TAZ,HHBASE,HHCHILDNO,HHCHILDYES,HHINC1,HHINC2,HHINC3,HHINC4,HHINC5
1,0,0,0,0,0,0,0,0
2,0,0,0,0,0,0,0,0
3,652,615,37,114,213,79,91,155
4,0,0,0,0,0,0,0,0
5,686,453,233,374,207,36,69,0
6,0,0,0,0,0,0,0,0
7,0,0,0,0,0,0,0,0
8,0,0,0,0,0,0,0,0
9,0,0,0,0,0,0,0,0
10,2170,1915,255,623,166,251,230,900
11,2159,1913,246,180,406,233,117,1223
12,0,0,0,0,0,0,0,0
13,0,0,0,0,0,0,0,0
14,2891,2687,204,316,359,314,132,1770
15,1134,1012,122,137,160,73,170,594
16,400,334,66,69,16,61,38,215
17,687,658,29,49,48,112,106,372
18,1414,951,463,408,241,275,106,384
19,1539,1382,157,84,77,68,0,1310
20,899,783,116,553,283,48,15,0
21,612,577,35,110,110,98,51,244
22,516,479,37,121,46,65,64,220
23,956,867,89,561,272,52,72,0
24,554,471,83,328,96,77,0,54
25,1261,1225,36,323,187,206,148,396
26,1137,1106,31,536,247,171,39,144
27,1201,1163,38,871,183,72,37,38
28,1131,1100,31,715,229,85,39,63
29,1058,867,191,537,202,85,0,234
30,1495,1336,159,112,126,0,248,1010
31,758,699,59,470,0,0,35,253
32,1153,763,390,146,0,0,0,1007
33,886,886,0,128,166,160,121,312
34,1351,1235,116,225,190,171,194,570
35,1610,1486,124,411,178,397,140,484
36,1095,996,99,348,323,151,151,123
37,1538,1427,111,616,308,152,142,319
38,1166,973,193,643,127,239,102,54
39,1678,1492,186,830,392,206,127,123
40,420,417,3,140,112,12,63,93
41,544,477,67,48,125,20,36,316
42,1003,820,183,30,92,48,146,686
43,626,498,128,175,99,0,58,294
44,743,735,8,130,158,27,121,307
45,702,538,164,303,177,48,36,138
46,696,663,33,349,134,19,64,130
47,515,457,58,263,51,72,15,114
48,1036,775,261,495,361,102,52,26
49,1254,1254,0,245,122,50,47,791
50,1203,1085,118,569,143,131,82,278
51,1539,1225,314,857,329,85,121,148
52,980,940,40,741,165,15,19,40
53,1006,913,93,136,24,29,266,551
54,803,701,102,162,95,68,125,353
55,697,605,92,33,131,144,41,348
56,1020,1007,13,112,83,133,82,610
57,1113,1016,97,291,70,90,56,605
58,564,564,0,0,84,92,50,339
59,978,863,115,65,83,41,141,648
60,1057,1010,47,207,108,72,89,580
61,1209,1129,80,247,71,139,88,664
62,1336,1215,121,279,211,63,79,704
63,633,633,0,219,101,40,18,254
64,905,842,63,61,116,100,93,535
65,401,374,27,79,25,16,90,191
66,782,743,39,219,93,59,50,362
67,623,493,130,236,175,29,20,163
68,939,887,52,495,90,70,56,229
69,1267,1190,77,135,138,199,96,698
70,657,592,65,142,64,86,179,187
71,146,133,13,46,28,12,16,43
72,188,177,11,54,30,51,14,39
73,752,654,98,389,143,31,74,115
74,672,672,0,550,101,10,0,11
75,1299,1239,60,461,147,38,118,536
76,1694,1510,184,399,316,142,104,733
77,763,676,87,225,102,58,51,327
78,2049,1760,289,269,93,88,212,1387
79,1422,1405,17,531,378,246,75,192
80,1272,1147,125,404,335,94,109,331
81,1603,1594,9,195,353,350,186,519
82,630,573,57,453,81,57,14,26
83,968,742,226,643,156,84,13,72
84,574,503,71,353,158,43,6,14
85,2266,2127,139,680,206,38,150,1193
86,1044,935,109,548,79,94,0,323
87,1652,1418,234,838,203,130,185,295
88,88,88,0,0,0,0,0,0
89,826,765,61,63,114,49,40,560
90,180,169,11,28,6,6,1,139
91,300,300,0,30,0,0,0,270
92,56,56,0,0,0,0,0,0
93,796,796,0,79,0,0,0,717
94,272,272,0,0,0,0,0,0
95,614,578,36,176,97,168,47,126
96,389,389,0,39,0,0,0,350
97,622,554,68,146,116,52,38,269
98,215,199,16,16,30,13,10,146
99,219,206,13,34,8,8,1,169
100,30,28,2,5,1,1,0,23
101,0,0,0,0,0,0,0,0
102,0,0,0,0,0,0,0,0
103,0,0,0,0,0,0,0,0
104,2139,1887,252,167,162,267,218,1324
105,3868,3506,362,300,347,399,331,2491
106,0,0,0,0,0,0,0,0
107,3543,3163,380,316,268,267,426,2266
108,2607,2123,484,350,201,168,161,1728
109,596,509,87,41,0,93,0,462
110,0,0,0,0,0,0,0,0
111,0,0,0,0,0,0,0,0
112,0,0,0,0,0,0,0,0
113,2344,1891,453,285,372,228,144,1315
114,0,0,0,0,0,0,0,0
115,0,0,0,0,0,0,0,0
116,0,0,0,0,0,0,0,0
117,1533,1178,355,203,200,234,226,670
118,1562,1256,306,206,194,311,154,698
119,68,58,10,14,10,13,7,25
120,293,191,102,29,5,21,12,227
121,714,624,90,173,63,65,127,286
122,658,577,81,77,101,90,88,301
123,402,356,46,44,30,78,67,183
124,374,280,94,77,61,11,33,192
125,546,435,111,132,44,51,32,287
126,716,542,174,53,65,57,105,436
127,613,508,105,67,129,104,100,213
128,416,390,26,106,46,55,67,143
129,772,596,176,58,156,63,42,453
130,844,732,112,298,131,144,30,241
131,847,719,128,225,95,107,61,358
132,792,650,142,150,144,32,111,356
133,219,99,120,9,9,10,31,161
134,454,293,161,24,39,73,45,273
135,618,485,133,83,93,34,34,373
136,581,495,86,116,72,100,111,182
137,1020,901,119,106,112,101,106,596
138,527,394,133,152,20,71,86,200
139,739,671,68,106,83,81,90,378
140,431,286,145,49,59,43,27,253
141,466,417,49,78,33,60,19,276
142,706,625,81,138,150,94,84,240
143,626,456,170,30,119,94,140,242
144,536,474,62,64,90,95,35,251
145,435,383,52,35,28,123,32,217
146,621,438,183,99,45,88,68,321
147,534,433,101,117,47,38,59,273
148,683,627,56,113,154,88,83,245
149,551,441,110,83,60,118,78,211
150,630,493,137,57,40,104,55,374
151,428,239,189,50,72,49,143,113
152,638,571,67,91,50,71,75,351
153,858,431,427,14,38,77,44,685
154,564,544,20,92,97,68,48,259
155,657,628,29,139,73,106,67,272
156,438,343,95,83,105,77,30,143
157,1041,958,83,47,128,126,31,709
158,1554,1539,15,162,256,114,76,945
159,849,819,30,78,82,107,98,485
160,849,698,151,41,10,32,105,661
161,131,78,53,22,50,24,4,31
162,812,654,158,185,99,103,91,335
163,753,560,193,259,126,68,38,261
164,678,582,96,143,7,68,62,398
165,835,745,90,148,154,144,44,345
166,654,573,81,63,17,35,125,414
167,581,502,79,155,79,37,23,287
168,465,455,10,119,26,97,18,206
169,685,665,20,169,79,22,93,322
170,577,511,66,147,104,51,81,194
171,608,563,45,99,94,95,35,285
172,690,527,163,78,31,39,48,494
173,580,513,67,45,87,80,18,351
174,625,556,69,50,104,43,52,376
175,324,227,97,9,36,24,31,224
176,819,657,162,96,97,54,25,547
177,621,578,43,114,15,42,18,432
178,662,523,139,0,37,17,66,541
179,782,744,38,58,0,108,147,469
180,354,257,97,24,23,30,9,267
181,714,523,191,32,117,30,0,535
182,366,281,85,18,43,30,20,255
183,1477,1373,104,65,77,210,60,1065
184,331,199,132,0,12,51,24,244
185,538,455,83,148,58,39,27,267
186,286,167,119,10,0,11,58,207
187,560,431,129,37,53,29,29,412
188,811,656,155,0,66,42,121,582
189,834,693,141,71,93,97,19,554
190,504,405,99,130,46,12,17,299
191,839,719,120,33,54,44,73,635
192,985,949,36,236,10,115,48,577
193,1049,1049,0,184,72,197,130,466
194,713,653,60,107,55,50,107,394
195,466,386,80,37,34,84,56,255
196,835,762,73,138,116,39,123,419
197,1242,1152,90,334,186,160,124,438
198,568,475,93,44,58,82,77,307
199,486,421,65,24,62,53,85,262
200,616,586,30,108,24,15,81,388
201,401,351,50,25,0,14,47,315
202,510,390,120,0,68,75,56,311
203,726,659,67,152,114,78,103,279
204,754,448,306,20,132,99,50,453
205,273,239,34,115,29,8,11,110
206,1146,1068,78,461,45,80,78,482
207,917,902,15,223,178,86,152,278
208,414,362,52,141,41,65,38,130
209,372,331,41,40,59,22,50,202
210,586,454,132,52,61,92,109,272
211,430,386,44,41,16,75,32,266
212,453,453,0,0,0,0,0,0
213,853,631,222,28,175,57,98,495
214,552,446,106,19,0,106,90,336
215,1084,983,101,334,190,105,88,367
216,1229,1069,160,362,128,145,166,427
217,1806,1746,60,551,272,180,121,681
218,801,664,137,404,111,77,63,146
219,1293,1085,208,984,251,35,0,23
220,351,281,70,142,41,87,55,26
221,415,378,37,200,60,48,6,101
222,360,311,49,188,80,0,14,78
223,631,561,70,39,58,84,63,387
224,1087,939,148,34,112,105,48,789
225,797,731,66,53,49,123,81,491
226,1058,996,62,77,103,131,113,634
227,510,412,98,61,53,77,38,281
228,658,573,85,17,47,128,79,387
229,531,481,50,61,24,78,49,319
230,709,528,181,150,77,14,24,445
231,822,762,60,77,55,150,0,540
232,478,444,34,32,0,57,70,319
233,634,551,83,37,98,123,0,375
234,672,620,52,50,17,114,115,378
235,692,654,38,12,67,91,39,483
236,837,760,77,70,86,22,11,648
237,758,635,123,179,81,118,130,249
238,1051,834,217,232,144,98,112,466
239,452,372,80,59,42,34,22,294
240,506,380,126,64,37,52,45,308
241,539,406,133,13,93,81,97,255
242,501,384,117,41,72,28,66,294
243,735,649,86,131,119,76,94,315
244,470,313,157,46,58,64,77,226
245,485,485,0,0,0,0,0,0
246,324,292,32,61,17,28,0,219
247,1037,900,137,114,125,245,54,499
248,596,514,82,19,65,79,46,386
249,1248,1169,79,111,78,89,168,803
250,461,369,92,16,16,16,33,380
251,529,441,88,58,18,31,17,406
252,0,0,0,0,0,0,0,0
253,74,37,37,1,3,7,4,59
254,559,433,126,18,46,82,39,374
255,0,0,0,0,0,0,0,0
256,51,51,0,0,0,0,0,0
257,401,365,36,91,36,22,15,237
258,0,0,0,0,0,0,0,0
259,0,0,0,0,0,0,0,0
260,1178,1106,72,89,50,85,267,687
261,1472,1145,327,108,78,107,133,1045
262,628,544,84,102,68,20,71,367
263,0,0,0,0,0,0,0,0
264,0,0,0,0,0,0,0,0
265,0,0,0,0,0,0,0,0
266,0,0,0,0,0,0,0,0
267,628,457,171,108,72,100,75,273
268,0,0,0,0,0,0,0,0
269,0,0,0,0,0,0,0,0
270,0,0,0,0,0,0,0,0
271,1349,1138,211,75,136,148,144,846
272,1287,1008,279,101,65,45,110,966
273,433,433,0,0,0,0,0,0
274,0,0,0,0,0,0,0,0
275,0,0,0,0,0,0,0,0
276,1063,794,269,99,179,222,151,412
277,0,0,0,0,0,0,0,0
278,0,0,0,0,0,0,0,0
279,1289,933,356,118,126,89,173,784
280,0,0,0,0,0,0,0,0
281,0,0,0,0,0,0,0,0
282,919,444,475,429,210,142,22,116
283,0,0,0,0,0,0,0,0
284,0,0,0,0,0,0,0,0
285,555,516,39,109,46,13,97,290
286,1214,1102,112,672,220,76,14,232
287,1289,1108,181,351,273,15,117,533
288,834,757,77,72,93,71,88,509
289,317,299,18,55,24,25,36,178
290,645,565,80,92,112,35,62,344
291,483,410,73,58,15,43,0,367
292,464,446,18,0,80,53,43,288
293,917,883,34,219,82,43,71,503
294,818,675,143,57,10,31,15,705
295,448,373,75,12,0,57,7,372
296,1014,915,99,143,65,100,34,671
297,1240,1142,98,87,182,144,24,803
298,854,718,136,285,120,36,59,354
299,675,550,125,82,218,81,28,266
300,586,472,114,112,128,50,20,276
301,501,436,65,27,99,29,45,301
302,321,234,87,65,30,9,38,180
303,313,272,41,67,69,54,9,113
304,478,372,106,72,103,0,102,201
305,654,503,151,160,118,86,52,239
306,417,370,47,63,58,21,65,210
307,799,589,210,171,128,42,18,441
308,410,259,151,18,55,61,54,221
309,460,327,133,64,81,80,59,176
310,408,293,115,144,63,94,22,85
311,624,302,322,337,131,95,24,38
312,695,601,94,103,75,87,40,390
313,454,393,61,28,33,51,41,301
314,428,412,16,60,13,16,107,233
315,406,308,98,20,30,33,94,228
316,477,404,73,22,24,65,70,296
317,573,454,119,0,13,61,45,454
318,466,338,128,57,0,21,68,320
319,386,308,78,53,21,36,63,214
320,695,538,157,76,38,40,65,476
321,607,492,115,31,49,72,27,427
322,597,442,155,71,49,51,31,394
323,428,413,15,84,32,16,37,259
324,472,372,100,68,123,37,28,216
325,477,358,119,33,89,0,40,314
326,505,478,27,18,75,12,34,366
327,821,600,221,71,62,41,55,591
328,664,575,89,107,72,21,75,388
329,635,531,104,89,31,97,84,334
330,426,295,131,24,49,43,30,280
331,452,359,93,63,83,13,66,228
332,306,219,87,5,20,77,38,165
333,420,267,153,68,141,88,32,90
334,561,326,235,74,82,70,102,232
335,184,143,41,141,3,0,3,37
336,139,100,39,49,8,14,12,56
337,507,355,152,10,28,85,10,374
338,526,443,83,36,75,55,45,315
339,643,551,92,9,70,39,41,483
340,321,283,38,16,7,20,22,256
341,410,310,100,37,77,15,32,248
342,771,550,221,59,69,148,35,460
343,495,403,92,21,25,18,55,376
344,659,486,173,100,95,61,37,365
345,591,420,171,99,82,43,20,347
346,673,540,133,124,59,65,50,375
347,403,298,105,20,48,35,28,273
348,528,374,154,128,80,74,11,234
349,163,135,28,43,29,16,4,72
350,313,178,135,49,61,100,44,59
351,412,360,52,13,32,39,31,297
352,378,310,68,30,56,59,42,191
353,459,281,178,156,83,72,0,148
354,329,255,74,21,30,45,0,233
355,331,209,122,57,8,92,35,139
356,341,243,98,26,33,26,42,213
357,384,258,126,18,67,19,61,218
358,317,235,82,31,54,18,20,194
359,388,219,169,93,97,62,27,108
360,407,231,176,99,160,33,11,106
361,553,399,154,18,40,184,27,284
362,490,387,103,54,21,67,41,307
363,441,265,176,142,56,69,40,134
364,325,208,117,98,64,56,26,81
365,270,131,139,116,50,18,20,67
366,291,202,89,0,24,22,73,172
367,586,368,218,56,30,52,83,365
368,397,357,40,49,36,39,32,241
369,455,307,148,48,70,47,12,277
370,623,334,289,80,45,82,12,404
371,524,350,174,19,41,73,45,347
372,439,275,164,25,75,14,109,216
373,714,517,197,0,56,78,106,475
374,536,423,113,13,63,80,109,271
375,484,430,54,39,37,108,108,192
376,252,191,61,0,23,0,43,186
377,425,330,95,108,35,109,40,133
378,224,159,65,57,42,62,45,18
379,391,241,150,28,76,70,151,65
380,356,275,81,59,80,68,54,95
381,368,294,74,79,79,67,29,115
382,644,559,85,51,67,97,56,374
383,572,497,75,80,96,70,41,286
384,477,344,133,0,105,25,42,305
385,345,209,136,66,30,46,61,141
386,366,221,145,23,22,49,22,250
387,358,271,87,8,48,39,24,239
388,636,424,212,100,74,75,77,311
389,522,359,163,89,70,28,47,288
390,793,405,388,97,155,32,148,361
391,388,231,157,20,86,73,31,178
392,564,401,163,26,39,99,73,327
393,394,213,181,68,0,42,46,238
394,341,239,102,0,45,51,26,219
395,393,291,102,14,117,15,63,184
396,504,352,152,123,46,62,35,238
397,296,185,111,13,0,57,0,226
398,265,220,45,88,0,13,99,65
399,443,312,131,99,28,113,62,140
400,420,229,191,43,126,64,35,151
401,320,221,99,38,62,17,36,168
402,325,315,10,75,55,38,83,74
403,224,185,39,40,63,18,42,61
404,329,177,152,32,96,26,42,133
405,508,394,114,36,79,63,74,257
406,151,111,40,10,0,3,0,138
407,600,453,147,85,143,79,85,208
408,643,454,189,142,85,128,105,184
409,716,455,261,132,149,116,54,265
410,487,288,199,55,21,99,83,230
411,354,216,138,20,73,95,80,86
412,323,305,18,33,41,34,95,121
413,198,198,0,0,0,0,0,0
414,421,354,67,74,68,55,35,189
415,305,192,113,33,53,29,36,155
416,514,432,82,51,65,116,96,187
417,375,256,119,9,82,36,107,141
418,351,202,149,38,23,92,57,142
419,343,251,92,15,80,81,58,108
420,310,161,149,13,46,46,71,133
421,277,184,93,33,33,51,37,122
422,327,201,126,49,27,121,9,122
423,334,191,143,37,22,33,54,188
424,349,233,116,31,45,73,123,76
425,280,236,44,76,52,30,18,105
426,420,238,182,25,84,99,81,130
427,548,410,138,143,168,95,92,50
428,467,370,97,136,90,88,14,138
429,516,260,256,63,106,92,95,161
430,430,325,105,31,16,57,65,262
431,595,511,84,108,92,83,56,257
432,418,336,82,18,35,50,79,236
433,658,572,86,152,37,49,37,382
434,1026,857,169,80,99,97,159,591
435,801,693,108,13,122,63,182,421
436,428,357,71,60,35,33,24,276
437,40,40,0,0,0,14,0,26
438,466,400,66,57,96,26,19,268
439,405,296,109,31,42,22,26,284
440,792,575,217,70,98,84,58,482
441,455,285,170,34,105,93,50,172
442,293,271,22,104,66,0,0,123
443,1402,1239,163,68,201,297,178,659
444,683,477,206,68,84,44,53,433
445,515,437,78,17,7,39,47,404
446,11,9,2,2,1,2,1,5
447,455,262,193,53,64,71,44,222
448,297,281,16,26,68,22,22,159
449,748,562,186,80,117,184,50,316
450,340,186,154,89,68,15,68,99
451,406,275,131,0,51,59,19,276
452,576,308,268,125,97,80,94,181
453,682,461,221,85,172,131,63,231
454,737,434,303,186,175,76,140,160
455,657,435,222,54,189,136,80,198
456,465,282,183,105,27,70,82,181
457,359,198,161,76,64,60,54,106
458,269,135,134,80,46,71,10,63
459,348,231,117,87,40,22,54,145
460,579,513,66,28,43,41,16,451
461,452,382,70,17,35,50,31,318
462,717,689,28,38,46,69,52,513
463,766,653,113,68,76,64,40,519
464,877,635,242,25,67,83,25,678
465,492,272,220,23,63,59,53,294
466,350,274,76,90,36,64,11,149
467,320,211,109,79,50,51,41,99
468,378,203,175,40,59,46,62,171
469,636,478,158,104,104,115,91,222
470,454,340,114,21,88,71,68,205
471,228,196,32,7,14,49,46,112
472,342,218,124,26,78,32,27,179
473,420,283,137,49,59,80,60,173
474,473,333,140,58,64,82,69,199
475,713,512,201,148,91,177,57,240
476,318,255,63,48,28,30,58,154
477,621,602,19,163,37,84,41,297
478,816,697,119,84,231,190,61,250
479,30,30,0,0,4,1,5,20
480,631,518,113,343,45,29,81,134
481,1368,1273,95,385,365,47,62,509
482,832,518,314,286,132,57,24,333
483,1005,533,472,122,71,19,170,622
484,615,520,95,24,51,34,34,471
485,12,9,3,3,1,1,0,6
486,510,360,150,54,99,61,76,219
487,0,0,0,0,0,0,0,0
488,42,33,9,11,5,3,2,22
489,2204,1837,367,309,183,171,121,1420
490,287,230,57,43,25,27,52,139
491,99,99,0,0,12,5,15,66
492,7,7,0,0,1,0,1,5
493,382,382,0,0,0,135,0,247
494,894,745,149,125,74,69,49,576
495,1081,901,180,152,90,84,59,697
496,90,90,0,0,0,0,0,0
497,331,331,0,0,0,0,0,0
498,1,1,0,0,0,0,0,1
499,0,0,0,0,0,0,0,0
500,0,0,0,0,0,0,0,0
501,228,228,0,0,0,0,0,0
502,0,0,0,0,0,0,0,0
503,45,35,10,12,5,3,2,23
504,0,0,0,0,0,0,0,0
505,0,0,0,0,0,0,0,0
506,38,30,8,10,4,3,1,20
507,8,6,2,2,1,1,0,4
508,0,0,0,0,0,0,0,0
509,0,0,0,0,0,0,0,0
510,438,179,259,209,75,102,16,36
511,776,452,324,371,133,74,56,141
512,210,102,108,113,44,32,8,13
513,36,22,14,12,5,6,3,11
514,435,262,173,140,55,68,39,132
515,99,63,36,30,20,17,8,25
516,261,127,134,112,48,17,19,65
517,54,36,18,13,6,3,8,23
518,61,61,0,0,0,0,0,0
519,32,23,9,3,4,3,2,19
520,177,111,66,13,41,36,20,67
521,268,268,0,0,0,0,0,0
522,271,183,88,44,47,55,19,106
523,213,149,64,52,20,26,15,101
524,676,508,168,75,105,57,63,376
525,648,422,226,0,87,80,52,430
526,308,257,51,43,26,24,17,198
527,0,0,0,0,0,0,0,0
528,0,0,0,0,0,0,0,0
529,0,0,0,0,0,0,0,0
530,0,0,0,0,0,0,0,0
531,0,0,0,0,0,0,0,0
532,1084,909,175,347,108,242,32,356
533,0,0,0,0,0,0,0,0
534,618,430,188,48,66,29,60,414
535,0,0,0,0,0,0,0,0
536,0,0,0,0,0,0,0,0
537,0,0,0,0,0,0,0,0
538,776,680,96,213,105,139,86,233
539,705,403,302,49,22,63,63,508
540,244,175,69,0,10,32,9,193
541,299,240,59,19,20,20,0,239
542,290,233,57,0,20,0,32,238
543,395,209,186,38,18,0,51,288
544,278,207,71,22,15,0,36,205
545,287,226,61,0,0,52,0,235
546,345,301,44,0,0,43,0,302
547,492,324,168,55,0,0,34,403
548,229,164,65,0,19,54,38,118
549,319,194,125,0,0,46,18,255
550,288,247,41,49,51,18,64,105
551,529,444,85,54,89,76,44,266
552,306,203,103,46,0,86,0,174
553,457,393,64,92,33,29,68,236
554,298,155,143,18,14,41,0,225
555,286,230,56,33,5,79,0,168
556,284,266,18,31,27,43,18,165
557,429,255,174,61,156,45,54,112
558,422,316,106,71,71,32,88,161
559,463,325,138,32,47,47,146,191
560,383,293,90,18,12,96,97,159
561,547,377,170,54,51,62,34,347
562,424,265,159,30,22,53,68,252
563,540,424,116,65,53,90,62,270
564,294,169,125,38,39,12,12,192
565,379,206,173,5,68,15,37,255
566,226,192,34,39,34,40,25,89
567,694,574,120,86,87,113,90,318
568,576,439,137,95,90,64,164,163
569,485,330,155,36,17,87,79,265
570,477,405,72,86,25,186,50,131
571,385,335,50,99,14,28,20,224
572,270,146,124,19,24,0,27,200
573,326,254,72,29,38,30,50,179
574,319,186,133,31,38,12,0,237
575,464,309,155,58,17,66,37,287
576,525,383,142,35,129,118,63,181
577,357,289,68,103,28,47,14,164
578,323,250,73,50,49,51,26,145
579,364,199,165,23,5,59,72,205
580,328,256,72,10,53,50,84,131
581,472,379,93,105,13,59,138,158
582,332,222,110,21,31,18,0,261
583,499,270,229,177,92,15,23,191
584,340,251,89,25,55,55,55,150
585,444,371,73,61,0,130,89,163
586,309,264,45,84,43,49,82,50
587,418,394,24,101,32,93,9,183
588,441,350,91,61,67,43,28,242
589,466,402,64,72,42,103,66,183
590,410,321,89,74,98,39,17,182
591,885,751,134,85,69,196,133,402
592,463,387,76,52,41,134,46,189
593,760,535,225,65,21,133,63,477
594,524,387,137,47,7,90,79,300
595,718,596,122,122,17,85,57,437
596,778,706,72,26,151,85,137,379
597,467,397,70,93,98,37,17,222
598,664,610,54,276,214,65,54,56
599,712,570,142,61,65,67,49,470
600,476,358,118,36,24,57,19,341
601,476,335,141,30,88,16,38,304
602,466,315,151,55,48,32,43,288
603,269,213,56,44,15,0,44,166
604,515,307,208,41,38,41,63,332
605,434,334,100,6,10,28,60,331
606,326,243,83,18,52,37,29,190
607,308,181,127,17,5,30,15,241
608,608,487,121,29,57,99,43,379
609,641,525,116,64,16,35,113,413
610,462,310,152,35,24,43,42,319
611,367,235,132,77,25,32,82,151
612,542,355,187,12,76,105,59,290
613,466,355,111,65,107,41,54,199
614,470,286,184,81,93,82,57,157
615,459,326,133,111,31,96,70,151
616,417,334,83,69,50,66,79,153
617,656,532,124,49,71,77,92,367
618,568,418,150,53,131,133,68,184
619,566,508,58,35,39,98,40,355
620,735,584,151,103,82,130,40,381
621,493,335,158,61,45,148,58,181
622,411,324,87,23,68,99,17,204
623,494,381,113,56,91,104,64,179
624,542,388,154,40,85,42,49,326
625,429,301,128,45,21,73,9,281
626,508,380,128,39,54,81,78,255
627,517,367,150,106,90,46,50,225
628,438,352,86,53,44,28,95,218
629,385,309,76,37,51,51,27,219
630,423,286,137,26,51,53,113,179
631,429,300,129,54,74,49,44,209
632,543,368,175,48,75,91,95,234
633,389,325,64,66,62,41,59,161
634,434,338,96,115,34,39,29,217
635,455,300,155,72,14,42,136,191
636,1348,1086,262,285,269,151,217,427
637,989,691,298,310,267,31,181,200
638,534,447,87,163,103,142,33,93
639,489,353,136,59,94,66,45,224
640,601,433,168,44,110,75,31,340
641,301,284,17,53,99,37,42,71
642,0,0,0,0,0,0,0,0
643,265,265,0,0,0,0,0,0
644,431,388,43,148,87,76,37,83
645,69,63,6,29,22,7,6,6
646,119,119,0,0,0,0,0,0
647,420,278,142,68,34,10,17,292
648,0,0,0,0,0,0,0,0
649,0,0,0,0,0,0,0,0
650,0,0,0,0,0,0,0,0
651,0,0,0,0,0,0,0,0
652,1014,818,196,115,193,248,248,210
653,0,0,0,0,0,0,0,0
654,0,0,0,0,0,0,0,0
655,509,333,176,71,145,11,65,217
656,1578,993,585,71,160,173,168,1006
657,1455,967,488,111,177,206,139,821
658,2410,1634,776,182,298,306,292,1331
659,306,179,127,18,28,22,47,191
660,3129,2352,777,309,435,418,493,1474
661,0,0,0,0,0,0,0,0
662,0,0,0,0,0,0,0,0
663,1181,856,325,119,105,214,102,640
664,1302,892,410,117,126,204,220,635
665,0,0,0,0,0,0,0,0
666,0,0,0,0,0,0,0,0
667,0,0,0,0,0,0,0,0
668,1726,1169,557,161,176,221,229,940
669,26,26,0,0,0,0,0,0
670,43,43,0,0,0,0,0,0
671,1568,997,571,76,199,238,302,752
672,551,312,239,44,47,42,138,280
673,1621,1126,495,189,130,133,258,910
674,0,0,0,0,0,0,0,0
675,633,393,240,0,163,95,98,276
676,0,0,0,0,0,0,0,0
677,2928,1942,986,184,421,329,335,1659
678,1462,987,475,122,161,164,174,840
679,1958,1382,576,197,201,252,311,998
680,1840,1369,471,238,300,261,210,832
681,1216,825,391,97,116,125,129,748
682,1414,1014,400,86,148,224,132,824
683,2011,1420,591,247,196,279,183,1105
684,1384,853,531,66,110,158,156,894
685,1662,1140,522,152,180,314,249,767
686,0,0,0,0,0,0,0,0
687,0,0,0,0,0,0,0,0
688,0,0,0,0,0,0,0,0
689,310,260,50,9,43,10,8,239
690,914,581,333,53,97,100,93,571
691,637,458,179,42,51,63,60,421
692,546,442,104,111,62,62,65,245
693,315,164,151,0,17,19,22,257
694,0,0,0,0,0,0,0,0
695,0,0,0,0,0,0,0,0
696,0,0,0,0,0,0,0,0
697,1868,1296,572,109,238,331,246,944
698,0,0,0,0,0,0,0,0
699,1018,605,413,111,262,87,190,368
700,465,256,209,45,87,94,57,182
701,353,288,65,22,25,59,73,174
702,407,277,130,25,81,51,24,226
703,277,185,92,0,6,22,0,249
704,410,238,172,67,76,93,17,157
705,1185,1049,136,125,198,230,141,491
706,547,397,150,58,56,63,103,267
707,553,260,293,20,126,129,77,200
708,693,549,144,149,82,76,268,117
709,575,381,194,25,106,69,84,291
710,682,425,257,40,152,105,77,309
711,1047,627,420,54,110,38,13,832
712,323,156,167,42,33,10,26,211
713,424,321,103,7,54,61,68,234
714,1573,1067,506,200,116,388,172,697
715,428,333,95,76,68,78,56,149
716,275,122,153,21,86,63,47,57
717,2020,1384,636,179,395,237,242,967
718,290,150,140,20,11,33,30,197
719,887,660,227,75,126,35,80,572
720,737,447,290,25,96,31,105,480
721,314,186,128,50,0,14,40,210
722,249,166,83,33,90,25,47,54
723,1802,1048,754,288,366,396,386,367
724,898,631,267,59,98,94,146,502
725,806,492,314,70,135,94,138,369
726,419,146,273,107,20,0,25,268
727,1096,790,306,148,127,137,133,551
728,256,136,120,21,12,45,21,158
729,372,180,192,10,48,29,9,275
730,359,178,181,24,33,65,0,238
731,572,307,265,99,180,83,83,127
732,630,465,165,101,99,161,91,179
733,358,232,126,23,36,16,36,248
734,277,194,83,0,56,63,31,127
735,329,192,137,19,35,20,21,233
736,433,270,163,140,74,38,52,129
737,602,387,215,72,50,139,143,198
738,242,190,52,44,43,29,45,81
739,360,211,149,0,41,113,58,148
740,712,450,262,59,125,126,63,340
741,720,514,206,133,190,63,54,279
742,538,390,148,65,55,123,68,227
743,422,264,158,58,106,113,62,84
744,778,360,418,215,85,111,78,289
745,393,291,102,0,35,166,48,145
746,1692,1265,427,215,661,369,142,305
747,748,621,127,56,104,125,75,388
748,1473,802,671,355,297,124,227,470
749,878,632,246,119,133,218,102,306
750,331,245,86,36,48,61,60,126
751,798,739,59,93,208,112,60,324
752,869,627,242,84,66,145,283,290
753,797,674,123,200,150,122,49,277
754,913,745,168,158,243,146,137,229
755,793,560,233,173,76,140,121,282
756,377,312,65,23,29,126,96,103
757,815,477,338,139,75,208,119,275
758,708,447,261,68,143,53,94,351
759,1112,901,211,131,107,140,271,463
760,1188,916,272,162,97,110,166,653
761,772,408,364,0,54,26,97,594
762,567,416,151,91,186,76,32,182
763,546,341,205,39,53,88,81,285
764,719,505,214,93,110,52,90,374
765,217,116,101,15,43,23,21,115
766,341,238,103,20,48,62,16,195
767,495,378,117,26,67,111,115,177
768,417,301,116,17,13,0,99,288
769,567,277,290,61,32,15,101,358
770,680,456,224,132,53,57,38,400
771,429,313,116,11,49,57,25,288
772,910,681,229,96,171,80,123,441
773,551,338,213,58,60,103,70,260
774,227,162,65,41,22,48,52,65
775,425,325,100,77,47,119,25,157
776,444,233,211,85,101,100,63,96
777,454,198,256,51,97,78,151,77
778,0,0,0,0,0,0,0,0
779,0,0,0,0,0,0,0,0
780,392,345,47,0,30,0,32,330
781,770,550,220,100,88,96,128,358
782,1113,652,461,147,84,114,84,685
783,909,533,376,112,96,79,178,444
784,909,582,327,81,90,50,150,538
785,424,199,225,89,55,88,165,28
786,316,238,78,0,16,22,35,243
787,589,415,174,176,23,78,51,262
788,2,1,1,0,0,0,0,1
789,0,0,0,0,0,0,0,0
790,153,135,18,16,26,30,18,63
791,1152,717,435,201,149,132,186,483
792,0,0,0,0,0,0,0,0
793,0,0,0,0,0,0,0,0
794,0,0,0,0,0,0,0,0
795,328,223,105,30,25,37,37,199
796,1444,995,449,91,95,89,187,983
797,1425,1032,393,90,167,112,168,889
798,263,192,71,38,18,18,42,147
799,0,0,0,0,0,0,0,0
800,665,366,299,20,114,58,95,378
801,273,166,107,18,41,49,32,133
802,1949,1709,240,222,137,291,153,1146
803,1565,1031,534,199,89,122,132,1024
804,1557,1023,534,72,120,150,110,1104
805,2376,1597,779,186,361,117,281,1432
806,1256,791,465,84,158,99,123,791
807,1347,929,418,67,60,99,49,1073
808,1238,1238,0,0,0,0,0,0
809,0,0,0,0,0,0,0,0
810,2725,1789,936,133,212,83,216,2082
811,3355,2502,853,501,385,437,226,1805
812,0,0,0,0,0,0,0,0
813,423,265,158,31,0,12,14,365
814,1337,769,568,63,71,39,21,1143
815,668,374,294,10,98,7,15,539
816,871,642,229,28,65,34,99,644
817,0,0,0,0,0,0,0,0
818,406,249,157,35,17,65,54,236
819,1110,753,357,39,75,75,148,771
820,1286,850,436,64,127,194,193,708
821,1349,843,506,84,102,50,106,1007
822,0,0,0,0,0,0,0,0
823,2340,1715,625,85,203,252,161,1638
824,1424,947,477,79,178,203,145,819
825,2228,1497,731,137,261,236,391,1203
826,3555,2684,871,562,492,365,309,1827
827,1969,1291,678,153,348,191,305,972
828,410,255,155,10,8,33,53,306
829,338,287,51,16,44,30,20,229
830,288,157,131,0,21,7,9,251
831,1170,934,236,173,143,77,198,579
832,827,511,316,44,38,144,166,435
833,384,234,150,19,63,27,38,237
834,1072,804,268,90,205,186,69,522
835,837,480,357,48,61,78,18,633
836,814,511,303,40,117,46,54,557
837,654,521,133,140,110,81,156,167
838,790,468,322,56,107,152,242,233
839,602,484,118,48,133,119,46,256
840,423,292,131,62,71,68,37,185
841,315,123,192,11,76,99,81,47
842,428,358,70,31,40,54,67,237
843,681,248,433,96,163,179,94,148
844,629,425,204,47,121,149,162,149
845,472,239,233,0,40,45,20,367
846,442,249,193,47,152,113,61,69
847,447,404,43,135,77,27,44,165
848,468,384,84,62,87,35,108,176
849,486,321,165,53,62,47,23,301
850,1030,634,396,81,129,148,152,520
851,401,211,190,31,58,79,21,212
852,460,235,225,0,39,37,40,344
853,621,381,240,87,100,27,48,359
854,648,395,253,71,51,73,118,335
855,333,159,174,21,12,22,19,259
856,1307,1106,201,311,195,220,135,446
857,1238,743,495,132,162,92,185,667
858,1270,1018,252,124,258,220,138,530
859,485,337,148,22,91,71,57,244
860,705,456,249,14,92,48,114,437
861,615,459,156,100,65,64,57,329
862,652,439,213,42,89,50,85,385
863,299,165,134,11,44,10,11,223
864,719,553,166,107,48,190,56,317
865,475,289,186,45,59,58,71,243
866,646,442,204,109,22,147,78,291
867,384,269,115,49,24,118,23,171
868,394,202,192,0,17,55,41,281
869,600,424,176,24,98,66,55,358
870,552,417,135,193,52,30,43,234
871,1166,838,328,77,203,150,89,647
872,318,216,102,24,77,39,48,129
873,1940,1180,760,156,250,237,168,1130
874,1403,1198,205,78,247,131,324,623
875,1005,707,298,72,126,121,79,608
876,326,201,125,89,0,15,50,172
877,466,291,175,40,49,86,61,229
878,525,430,95,41,67,117,68,232
879,379,222,157,14,45,90,22,209
880,1337,972,365,172,66,295,156,648
881,661,490,171,28,40,106,84,402
882,529,327,202,37,80,54,104,253
883,522,336,186,43,28,55,23,373
884,324,216,108,29,38,74,44,139
885,370,172,198,30,0,68,31,241
886,1182,970,212,66,123,156,145,691
887,349,268,81,36,20,36,25,231
888,423,284,139,0,0,42,43,338
889,995,688,307,58,159,46,95,637
890,885,504,381,46,63,45,9,722
891,639,460,179,29,22,44,85,459
892,636,483,153,100,81,110,136,209
893,426,353,73,23,123,28,0,252
894,681,518,163,139,142,18,18,364
895,263,131,132,20,11,12,11,210
896,411,261,150,31,8,39,27,305
897,461,270,191,68,89,78,10,216
898,508,352,156,38,41,31,59,340
899,225,225,0,0,0,0,0,0
900,138,138,0,0,0,0,0,0
901,76,76,0,0,0,0,0,0
902,2129,1481,648,104,115,109,183,1618
903,1551,1056,495,91,63,109,127,1162
904,94,94,0,0,0,0,0,0
905,0,0,0,0,0,0,0,0
906,126,126,0,0,0,0,0,0
907,0,0,0,0,0,0,0,0
908,0,0,0,0,0,0,0,0
909,655,413,242,38,28,52,122,415
910,1549,908,641,177,356,359,246,411
911,1160,645,515,190,281,221,144,324
912,0,0,0,0,0,0,0,0
913,0,0,0,0,0,0,0,0
914,844,437,407,33,71,82,99,559
915,719,477,242,71,67,80,45,456
916,1750,1188,562,174,135,221,164,1057
917,56,56,0,0,0,0,0,0
918,3238,2006,1232,190,155,319,225,2349
919,389,224,165,104,64,90,79,51
920,1283,787,496,173,301,294,131,383
921,100,100,0,0,0,0,0,0
922,1077,726,351,71,84,137,86,698
923,806,430,376,37,55,90,51,573
924,890,402,488,104,180,212,129,264
925,1546,646,900,314,216,378,184,454
926,0,0,0,0,0,0,0,0
927,1881,1485,396,225,449,124,230,854
928,744,327,417,29,0,85,0,630
929,0,0,0,0,0,0,0,0
930,1212,654,558,8,55,152,46,951
931,1743,1064,679,215,91,150,103,1183
932,1677,1113,564,182,184,121,234,956
933,2795,1906,889,179,221,219,98,2078
934,1136,760,376,71,71,63,87,845
935,1302,858,444,83,77,35,112,995
936,2239,1639,600,226,278,387,298,1050
937,2257,1551,706,174,159,371,312,1241
938,2180,1413,767,156,227,143,130,1524
939,1967,1386,581,143,194,219,218,1195
940,797,538,259,42,75,23,9,648
941,1394,757,637,347,263,249,131,404
942,2535,1440,1095,386,517,418,305,909
943,2891,1629,1262,478,835,588,323,668
944,787,585,202,74,161,38,95,419
945,224,171,53,0,30,0,11,183
946,499,367,132,70,35,20,8,367
947,289,167,122,46,34,13,27,168
948,450,323,127,29,49,43,16,314
949,265,174,91,6,7,6,26,220
950,351,211,140,22,24,11,6,288
951,404,229,175,19,0,22,7,356
952,1140,542,598,72,60,79,60,869
953,1077,613,464,52,46,73,62,843
954,777,503,274,20,96,67,49,546
955,353,197,156,34,5,21,24,268
956,556,361,195,35,70,40,71,342
957,1095,796,299,123,167,119,118,568
958,1017,670,347,54,74,122,119,649
959,460,240,220,0,0,50,82,328
960,353,216,137,45,22,22,0,264
961,771,554,217,110,57,160,0,444
962,686,519,167,24,39,71,82,470
963,1079,767,312,231,228,190,0,430
964,964,551,413,84,35,102,58,684
965,475,332,143,32,16,35,43,349
966,567,359,208,61,21,91,0,393
967,534,402,132,28,52,108,52,293
968,436,331,105,109,42,16,9,259
969,729,448,281,239,146,61,84,199
970,540,269,271,21,90,132,68,228
971,1378,1164,214,393,210,148,102,525
972,1160,683,477,165,147,135,72,641
973,462,152,310,106,127,35,76,119
974,890,694,196,142,93,137,146,372
975,416,302,114,137,75,35,66,103
976,854,546,308,122,199,185,69,278
977,294,196,98,14,57,42,9,172
978,1296,853,443,50,98,78,88,982
979,663,403,260,18,50,0,88,507
980,487,361,126,24,94,0,47,321
981,990,812,178,139,131,97,171,452
982,513,371,142,58,78,74,46,258
983,876,551,325,132,127,150,107,360
984,602,423,179,101,97,38,117,249
985,505,288,217,54,174,104,70,103
986,693,555,138,145,139,138,167,104
987,412,326,86,15,131,9,24,233
988,690,495,195,17,39,151,116,367
989,461,185,276,101,102,124,53,81
990,299,239,60,81,54,21,15,127
991,749,373,376,125,147,172,71,234
992,617,526,91,149,160,19,97,193
993,0,0,0,0,0,0,0,0
994,1528,928,600,165,90,90,206,976
995,759,425,334,42,90,29,50,548
996,1919,1257,662,368,199,129,76,1147
997,2174,1180,994,97,122,116,183,1656
998,1562,842,720,117,57,80,87,1220
999,1779,1100,679,133,159,53,184,1251
1000,637,369,268,32,30,21,48,506
1001,2087,1302,785,83,227,152,178,1447
1002,0,0,0,0,0,0,0,0
1003,472,330,142,146,50,23,8,244
1004,0,0,0,0,0,0,0,0
1005,1058,543,515,90,42,31,68,827
1006,0,0,0,0,0,0,0,0
1007,0,0,0,0,0,0,0,0
1008,0,0,0,0,0,0,0,0
1009,0,0,0,0,0,0,0,0
1010,1527,1030,497,75,83,65,69,1234
1011,561,439,122,49,83,64,61,304
1012,0,0,0,0,0,0,0,0
1013,585,329,256,43,61,16,0,465
1014,1342,794,548,55,66,160,94,967
1015,1100,704,396,95,65,87,79,774
1016,1000,654,346,77,32,91,78,723
1017,1509,913,596,55,85,93,122,1155
1018,0,0,0,0,0,0,0,0
1019,1198,707,491,45,92,83,90,889
1020,981,563,418,32,39,51,79,780
1021,44,30,14,2,4,3,3,32
1022,0,0,0,0,0,0,0,0
1023,866,556,310,0,31,30,16,789
1024,0,0,0,0,0,0,0,0
1025,3014,2170,844,117,188,239,208,2262
1026,1228,728,500,149,95,131,103,748
1027,851,695,156,66,42,60,111,572
1028,951,758,193,82,171,116,52,529
1029,1358,1052,306,137,114,167,102,838
1030,782,502,280,59,47,87,49,540
1031,741,570,171,164,81,73,105,318
1032,1209,780,429,128,45,44,39,953
1033,641,397,244,65,0,138,60,377
1034,515,391,124,116,23,77,39,260
1035,344,252,92,9,31,76,64,164
1036,2295,1911,384,486,330,199,164,1116
1037,0,0,0,0,0,0,0,0
1038,1892,1431,461,255,95,355,253,933
1039,1490,934,556,47,75,86,85,1197
1040,1375,1075,300,328,193,180,115,560
1041,333,261,72,129,60,0,10,134
1042,992,647,345,119,71,108,177,518
1043,1027,1027,0,248,379,105,175,119
1044,471,324,147,53,103,53,62,200
1045,631,448,183,14,116,50,60,392
1046,703,432,271,29,75,57,37,504
1047,731,464,267,97,84,126,112,313
1048,929,467,462,55,112,45,121,596
1049,400,322,78,0,0,28,73,299
1050,692,389,303,100,67,52,28,445
1051,669,449,220,82,156,103,60,268
1052,285,224,61,79,49,39,11,107
1053,535,335,200,44,38,82,58,313
1054,750,642,108,127,133,40,36,415
1055,104,89,15,0,15,11,8,70
1056,544,394,150,55,67,50,44,328
1057,557,512,45,56,85,64,135,217
1058,213,175,38,5,3,16,12,177
1059,735,427,308,72,0,101,21,541
1060,716,458,258,109,93,107,58,350
1061,183,161,22,55,15,36,4,72
1062,564,376,188,16,45,27,16,460
1063,527,471,56,78,96,96,92,165
1064,564,433,131,106,71,137,9,241
1065,351,306,45,23,16,14,34,264
1066,356,285,71,50,38,73,27,168
1067,312,285,27,38,76,16,25,157
1068,739,507,232,162,71,88,36,382
1069,639,591,48,68,23,65,45,439
1070,1287,910,377,165,94,156,120,752
1071,780,661,119,87,78,127,92,396
1072,734,562,172,0,96,47,42,549
1073,363,263,100,14,37,32,14,266
1074,0,0,0,0,0,0,0,0
1075,824,538,286,41,20,75,83,605
1076,521,223,298,0,0,58,82,381
1077,432,276,156,54,52,82,11,234
1078,499,317,182,12,35,0,43,409
1079,262,154,108,24,8,49,8,173
1080,252,169,83,0,12,8,19,213
1081,698,456,242,39,11,63,46,539
1082,421,219,202,53,29,28,6,304
1083,0,0,0,0,0,0,0,0
1084,715,580,135,145,118,70,84,298
1085,364,151,213,40,0,17,51,256
1086,463,228,235,63,43,33,0,325
1087,427,236,191,35,0,20,39,333
1088,688,416,272,78,25,43,38,504
1089,596,259,337,34,38,37,76,412
1090,736,509,227,84,84,113,56,399
1091,531,339,192,22,55,33,53,368
1092,448,218,230,40,0,27,21,361
1093,282,192,90,11,26,19,21,205
1094,1840,1840,0,0,0,0,0,1840
1095,0,0,0,0,0,0,0,0
1096,1160,1002,158,204,145,208,78,526
1097,2813,1480,1333,155,370,233,141,1915
1098,1546,959,587,101,88,191,95,1071
1099,1807,873,934,91,139,136,211,1231
1100,1441,779,662,120,142,60,111,1008
1101,918,570,348,61,70,64,88,635
1102,1509,908,601,198,158,59,105,989
1103,3223,2056,1167,328,363,417,270,1845
1104,0,0,0,0,0,0,0,0
1105,3214,2276,938,258,411,397,354,1793
1106,331,259,72,86,21,78,36,111
1107,2509,1832,677,242,322,367,161,1417
1108,832,526,306,84,65,157,48,477
1109,0,0,0,0,0,0,0,0
1110,1475,1006,469,197,218,175,176,709
1111,774,537,237,50,87,52,65,519
1112,2433,1668,765,182,249,230,371,1400
1113,3088,2051,1037,221,426,552,357,1532
1114,0,0,0,0,0,0,0,0
1115,1370,804,566,94,358,180,226,511
1116,1097,711,386,170,75,88,174,589
1117,0,0,0,0,0,0,0,0
1118,0,0,0,0,0,0,0,0
1119,1909,1332,577,117,299,197,201,1096
1120,3000,1692,1308,280,495,443,368,1415
1121,2542,1389,1153,256,229,188,161,1708
1122,1061,651,410,28,72,119,109,732
1123,2061,1008,1053,162,147,121,275,1356
1124,854,635,219,58,51,95,56,593
1125,0,0,0,0,0,0,0,0
1126,579,375,204,20,138,71,65,285
1127,1645,971,674,252,192,172,331,700
1128,4,2,2,1,1,1,0,2
1129,765,585,180,104,156,145,97,263
1130,1818,1522,296,394,183,287,301,653
1131,0,0,0,0,0,0,0,0
1132,0,0,0,0,0,0,0,0
1133,434,274,160,32,0,104,53,244
1134,0,0,0,0,0,0,0,0
1135,0,0,0,0,0,0,0,0
1136,0,0,0,0,0,0,0,0
1137,90,70,20,6,5,4,4,72
1138,0,0,0,0,0,0,0,0
1139,4648,3604,1044,298,234,207,200,3708
1140,804,546,258,55,145,107,88,409
1141,223,132,91,55,13,34,12,109
1142,0,0,0,0,0,0,0,0
1143,1111,676,435,77,162,97,143,633
1144,0,0,0,0,0,0,0,0
1145,0,0,0,0,0,0,0,0
1146,0,0,0,0,0,0,0,0
1147,0,0,0,0,0,0,0,0
1148,650,448,202,67,12,5,6,559
1149,0,0,0,0,0,0,0,0
1150,594,460,134,18,52,40,31,453
1151,4,3,1,0,0,0,0,3
1152,0,0,0,0,0,0,0,0
1153,0,0,0,0,0,0,0,0
1154,573,426,147,65,135,97,70,206
1155,0,0,0,0,0,0,0,0
1156,0,0,0,0,0,0,0,0
1157,175,47,128,8,19,48,29,71
1158,2604,2107,497,457,353,235,378,1181
1159,953,510,443,31,112,213,90,507
1160,232,153,79,14,51,9,4,153
1161,2058,1375,683,306,343,287,340,783
1162,611,500,111,11,180,93,20,306
1163,1114,772,342,110,162,117,143,583
1164,1571,1056,515,118,182,250,195,825
1165,1439,942,497,112,171,199,210,747
1166,959,649,310,85,222,176,193,282
1167,816,568,248,46,68,63,149,490
1168,176,111,65,31,32,8,28,77
1169,37,31,6,8,4,9,7,9
1170,5017,3696,1321,624,412,538,304,3139
1171,663,445,218,23,0,53,53,534
1172,1676,1292,384,172,0,0,172,1333
1173,475,263,212,14,35,104,7,315
1174,486,297,189,19,0,24,0,443
1175,377,284,93,44,17,47,61,209
1176,478,315,163,47,63,49,12,307
1177,725,331,394,0,54,68,144,460
1178,336,223,113,61,65,46,47,117
1179,2044,1603,441,229,122,99,246,1349
1180,223,167,56,3,11,18,16,175
1181,289,180,109,20,21,100,31,118
1182,596,410,186,31,39,94,70,363
1183,1284,858,426,73,48,173,142,847
1184,407,293,114,40,87,46,88,147
1185,213,109,104,8,16,15,33,141
1186,721,436,285,41,86,139,71,384
1187,516,388,128,51,65,127,85,188
1188,543,198,345,57,189,121,53,123
1189,712,555,157,52,70,10,99,482
1190,863,627,236,69,99,118,53,524
1191,475,350,125,73,78,80,39,204
1192,667,460,207,96,73,85,76,336
1193,603,371,232,26,89,20,19,450
1194,331,223,108,46,21,71,16,177
1195,436,191,245,70,114,86,0,166
1196,858,632,226,101,175,157,53,372
1197,4002,2451,1551,193,222,217,286,3085
1198,480,302,178,47,30,11,79,313
1199,729,524,205,42,73,60,118,437
1200,1189,885,304,243,69,114,27,736
1201,570,321,249,36,50,64,18,401
1202,518,302,216,61,27,102,46,282
1203,279,209,70,43,37,23,0,176
1204,498,346,152,41,49,65,47,295
1205,315,183,132,10,51,13,25,216
1206,543,297,246,21,27,61,21,414
1207,947,749,198,234,179,141,168,225
1208,468,358,110,40,66,80,50,233
1209,167,142,25,21,16,25,14,91
1210,31,22,9,8,1,0,4,18
1211,882,530,352,30,75,111,118,547
1212,523,382,141,47,68,63,147,198
1213,538,372,166,12,77,43,129,277
1214,33,15,18,10,15,0,9,0
1215,1595,859,736,61,69,127,130,1208
1216,475,312,163,38,139,53,36,209
1217,414,274,140,23,70,34,49,237
1218,0,0,0,0,0,0,0,0
1219,720,543,177,85,32,89,116,398
1220,416,314,102,49,18,52,67,230
1221,2108,1031,1077,166,130,302,169,1341
1222,1031,495,536,39,58,79,46,809
1223,1093,610,483,56,90,73,24,851
1224,1432,766,666,87,141,125,51,1028
1225,2307,964,1343,150,168,313,98,1579
1226,324,251,73,0,0,73,90,160
1227,2419,1643,776,173,151,331,392,1372
1228,2409,1556,853,534,477,471,377,551
1229,2160,1569,591,292,441,240,394,793
1230,2047,1613,434,179,219,212,242,1196
1231,2493,1717,776,426,374,330,200,1163
1232,1366,864,502,105,147,107,106,900
1233,2593,1488,1105,197,352,229,144,1671
1234,1322,819,503,138,64,97,85,938
1235,2050,1243,807,165,344,176,187,1179
1236,2309,1355,954,120,250,212,320,1407
1237,1874,1098,776,118,180,211,154,1212
1238,1371,765,606,127,89,71,132,951
1239,2760,1649,1111,142,189,289,248,1893
1240,3235,2394,841,239,218,293,328,2158
1241,1112,710,402,47,55,133,74,803
1242,1185,749,436,50,91,158,88,798
1243,1002,666,336,90,60,58,63,731
1244,2506,1800,706,324,188,166,141,1687
1245,1097,746,351,48,96,91,41,821
1246,1501,962,539,147,161,171,121,902
1247,2023,1252,771,76,62,76,170,1639
1248,1387,785,602,94,99,87,67,1040
1249,2077,1279,798,199,93,178,135,1472
1250,2761,1454,1307,263,136,180,296,1886
1251,1955,770,1185,198,169,142,42,1404
1252,1790,898,892,80,137,144,109,1320
1253,1589,848,741,99,59,131,104,1197
1254,2112,1098,1014,180,355,124,87,1366
1255,2758,1529,1229,385,227,288,232,1626
1256,2834,1361,1473,238,286,314,258,1738
1257,1422,760,662,79,112,101,142,989
1258,3008,2380,628,405,296,365,382,1560
1259,1813,1241,572,114,238,212,203,1047
1260,1546,1054,492,123,87,149,145,1043
1261,2521,1524,997,332,116,259,241,1573
1262,2363,1311,1052,311,301,299,279,1173
1263,2060,1251,809,162,254,446,176,1021
1264,1076,746,330,140,186,154,287,308
1265,2388,1415,973,587,600,350,185,666
1266,1648,1015,633,238,232,172,176,832
1267,1526,1050,476,179,191,312,114,730
1268,1617,1013,604,199,239,191,180,807
1269,1431,820,611,120,203,102,118,889
1270,2363,1406,957,173,247,402,152,1389
1271,1340,874,466,150,138,229,168,655
1272,2003,1418,585,106,217,192,214,1274
1273,1951,1109,842,96,75,153,153,1473
1274,2045,1232,813,139,130,157,165,1454
1275,1697,1143,554,51,180,112,163,1191
1276,1934,1402,532,235,158,414,178,949
1277,3096,2212,884,215,333,405,374,1768
1278,355,274,81,50,50,25,101,129
1279,1691,1224,467,165,158,248,191,929
1280,1673,873,800,194,185,175,120,999
1281,2084,1197,887,196,293,372,106,1118
1282,1355,796,559,138,127,122,209,759
1283,0,0,0,0,0,0,0,0
1284,0,0,0,0,0,0,0,0
1285,1004,548,456,89,83,192,189,451
1286,886,440,446,96,84,139,125,443
1287,1068,629,439,55,179,204,137,493
1288,920,514,406,51,85,163,124,498
1289,635,385,250,226,156,75,11,167
1290,0,0,0,0,0,0,0,0
1291,0,0,0,0,0,0,0,0
1292,0,0,0,0,0,0,0,0
1293,1795,1275,520,200,163,205,198,1029
1294,0,0,0,0,0,0,0,0
1295,243,198,45,19,12,8,16,188
1296,0,0,0,0,0,0,0,0
1297,775,660,115,249,109,113,87,217
1298,2496,1652,844,488,586,484,286,652
1299,1377,1019,358,113,198,209,192,665
1300,1199,875,324,151,104,91,112,741
1301,2194,1339,855,206,383,178,216,1210
1302,730,465,265,312,92,76,53,197
1303,2760,1513,1247,453,343,414,203,1348
1304,0,0,0,0,0,0,0,0
1305,0,0,0,0,0,0,0,0
1306,415,209,206,30,70,78,59,179
1307,1149,625,524,312,250,256,140,190
1308,0,0,0,0,0,0,0,0
1309,0,0,0,0,0,0,0,0
1310,1038,806,232,106,192,455,98,186
1311,0,0,0,0,0,0,0,0
1312,1846,1329,517,173,246,337,183,907
1313,2942,2108,834,637,668,346,392,898
1314,2521,1812,709,204,317,451,284,1265
1315,606,375,231,28,49,106,79,344
1316,2024,1257,767,225,99,118,142,1440
1317,3251,2678,573,324,273,386,705,1563
1318,1068,721,347,136,80,153,58,641
1319,0,0,0,0,0,0,0,0
1320,548,249,299,51,171,103,17,206
1321,1944,1202,742,406,399,248,284,607
1322,2651,1551,1100,143,299,226,330,1652
1323,1912,1293,619,122,197,191,194,1207
1324,1586,1071,515,111,204,108,143,1021
1325,0,0,0,0,0,0,0,0
1326,2262,1264,998,456,463,433,335,575
1327,1041,354,687,166,464,199,102,110
1328,1044,463,581,77,114,139,269,446
1329,915,757,158,254,141,141,71,306
1330,555,356,199,73,75,53,48,306
1331,765,542,223,183,257,108,38,179
1332,1090,679,411,637,203,76,62,112
1333,242,199,43,64,45,0,20,113
1334,786,519,267,167,129,168,101,221
1335,1287,928,359,207,158,219,116,587
1336,264,242,22,91,76,10,42,45
1337,157,105,52,35,24,35,36,26
1338,1859,1331,528,165,257,176,174,1087
1339,288,273,15,61,9,22,32,164
1340,427,304,123,28,97,82,11,209
1341,430,262,168,68,61,28,42,231
1342,1556,1238,318,367,300,208,156,525
1343,718,503,215,131,150,113,51,273
1344,2108,1152,956,561,496,523,270,258
1345,699,413,286,161,79,144,171,143
1346,1793,1101,692,437,298,299,343,416
1347,493,158,335,16,155,170,50,102
1348,542,393,149,113,64,0,38,327
1349,1177,640,537,308,268,176,116,308
1350,360,143,217,37,190,61,17,55
1351,725,679,46,82,44,65,90,443
1352,363,329,34,111,104,64,29,55
1353,392,337,55,46,149,87,14,95
1354,1143,649,494,240,231,110,166,396
1355,424,301,123,104,123,78,36,82
1356,230,136,94,20,50,59,0,101
1357,416,216,200,68,21,15,35,277
1358,1046,840,206,204,54,114,103,570
1359,501,396,105,55,26,69,10,341
1360,423,306,117,0,65,36,50,272
1361,414,295,119,30,19,89,80,195
1362,451,314,137,30,72,93,66,191
1363,300,191,109,0,0,40,0,260
1364,477,226,251,96,77,94,55,155
1365,1566,1364,202,250,58,155,167,936
1366,405,254,151,38,10,51,44,262
1367,254,175,79,25,77,0,18,133
1368,419,343,76,63,60,16,31,249
1369,401,149,252,60,163,51,51,77
1370,290,120,170,18,73,35,30,135
1371,1321,458,863,324,352,236,183,226
1372,232,104,128,5,100,35,24,68
1373,377,145,232,27,69,108,68,105
1374,1198,1017,181,235,148,171,61,582
1375,210,50,160,39,53,9,40,70
1376,585,391,194,52,26,180,105,222
1377,542,383,159,202,175,28,66,71
1378,139,78,61,11,52,19,7,50
1379,527,342,185,156,43,117,74,136
1380,660,373,287,90,75,212,61,222
1381,327,206,121,84,152,40,20,32
1382,740,333,407,84,52,114,208,282
1383,362,158,204,112,45,51,69,84
1384,870,507,363,194,131,157,128,259
1385,444,326,118,22,24,42,9,347
1386,616,451,165,0,115,36,88,377
1387,535,364,171,79,149,118,62,126
1388,523,449,74,144,87,66,31,195
1389,562,388,174,58,119,48,98,239
1390,296,221,75,17,25,55,25,174
1391,275,244,31,114,18,42,36,65
1392,186,143,43,10,38,35,15,88
1393,643,545,98,148,104,44,117,230
1394,319,187,132,0,110,47,14,147
1395,372,199,173,41,163,85,32,52
1396,454,345,109,109,109,52,105,78
1397,536,217,319,86,158,99,62,132
1398,987,709,278,251,224,126,113,272
1399,574,445,129,75,79,166,126,128
1400,0,0,0,0,0,0,0,0
1401,656,387,269,165,0,30,33,428
1402,482,337,145,64,75,73,126,144
1403,609,380,229,84,81,101,32,311
1404,329,222,107,167,41,79,14,27
1405,226,226,0,125,37,20,0,44
1406,450,450,0,114,114,77,21,125
1407,568,387,181,95,195,63,18,197
1408,1055,931,124,185,172,108,99,491
1409,1015,899,116,641,134,104,98,38
1410,543,386,157,0,104,120,33,286
1411,1060,957,103,77,51,141,138,653
1412,426,348,78,28,52,71,41,234
1413,196,31,165,0,41,0,55,100
1414,603,371,232,73,188,99,58,185
1415,778,595,183,184,175,19,0,400
1416,484,383,101,90,123,39,28,204
1417,263,193,70,58,52,89,0,65
1418,788,386,402,165,385,109,61,68
1419,411,230,181,0,20,108,46,236
1420,409,358,51,134,97,64,32,83
1421,0,0,0,0,0,0,0,0
1422,822,589,233,73,114,78,77,481
1423,399,378,21,84,13,31,45,227
1424,1355,793,562,227,201,196,201,529
1425,851,404,447,136,181,157,139,238
1426,1031,675,356,108,130,140,169,484
1427,1904,956,948,103,220,400,285,896
1428,2307,1197,1110,160,317,455,436,939
1429,3127,1159,1968,126,25,125,196,2656
1430,1083,698,385,51,119,116,158,639
1431,1001,579,422,55,106,178,63,599
1432,871,491,380,81,72,118,83,518
1433,1107,596,511,140,70,127,81,689
1434,0,0,0,0,0,0,0,0
1435,1495,927,568,139,178,233,134,811
1436,1485,904,581,77,102,226,311,770
1437,670,465,205,147,109,37,22,355
1438,1485,707,778,167,63,110,28,1118
1439,483,291,192,32,70,96,90,194
1440,730,472,258,48,74,77,111,420
1441,1251,671,580,171,272,105,216,488
1442,1337,879,458,86,124,138,148,841
1443,980,570,410,102,102,143,136,497
1444,149,149,0,0,0,0,0,0
1445,1908,1082,826,282,179,234,340,872
1446,0,0,0,0,0,0,0,0
1447,311,205,106,38,49,33,26,165
1448,327,327,0,0,0,0,0,0
1449,0,0,0,0,0,0,0,0
1450,575,345,230,25,66,54,107,324
1451,1719,936,783,344,351,258,262,504
1452,1253,666,587,21,73,76,113,971
1453,3872,3138,734,422,552,688,339,1871
1454,1707,857,850,155,140,126,312,974
1455,895,390,505,142,166,183,163,240
1456,1121,397,724,270,238,243,149,220
1457,1139,424,715,150,162,257,190,380
1458,328,136,192,45,14,45,30,193
1459,849,407,442,55,134,172,123,366
1460,865,462,403,97,72,110,121,465
1461,1604,693,911,285,288,281,201,549
1462,417,106,311,40,47,85,115,130
1463,1616,1084,532,226,217,220,204,750
1464,1312,673,639,339,137,193,222,421
1465,1690,1014,676,156,262,229,199,845
1466,567,362,205,37,34,61,37,398
1467,1119,544,575,129,177,53,131,630
1468,823,531,292,60,101,74,85,503
1469,1753,661,1092,44,184,81,91,1353
1470,1425,921,504,242,197,196,149,641
1471,3936,1758,2178,196,150,233,110,3247
1472,1204,471,733,198,263,203,218,321
1473,1228,518,710,153,223,227,200,425
1474,1224,592,632,190,219,265,161,388
1475,205,119,86,86,56,35,0,29
1476,849,360,489,104,269,138,123,215
1477,2335,1568,767,836,525,332,216,425
1478,197,85,112,0,38,55,24,80
1479,2176,1212,964,245,245,369,422,896
1480,1325,832,493,127,280,212,121,585
1481,2247,1185,1062,269,518,369,305,785
1482,1408,685,723,288,294,254,231,342
1483,964,502,462,108,153,252,71,381
1484,1267,531,736,79,212,260,227,489
1485,1581,991,590,150,215,111,101,1005
1486,1530,1047,483,70,129,58,137,1136
1487,1490,962,528,281,110,175,90,833
1488,989,698,291,44,85,129,86,645
1489,2076,1285,791,101,296,268,303,1108
1490,689,377,312,57,70,73,69,420
1491,0,0,0,0,0,0,0,0
1492,1228,660,568,47,226,346,169,439
1493,1484,833,651,116,206,119,120,924
1494,1303,776,527,144,71,160,122,805
1495,2071,1070,1001,359,255,263,262,932
1496,1075,642,433,129,91,73,229,553
1497,304,135,169,50,129,70,21,35
1498,261,35,226,34,11,63,21,131
1499,359,186,173,212,51,49,20,26
1500,99,49,50,53,21,6,10,9
1501,99,73,26,52,23,7,8,8
1502,416,200,216,37,48,67,116,147
1503,671,437,234,24,44,140,56,408
1504,619,485,134,38,0,85,72,425
1505,498,357,141,149,84,77,25,164
1506,831,548,283,101,131,89,69,441
1507,558,340,218,160,136,78,80,104
1508,1434,799,635,468,297,193,181,295
1509,505,315,190,140,44,73,41,206
1510,601,375,226,104,49,114,85,250
1511,431,166,265,25,60,96,160,90
1512,276,202,74,28,79,34,81,54
1513,654,376,278,123,160,115,78,178
1514,165,87,78,36,27,34,37,32
1515,571,293,278,32,28,26,61,423
1516,693,264,429,46,121,87,94,345
1517,584,375,209,13,36,69,79,388
1518,581,352,229,50,38,40,101,352
1519,884,526,358,102,155,83,146,398
1520,536,274,262,34,26,68,126,282
1521,237,118,119,43,38,29,31,96
1522,1048,745,303,66,55,48,94,784
1523,431,226,205,0,98,60,74,198
1524,686,507,179,214,7,145,54,266
1525,1094,754,340,173,76,148,106,591
1526,765,451,314,52,105,68,118,422
1527,916,586,330,94,100,145,168,410
1528,306,119,187,119,0,68,0,119
1529,742,510,232,32,88,63,70,489
1530,619,408,211,75,97,66,52,329
1531,646,426,220,78,102,69,54,343
1532,2677,1437,1240,532,281,335,320,1209
1533,1332,750,582,68,167,54,79,964
1534,2710,1625,1085,71,148,149,133,2209
1535,2032,1468,564,183,287,248,197,1116
1536,1751,966,785,95,46,117,157,1336
1537,2103,1271,832,107,184,171,239,1402
1538,0,0,0,0,0,0,0,0
1539,1092,623,469,84,200,218,62,529
1540,1065,583,482,67,97,117,52,732
1541,1047,574,473,49,97,59,31,811
1542,1443,775,668,40,91,121,138,1053
1543,2099,1341,758,139,229,341,92,1299
1544,1681,970,711,74,137,166,193,1111
1545,748,466,282,141,95,172,96,244
1546,1908,1018,890,192,242,218,291,964
1547,1835,1130,705,295,371,245,281,642
1548,1452,813,639,178,190,219,181,685
1549,806,536,270,0,129,24,126,527
1550,998,476,522,39,76,106,141,636
1551,692,361,331,61,80,82,73,397
1552,1166,652,514,53,144,137,145,687
1553,1306,835,471,82,153,109,151,811
1554,1806,1041,765,148,212,136,203,1107
1555,2953,1927,1026,291,353,594,423,1291
1556,1494,679,815,109,226,367,131,661
1557,0,0,0,0,0,0,0,0
1558,0,0,0,0,0,0,0,0
1559,777,428,349,104,130,151,154,238
1560,1657,1089,568,164,305,167,202,820
1561,896,489,407,76,144,118,40,518
1562,1569,1092,477,114,383,222,153,697
1563,1223,720,503,96,103,113,114,796
1564,973,572,401,44,87,72,85,684
1565,1363,799,564,67,124,162,212,797
1566,1558,866,692,212,216,139,268,724
1567,1934,1245,689,261,284,296,276,817
1568,1256,790,466,56,115,185,195,705
1569,1301,860,441,60,147,141,123,829
1570,2332,1237,1095,164,293,110,245,1520
1571,1414,1007,407,232,130,255,136,661
1572,1739,1061,678,129,160,164,178,1108
1573,558,312,246,22,50,14,75,397
1574,256,134,122,44,41,42,14,115
1575,433,247,186,0,56,114,60,203
1576,337,179,158,16,38,8,52,223
1577,1539,706,833,351,409,211,294,275
1578,1597,818,779,122,180,307,231,756
1579,304,192,112,64,11,37,46,146
1580,1378,896,482,59,429,198,342,349
1581,1981,1019,962,20,95,199,143,1523
1582,311,193,118,15,71,35,40,150
1583,467,362,105,0,102,41,74,251
1584,603,413,190,22,65,119,32,367
1585,1324,738,586,50,110,173,173,819
1586,623,422,201,66,29,63,79,387
1587,725,325,400,0,0,73,129,523
1588,534,344,190,119,85,83,68,179
1589,485,324,161,107,97,123,83,75
1590,592,311,281,14,105,39,75,358
1591,579,412,167,89,87,98,70,235
1592,298,146,152,0,17,52,7,223
1593,0,0,0,0,0,0,0,0
1594,1307,809,498,70,90,283,127,737
1595,1934,1049,885,237,447,236,233,780
1596,535,355,180,36,69,87,66,276
1597,1378,985,393,70,171,97,163,877
1598,0,0,0,0,0,0,0,0
1599,1514,1160,354,72,172,153,125,993
1600,2429,1313,1116,169,122,213,174,1752
1601,322,204,118,24,28,97,0,174
1602,2516,1357,1159,159,133,169,279,1776
1603,1055,403,652,167,227,132,174,354
1604,2860,1908,952,382,287,326,522,1342
1605,0,0,0,0,0,0,0,0
1606,546,371,175,29,49,118,73,277
1607,1646,949,697,102,179,237,225,903
1608,801,449,352,9,152,137,35,468
1609,551,290,261,81,45,34,112,279
1610,432,295,137,39,74,25,66,228
1611,911,486,425,161,285,125,50,289
1612,622,398,224,71,44,153,155,199
1613,860,537,323,124,73,83,147,432
1614,225,89,136,45,10,21,21,127
1615,250,118,132,49,43,25,37,96
1616,688,352,336,101,167,80,119,221
1617,377,268,109,94,68,97,28,91
1618,599,445,154,41,35,148,61,314
1619,1780,1045,735,178,162,237,203,1001
1620,123,83,40,39,38,17,11,18
1621,591,293,298,72,83,172,38,226
1622,420,171,249,110,112,33,47,118
1623,185,94,91,73,58,19,12,23
1624,572,222,350,119,121,161,49,121
1625,345,220,125,69,52,74,13,137
1626,1211,733,478,71,222,119,143,656
1627,937,661,276,160,151,62,70,494
1628,294,147,147,19,88,50,14,122
1629,358,121,237,65,106,77,27,83
1630,504,345,159,75,208,32,7,181
1631,794,544,250,105,76,64,20,528
1632,594,287,307,116,72,142,90,174
1633,781,417,364,127,143,147,83,283
1634,315,155,160,63,68,66,64,54
1635,558,401,157,83,171,67,76,161
1636,1834,1173,661,115,153,133,277,1155
1637,648,427,221,17,127,96,155,253
1638,1097,632,465,93,69,92,88,755
1639,1651,971,680,68,182,89,203,1109
1640,1115,685,430,7,29,60,43,976
1641,1236,824,412,33,22,132,84,965
1642,1957,1063,894,162,202,118,178,1297
1643,4740,2317,2423,356,287,219,372,3506
1644,2817,1406,1411,185,199,313,428,1692
1645,1754,1102,652,142,165,164,195,1087
1646,1326,874,452,46,28,104,81,1067
1647,1049,600,449,46,49,104,174,675
1648,218,218,0,0,0,0,0,0
1649,817,516,301,58,118,109,70,461
1650,998,622,376,27,36,113,88,734
1651,414,205,209,27,87,111,36,153
1652,0,0,0,0,0,0,0,0
1653,1541,1053,488,0,177,218,127,1019
1654,2830,1660,1170,178,288,391,362,1610
1655,0,0,0,0,0,0,0,0
1656,324,172,152,11,19,45,45,203
1657,1170,704,466,65,100,100,85,820
1658,428,380,48,42,44,97,30,216
1659,1775,967,808,101,127,133,176,1238
1660,611,424,187,78,62,63,86,322
1661,0,0,0,0,0,0,0,0
1662,0,0,0,0,0,0,0,0
1663,1161,713,448,12,85,83,165,816
1664,2442,1488,954,256,447,338,289,1112
1665,0,0,0,0,0,0,0,0
1666,1175,683,492,120,294,139,119,503
1667,1059,643,416,111,95,132,89,632
1670,955,571,384,195,287,182,103,187
1671,376,265,111,0,19,9,85,263
1672,875,573,302,57,18,70,109,622
1673,1205,749,456,96,70,147,71,821
1674,677,433,244,50,50,105,94,377
1675,557,291,266,28,43,93,39,354
1676,323,239,84,18,23,21,54,207
1677,614,478,136,146,56,100,150,162
1678,471,279,192,58,72,25,33,284
1679,593,350,243,62,48,57,103,322
1680,614,517,97,93,116,60,35,309
1681,456,362,94,70,154,109,37,87
1682,1809,1000,809,100,128,259,132,1190
1683,662,394,268,29,47,34,45,507
1684,323,214,109,13,27,21,42,220
1685,756,489,267,60,79,67,41,510
1686,833,513,320,15,50,33,78,657
1687,570,395,175,27,39,188,84,233
1688,449,169,280,22,59,135,69,165
1689,844,554,290,20,72,100,144,507
1690,1095,576,519,3,42,55,52,943
1691,1530,1167,363,174,151,23,480,701
1692,287,130,157,53,0,56,47,130
1693,0,0,0,0,0,0,0,0
1694,738,404,334,48,60,0,133,497
1695,890,671,219,15,19,101,82,674
1696,658,482,176,170,74,123,82,209
1697,685,457,228,186,97,49,62,291
1698,1498,653,845,72,53,90,75,1207
1699,331,174,157,36,34,60,75,126
1700,1043,598,445,111,145,138,97,553
1701,325,187,138,29,31,58,19,188
1702,435,279,156,27,41,79,91,197
1703,506,319,187,32,43,63,80,289
1704,647,396,251,39,45,48,24,491
1705,675,428,247,42,75,99,64,395
1706,660,356,304,5,66,56,37,495
1707,761,358,403,43,0,15,107,596
1708,0,0,0,0,0,0,0,0
1709,339,196,143,27,48,19,101,144
1710,248,152,96,54,75,6,14,99
1711,427,181,246,14,54,23,10,326
1712,419,251,168,26,70,24,31,268
1713,1014,663,351,62,122,117,99,613
1714,895,519,376,100,94,131,82,488
1715,511,347,164,119,88,41,16,248
1716,573,350,223,58,187,58,133,138
1717,1085,547,538,109,182,170,122,502
1718,1076,720,356,42,198,85,79,672
1719,87,87,0,0,0,0,0,0
1720,64,27,37,1,4,4,3,52
1721,22,10,12,0,0,0,12,10
1722,0,0,0,0,0,0,0,0
1723,450,239,211,16,27,63,63,282
1724,246,156,90,15,27,36,23,144
1725,3267,1316,1951,182,285,173,321,2306
1726,0,0,0,0,0,0,0,0
1727,0,0,0,0,0,0,0,0
1728,0,0,0,0,0,0,0,0
1729,0,0,0,0,0,0,0,0
1730,0,0,0,0,0,0,0,0
1731,690,437,253,54,66,60,98,412
1732,0,0,0,0,0,0,0,0
1733,536,294,242,13,128,36,28,331
1734,1020,615,405,54,159,116,71,620
1735,882,573,309,31,99,49,158,545
1736,480,226,254,24,116,52,103,185
1737,0,0,0,0,0,0,0,0
1738,0,0,0,0,0,0,0,0
1739,2512,1235,1277,175,300,352,577,1108
1740,0,0,0,0,0,0,0,0
1741,539,380,159,49,30,32,83,345
1742,750,450,300,28,37,124,108,454
1743,933,622,311,90,108,112,143,481
1744,1203,600,603,57,169,197,315,465
1745,1214,606,608,22,65,97,142,887
1746,2101,964,1137,122,133,259,176,1410
1747,0,0,0,0,0,0,0,0
1748,1426,971,455,172,186,256,332,480
1749,0,0,0,0,0,0,0,0
1750,63,19,44,3,6,7,4,43
1751,1036,562,474,37,83,89,72,755
1752,727,357,370,33,41,24,18,611
1753,651,316,335,18,17,76,24,516
1754,2146,1081,1065,113,258,394,402,979
1755,1057,647,410,58,106,135,149,609
1756,2120,1222,898,149,230,343,269,1130
1757,0,0,0,0,0,0,0,0
1758,2330,1012,1318,195,210,129,169,1627
1759,0,0,0,0,0,0,0,0
1760,1213,706,507,66,15,98,45,989
1761,1210,773,437,24,105,50,48,984
1762,535,356,179,28,16,151,110,229
1763,1215,683,532,122,225,138,304,425
1764,1853,1065,788,144,309,282,320,797
1765,2945,1761,1184,194,295,343,444,1669
1766,1830,1108,722,36,379,208,204,1003
1767,0,0,0,0,0,0,0,0
1768,942,609,333,103,106,145,65,523
1769,0,0,0,0,0,0,0,0
1770,0,0,0,0,0,0,0,0
1771,1697,1313,384,252,208,152,244,841
1772,2319,1212,1107,148,294,237,253,1387
1773,1671,877,794,74,110,126,196,1164
1774,1759,887,872,106,181,174,167,1131
1775,1410,835,575,153,131,225,158,742
1776,0,0,0,0,0,0,0,0
1780,337,175,162,4,10,2,32,288
1781,265,171,94,24,41,36,22,143
1782,967,789,178,197,168,104,166,331
1783,713,304,409,36,57,34,51,535
1784,1179,765,414,197,31,107,314,530
1785,292,125,167,0,9,23,21,240
1786,223,118,105,38,14,24,25,122
1787,842,374,468,10,144,86,151,452
1788,632,335,297,27,43,137,89,336
1789,779,425,354,39,90,146,79,425
1790,1320,716,604,108,119,146,137,810
1791,416,231,185,27,34,98,44,213
1792,384,156,228,0,26,39,95,225
1793,827,508,319,33,25,69,153,548
1794,617,403,214,141,147,48,52,229
1795,1000,306,694,50,91,104,70,686
1796,723,595,128,117,152,26,50,378
1797,513,258,255,22,21,15,36,420
1798,137,78,59,8,12,14,14,89
1799,605,286,319,28,22,29,115,411
1800,650,412,238,110,51,81,40,368
1801,906,382,524,0,16,30,89,772
1802,983,640,343,34,74,256,196,423
1803,351,205,146,36,0,21,21,273
1804,407,210,197,40,16,11,30,310
1805,816,417,399,114,87,56,199,360
1806,917,513,404,16,14,100,95,692
1807,440,226,214,13,13,0,26,388
1808,1324,843,481,71,183,138,141,791
1809,654,488,166,108,124,30,70,322
1810,632,271,361,66,71,23,57,415
1811,334,226,108,29,24,48,58,174
1812,6,2,4,0,0,1,0,5
1813,838,545,293,69,74,61,91,543
1814,336,246,90,16,19,40,21,240
1815,568,240,328,20,8,31,25,485
1816,213,139,74,10,17,42,10,134
1817,1300,816,484,114,201,53,116,816
1818,696,352,344,0,166,119,25,386
1819,432,178,254,13,58,74,80,207
1820,334,217,117,20,71,84,42,117
1821,353,158,195,19,31,113,53,136
1822,403,259,144,41,18,42,47,255
1823,1205,942,263,134,34,70,228,739
1824,1316,839,477,168,98,141,99,809
1825,448,302,146,60,62,86,78,162
1826,500,310,190,32,48,84,81,256
1827,353,191,162,9,68,109,75,92
1828,621,465,156,76,124,33,65,323
1829,928,430,498,56,54,28,112,678
1830,383,190,193,108,8,64,86,117
1831,904,584,320,87,79,192,145,401
1832,552,345,207,177,97,48,44,187
1833,407,280,127,101,104,72,45,85
1834,609,199,410,47,97,14,51,400
1835,382,264,118,35,48,13,0,287
1836,509,234,275,112,58,76,82,181
1837,452,286,166,109,69,14,49,211
1838,380,175,205,22,28,16,57,256
1839,316,202,114,24,50,125,19,97
1840,348,171,177,64,23,81,51,129
1841,455,276,179,97,29,99,61,169
1842,884,461,423,82,199,153,76,374
1843,629,351,278,13,132,46,82,355
1844,596,317,279,97,61,37,121,280
1845,472,287,185,37,76,46,40,273
1846,802,513,289,28,47,126,35,567
1847,572,452,120,197,54,0,35,286
1848,475,296,179,18,88,50,99,219
1849,592,348,244,26,41,84,87,354
1850,376,218,158,18,56,26,79,197
1851,575,454,121,147,188,75,87,78
1852,204,158,46,23,95,51,0,36
1853,369,242,127,69,63,57,11,169
1854,345,204,141,34,39,26,39,207
1855,721,340,381,67,72,61,114,406
1856,1076,669,407,90,145,292,161,388
1857,556,266,290,51,93,66,53,293
1858,375,203,172,47,0,0,201,126
1859,108,38,70,2,4,12,2,89
1860,477,362,115,24,106,41,88,219
1861,483,276,207,74,8,25,92,285
1862,523,266,257,9,40,113,13,349
1863,647,287,360,74,61,143,116,253
1864,889,453,436,34,59,88,81,628
1865,451,290,161,46,44,103,39,219
1866,367,172,195,23,75,171,48,50
1867,359,176,183,38,36,92,103,90
1868,695,308,387,117,18,30,136,395
1869,209,153,56,0,22,37,13,136
1870,981,479,502,98,122,266,74,421
1871,421,291,130,21,46,48,71,235
1872,420,171,249,23,20,0,75,301
1873,1004,599,405,86,154,89,209,467
1874,386,386,0,0,0,0,0,0
1875,0,0,0,0,0,0,0,0
1876,197,122,75,12,19,33,32,101
1877,209,209,0,0,0,0,0,0
1878,0,0,0,0,0,0,0,0
1879,0,0,0,0,0,0,0,0
1880,359,191,168,62,23,38,40,197
1881,31,13,18,2,2,1,2,23
1882,12,5,7,1,1,1,1,9
1883,0,0,0,0,0,0,0,0
1884,131,56,75,7,11,6,9,98
1885,80,80,0,0,0,0,0,0
1886,0,0,0,0,0,0,0,0
1887,0,0,0,0,0,0,0,0
1888,0,0,0,0,0,0,0,0
1889,0,0,0,0,0,0,0,0
1890,1044,731,313,160,159,126,178,422
1891,1038,698,340,47,195,86,128,582
1892,492,283,209,117,59,69,131,116
1893,0,0,0,0,0,0,0,0
1894,1373,911,462,163,135,213,172,690
1895,3126,2013,1113,153,291,345,375,1961
1896,2378,1619,759,106,220,228,439,1385
1897,742,552,190,16,86,93,101,445
1898,1186,792,394,220,284,206,201,275
1899,1300,912,388,97,211,116,95,780
1900,1657,1124,533,126,188,269,150,924
1901,0,0,0,0,0,0,0,0
1902,1568,955,613,306,284,275,286,417
1903,1513,907,606,125,262,232,242,652
1904,1359,802,557,123,172,271,237,555
1905,1642,1010,632,247,160,378,174,683
1906,0,0,0,0,0,0,0,0
1907,1166,777,389,146,183,190,126,522
1908,1392,1067,325,87,201,97,108,899
1909,1623,965,658,356,459,298,140,370
1910,888,462,426,158,203,97,130,300
1911,766,533,233,281,215,120,47,103
1912,858,503,355,63,146,210,126,314
1913,294,100,194,53,100,92,12,37
1914,0,0,0,0,0,0,0,0
1915,1069,693,376,54,217,123,228,447
1916,759,405,354,74,192,150,112,231
1917,0,0,0,0,0,0,0,0
1918,706,424,282,71,103,157,112,262
1919,676,322,354,69,62,106,49,390
1920,0,0,0,0,0,0,0,0
1921,0,0,0,0,0,0,0,0
1922,1337,923,414,145,157,134,181,720
1923,0,0,0,0,0,0,0,0
1924,0,0,0,0,0,0,0,0
1925,986,676,310,61,210,136,112,468
1926,1397,1004,393,98,199,134,240,726
1927,1124,756,368,207,309,232,92,285
1928,0,0,0,0,0,0,0,0
1929,1305,667,638,211,282,97,179,535
1930,1309,825,484,172,197,235,161,544
1931,1055,722,333,209,269,104,139,334
1932,786,487,299,209,259,113,127,79
1933,2172,1231,941,155,58,106,257,1597
1934,1208,890,318,44,113,189,198,663
1935,438,314,124,87,41,91,43,176
1936,1004,573,431,117,166,187,119,416
1937,1580,943,637,159,214,209,252,746
1938,0,0,0,0,0,0,0,0
1939,1166,844,322,242,193,258,157,316
1940,539,213,326,74,146,89,57,172
1941,0,0,0,0,0,0,0,0
1942,681,415,266,118,79,112,123,249
1943,661,432,229,161,146,53,98,203
1944,1108,454,654,171,277,276,162,221
1945,882,486,396,190,93,160,112,326
1946,0,0,0,0,0,0,0,0
1947,1680,902,778,149,243,319,202,767
1948,851,498,353,111,160,156,146,277
1949,419,180,239,113,107,66,67,67
1950,678,266,412,148,257,113,143,16
1951,355,262,93,17,8,95,40,196
1952,536,290,246,63,135,23,154,161
1953,340,280,60,117,81,0,83,59
1954,350,265,85,116,49,36,75,74
1955,507,321,186,131,80,49,32,216
1956,740,523,217,116,109,219,104,192
1957,376,230,146,100,55,116,58,47
1958,430,350,80,72,38,76,0,244
1959,543,422,121,130,124,159,62,67
1960,490,296,194,60,161,34,112,123
1961,413,335,78,105,128,62,69,48
1962,296,296,0,74,72,25,51,74
1963,927,691,236,29,89,85,258,466
1964,546,251,295,62,230,77,69,109
1965,841,534,307,50,198,53,113,427
1966,637,359,278,115,105,172,145,101
1967,737,497,240,181,139,96,202,120
1968,954,521,433,99,288,117,137,314
1969,461,329,132,117,154,111,48,31
1970,345,250,95,140,80,63,19,42
1971,821,620,201,149,221,188,84,179
1972,273,206,67,0,67,91,41,75
1973,568,431,137,107,102,73,81,205
1974,261,140,121,61,48,0,23,130
1975,918,504,414,26,10,49,175,659
1976,453,238,215,23,69,83,79,198
1977,787,408,379,40,94,115,270,267
1978,202,127,75,47,31,26,54,43
1979,227,188,39,80,30,61,9,47
1980,762,445,317,101,236,177,89,159
1981,380,211,169,56,110,90,68,56
1982,915,684,231,282,208,84,90,252
1983,275,223,52,41,40,55,35,103
1984,492,274,218,30,58,54,107,243
1985,654,514,140,71,111,204,80,188
1986,460,347,113,63,74,32,53,238
1987,728,430,298,146,101,65,92,324
1988,411,286,125,163,42,111,32,63
1989,632,366,266,26,47,203,104,252
1990,169,31,138,36,56,37,5,36
1991,603,180,423,72,196,159,62,114
1992,771,493,278,69,149,189,81,284
1993,651,502,149,76,159,84,76,257
1994,627,407,220,195,222,137,43,30
1995,927,500,427,244,275,78,122,208
1996,266,175,91,37,100,16,22,91
1997,928,491,437,207,234,161,147,180
1998,334,178,156,27,68,40,61,139
1999,357,188,169,109,68,73,41,65
2000,701,419,282,133,234,173,127,34
2001,448,224,224,22,22,182,62,159
2002,941,674,267,123,179,238,129,272
2003,180,111,69,45,29,34,11,61
2004,273,173,100,13,10,54,115,80
2005,598,367,231,118,112,153,95,120
2006,531,308,223,86,111,177,58,99
2007,754,338,416,132,177,147,135,163
2008,536,324,212,36,122,102,61,216
2009,344,188,156,0,45,120,81,98
2010,641,349,292,137,116,129,61,197
2011,390,163,227,42,97,122,55,75
2012,420,243,177,124,138,85,8,65
2013,418,275,143,73,48,28,67,203
2014,594,437,157,108,163,54,57,212
2015,496,331,165,31,109,110,28,219
2016,728,600,128,165,130,126,124,183
2017,251,178,73,54,27,52,45,73
2018,345,261,84,0,52,35,49,209
2019,531,348,183,114,66,71,138,142
2020,1078,655,423,193,250,289,102,244
2021,428,312,116,55,109,81,96,87
2022,393,272,121,38,99,107,47,102
2023,272,155,117,40,73,38,35,86
2024,254,121,133,45,44,33,23,108
2025,403,282,121,61,49,60,105,128
2026,860,612,248,220,103,113,73,351
2027,637,361,276,179,211,60,146,40
2028,464,289,175,0,18,146,56,244
2029,1030,662,368,81,84,186,266,413
2030,212,212,0,66,10,27,32,77
2031,242,142,100,22,30,71,21,97
2032,586,241,345,239,123,48,69,107
2033,320,308,12,112,65,30,31,83
2034,387,292,95,74,79,51,35,147
2035,738,378,360,122,56,212,187,161
2036,611,227,384,56,140,179,81,155
2037,369,281,88,23,27,62,111,146
2038,842,495,347,92,172,153,125,300
2039,243,105,138,37,66,44,35,61
2040,545,331,214,0,16,164,14,352
2041,1070,644,426,94,272,100,47,557
2042,745,550,195,107,104,165,154,215
2043,350,272,78,11,64,12,57,206
2044,305,236,69,0,75,77,0,153
2045,599,313,286,64,116,26,2,391
2046,712,482,230,99,181,183,115,134
2047,405,261,144,42,94,93,40,136
2048,685,521,164,72,211,201,123,78
2049,431,300,131,151,92,103,48,38
2050,376,232,144,126,48,76,17,109
2051,276,125,151,39,62,61,46,68
2052,648,360,288,125,167,127,73,156
2053,516,329,187,249,33,75,20,139
2054,631,460,171,144,46,121,138,183
2055,193,117,76,6,68,29,32,58
2056,485,336,149,93,74,105,19,194
2057,591,406,185,137,160,92,93,109
2058,725,363,362,182,90,94,166,193
2059,455,216,239,40,118,93,46,158
2060,532,310,222,47,180,119,51,135
2061,674,454,220,110,93,86,56,328
2062,316,256,60,47,61,72,53,82
2063,915,613,302,288,251,115,86,175
2064,909,606,303,160,158,199,104,289
2065,928,580,348,182,244,203,54,246
2066,439,327,112,76,121,98,72,72
2067,548,337,211,96,79,140,76,157
2068,781,431,350,195,201,127,129,128
2069,282,207,75,59,35,102,26,59
2070,174,110,64,41,27,23,47,37
2071,60,40,20,10,8,8,5,29
2072,0,0,0,0,0,0,0,0
2073,5,4,1,0,0,1,2,2
2074,569,245,324,154,145,89,91,91
2075,260,260,0,65,63,22,45,65
2076,79,64,15,12,11,16,10,30
2077,196,159,37,29,29,39,25,74
2078,199,123,76,49,32,37,12,67
2079,0,0,0,0,0,0,0,0
2080,400,184,216,41,163,76,71,49
2081,472,427,45,44,56,83,49,240
2082,2390,1714,676,127,109,238,160,1756
2083,802,587,215,34,44,42,57,625
2084,0,0,0,0,0,0,0,0
2085,0,0,0,0,0,0,0,0
2086,0,0,0,0,0,0,0,0
2087,46,46,0,0,0,0,0,0
2088,295,239,56,19,73,34,63,106
2089,0,0,0,0,0,0,0,0
2090,1371,1016,355,123,113,240,151,744
2091,0,0,0,0,0,0,0,0
2092,0,0,0,0,0,0,0,0
2093,0,0,0,0,0,0,0,0
2094,1285,748,537,61,45,61,136,981
2095,0,0,0,0,0,0,0,0
2096,707,459,248,40,15,53,48,550
2097,2454,1683,771,25,200,281,244,1703
2098,1869,1403,466,65,139,95,123,1447
2099,0,0,0,0,0,0,0,0
2100,0,0,0,0,0,0,0,0
2101,0,0,0,0,0,0,0,0
2102,476,307,169,190,74,54,68,90
2103,1018,780,238,62,74,84,101,697
2104,1310,1030,280,61,129,92,212,816
2105,0,0,0,0,0,0,0,0
2106,261,155,106,45,48,47,20,101
2107,1109,802,307,32,152,137,120,668
2108,39,39,0,0,0,0,0,0
2109,1527,861,666,53,67,138,39,1230
2110,0,0,0,0,0,0,0,0
2111,345,170,175,80,69,63,0,133
2112,0,0,0,0,0,0,0,0
2113,1583,901,682,371,309,307,245,350
2114,1426,1014,412,179,118,295,215,618
2115,608,345,263,46,134,32,60,336
2116,2439,1414,1025,141,166,247,407,1478
2117,2589,1631,958,156,262,253,187,1732
2118,0,0,0,0,0,0,0,0
2119,92,92,0,0,0,0,0,0
2120,0,0,0,0,0,0,0,0
2121,777,660,117,67,121,126,160,302
2122,0,0,0,0,0,0,0,0
2123,0,0,0,0,0,0,0,0
2124,0,0,0,0,0,0,0,0
2125,299,213,86,76,27,79,15,101
2126,0,0,0,0,0,0,0,0
2127,0,0,0,0,0,0,0,0
2128,0,0,0,0,0,0,0,0
2129,248,167,81,16,0,23,32,177
2130,399,253,146,36,87,48,37,191
2131,488,335,153,16,21,102,57,292
2132,341,125,216,58,177,27,6,72
2133,236,154,82,54,83,69,0,29
2134,410,328,82,8,49,92,37,223
2135,499,326,173,86,37,87,73,216
2136,398,372,26,182,20,144,21,32
2137,226,64,162,35,45,56,40,50
2138,476,267,209,159,18,47,0,253
2139,283,248,35,72,36,22,29,125
2140,452,326,126,218,33,17,22,161
2141,2437,2212,225,628,620,450,331,408
2142,274,111,163,227,34,13,0,0
2143,88,67,21,20,18,20,11,19
2144,429,402,27,184,99,43,14,89
2145,0,0,0,0,0,0,0,0
2146,911,756,155,215,164,76,122,334
2147,381,265,116,57,73,80,34,137
2148,1343,1145,198,615,204,247,36,241
2149,1381,993,388,252,203,204,115,607
2150,373,301,72,71,51,100,43,109
2151,491,293,198,219,119,49,60,44
2152,433,329,104,15,78,23,112,205
2153,437,281,156,18,34,62,67,256
2154,358,206,152,74,96,88,46,54
2155,391,144,247,101,86,77,64,63
2156,431,280,151,163,75,79,55,59
2157,486,331,155,55,179,90,45,116
2158,302,171,131,93,50,73,39,46
2159,529,218,311,104,163,91,92,78
2160,1090,891,199,134,127,171,131,527
2161,648,528,120,189,200,100,66,92
2162,647,376,271,187,206,123,103,28
2163,267,228,39,36,20,93,8,109
2164,1014,872,142,190,235,167,127,295
2165,881,819,62,360,129,55,124,213
2166,676,545,131,194,149,226,60,46
2167,558,417,141,201,151,94,93,20
2168,402,353,49,145,70,74,99,14
2169,267,163,104,0,36,17,0,214
2170,702,628,74,199,151,152,39,161
2171,511,451,60,218,170,47,23,54
2172,406,353,53,215,29,56,19,87
2173,495,329,166,43,110,56,50,235
2174,558,385,173,72,84,123,64,216
2175,714,614,100,261,237,99,15,102
2176,987,639,348,124,62,125,57,619
2177,400,273,127,123,39,102,25,110
2178,550,392,158,83,144,94,87,141
2179,412,387,25,151,73,47,35,106
2180,393,357,36,99,173,22,86,13
2181,334,187,147,59,30,126,69,50
2182,264,201,63,78,29,95,5,57
2183,406,250,156,148,45,74,47,93
2184,465,321,144,193,80,82,58,52
2185,352,160,192,134,75,56,44,43
2186,169,102,67,84,34,23,12,16
2187,0,0,0,0,0,0,0,0
2188,346,294,52,64,26,72,21,162
2189,549,428,121,31,51,98,109,261
2190,468,312,156,98,154,85,50,81
2191,357,138,219,159,72,87,25,14
2192,275,131,144,64,107,77,0,26
2193,662,376,286,155,221,76,90,120
2194,402,225,177,160,69,102,25,47
2195,310,153,157,104,65,60,24,57
2196,526,328,198,148,171,53,105,49
2197,571,354,217,97,173,62,126,113
2198,323,195,128,61,67,42,68,84
2199,408,323,85,62,106,80,38,123
2200,408,240,168,79,182,61,36,51
2201,376,249,127,7,20,17,29,302
2202,450,386,64,21,68,76,65,220
2203,401,355,46,30,44,63,50,213
2204,496,353,143,271,102,23,62,38
2205,277,244,33,71,42,46,11,106
2206,765,661,104,25,169,140,126,304
2207,423,388,35,66,82,62,60,153
2208,843,325,518,422,288,18,115,0
2209,607,319,288,172,155,46,144,90
2210,500,279,221,124,92,159,80,45
2211,373,221,152,90,42,42,108,91
2212,358,186,172,27,57,8,60,205
2213,347,192,155,17,39,43,26,223
2214,399,236,163,72,242,72,0,13
2215,632,224,408,179,222,90,52,89
2216,288,127,161,57,136,70,14,11
2217,577,319,258,147,188,59,57,126
2218,0,0,0,0,0,0,0,0
2219,540,370,170,163,89,175,51,61
2220,427,299,128,88,101,82,50,106
2221,544,344,200,107,166,43,128,101
2222,240,115,125,64,62,14,23,78
2223,239,140,99,54,34,59,11,81
2224,272,114,158,58,70,52,26,66
2225,284,131,153,87,94,53,31,19
2226,144,90,54,56,19,30,13,26
2227,466,354,112,53,88,110,41,175
2228,273,193,80,166,58,17,3,28
2229,425,287,138,136,130,96,11,53
2230,282,134,148,52,99,95,8,28
2231,495,215,280,57,248,59,50,81
2232,442,354,88,147,121,109,34,32
2233,603,587,16,353,55,9,73,114
2234,385,324,61,74,31,47,19,214
2235,665,362,303,167,219,125,43,111
2236,302,93,209,183,20,83,0,16
2237,291,160,131,90,113,37,14,38
2238,379,80,299,92,69,94,66,58
2239,456,369,87,147,73,65,65,105
2240,294,98,196,119,139,0,10,26
2241,229,130,99,137,11,7,11,64
2242,733,644,89,53,108,124,150,298
2243,1127,751,376,106,74,251,90,607
2244,607,504,103,173,134,77,58,166
2245,350,230,120,83,103,66,37,61
2246,500,374,126,175,112,79,60,74
2247,289,179,110,33,0,47,56,153
2248,380,161,219,142,79,83,46,29
2249,562,163,399,105,181,78,57,142
2250,457,204,253,158,166,52,50,30
2251,234,171,63,57,48,63,55,12
2252,340,206,134,87,119,67,0,67
2253,286,206,80,55,29,55,54,93
2254,708,507,201,79,126,151,122,230
2255,633,562,71,354,107,56,36,79
2256,350,337,13,52,11,84,22,181
2257,0,0,0,0,0,0,0,0
2258,539,206,333,180,65,127,78,89
2259,270,185,85,29,19,19,0,202
2260,242,111,131,55,73,0,52,62
2261,551,300,251,27,78,31,16,399
2262,319,188,131,107,85,73,15,38
2263,294,178,116,78,21,76,74,46
2264,505,279,226,114,189,49,67,85
2265,243,157,86,11,9,7,36,180
2266,726,699,27,154,83,134,185,171
2267,360,259,101,21,41,69,24,206
2268,1192,948,244,844,154,13,0,181
2269,831,720,111,96,124,100,190,322
2270,428,322,106,79,72,103,42,134
2271,232,117,115,75,88,22,7,40
2272,646,567,79,108,125,122,20,271
2273,355,281,74,102,56,62,39,97
2274,731,566,165,61,143,79,71,376
2275,556,399,157,72,77,120,20,267
2276,278,201,77,67,52,90,21,48
2277,421,321,100,163,92,57,35,73
2278,245,135,110,86,66,24,28,42
2279,358,276,82,11,44,41,30,233
2280,406,271,135,11,27,50,0,318
2281,0,0,0,0,0,0,0,0
2282,1133,671,462,280,212,113,74,454
2283,547,361,186,105,128,111,20,183
2284,389,248,141,29,90,23,49,198
2285,589,397,192,331,124,44,9,81
2286,117,103,14,35,14,10,11,47
2287,366,330,36,34,61,80,45,146
2288,359,266,93,78,89,49,68,75
2289,454,266,188,22,53,45,35,299
2290,671,578,93,150,217,183,28,93
2291,37,27,10,0,10,0,0,27
2292,342,311,31,11,30,19,28,254
2293,487,364,123,34,95,0,93,265
2294,303,273,30,0,15,72,106,110
2295,1051,873,178,213,160,229,135,314
2296,613,439,174,99,56,89,93,275
2297,554,456,98,165,91,84,60,154
2298,574,372,202,80,76,62,131,224
2299,538,427,111,118,50,34,87,250
2300,266,206,60,36,46,33,39,111
2301,1109,794,315,243,138,152,204,371
2302,277,209,68,20,23,39,53,142
2303,481,350,131,73,32,44,42,291
2304,479,349,130,36,36,35,23,348
2305,137,137,0,0,0,0,0,0
2306,950,888,62,112,151,155,227,305
2307,874,769,105,117,124,197,103,334
2308,410,390,20,18,79,131,59,124
2309,675,570,105,151,91,162,64,207
2310,351,276,75,99,40,145,39,29
2311,332,225,107,150,41,70,22,49
2312,266,166,100,96,36,39,31,64
2313,383,284,99,22,9,30,66,257
2314,253,142,111,23,37,42,26,125
2315,384,237,147,154,84,19,37,91
2316,339,198,141,82,36,119,46,56
2317,15,12,3,3,0,0,12,0
2318,494,341,153,254,129,50,16,45
2319,355,169,186,108,90,54,36,68
2320,1760,1546,214,620,278,125,99,638
2321,1069,931,138,566,123,111,56,214
2322,602,464,138,133,97,81,53,237
2323,552,361,191,36,19,85,55,357
2324,342,276,66,0,85,64,13,181
2325,390,277,113,114,77,23,41,135
2326,260,179,81,0,34,30,14,182
2327,343,238,105,160,38,37,66,41
2328,335,242,93,43,52,128,14,99
2329,1179,1006,173,236,253,226,70,394
2330,409,386,23,147,69,151,0,43
2331,502,469,33,118,80,103,18,183
2332,660,625,35,102,144,125,153,137
2333,1883,1670,213,152,459,230,323,720
2334,615,535,80,127,93,148,101,145
2335,1018,1000,18,174,135,256,99,354
2336,420,363,57,54,24,55,86,202
2337,854,799,55,70,158,184,117,325
2338,1086,1028,58,191,129,115,126,525
2339,382,354,28,79,36,87,41,140
2340,416,286,130,159,35,19,64,139
2341,380,183,197,184,40,81,49,25
2342,280,236,44,28,33,68,67,84
2343,674,456,218,141,164,144,108,117
2344,410,327,83,40,58,16,18,278
2345,710,601,109,154,163,88,85,221
2346,441,205,236,54,70,70,99,148
2347,661,515,146,86,123,48,49,355
2348,393,271,122,62,194,62,29,46
2349,630,418,212,94,150,226,92,67
2350,228,101,127,102,27,42,0,57
2351,527,435,92,85,112,108,54,169
2352,447,241,206,164,122,59,31,70
2353,507,187,320,166,179,79,0,83
2354,250,93,157,48,97,52,14,40
2355,508,303,205,164,179,75,60,29
2356,0,0,0,0,0,0,0,0
2357,334,147,187,66,139,71,26,32
2358,271,183,88,25,11,34,55,145
2359,328,190,138,41,61,37,19,170
2360,424,261,163,27,105,69,57,167
2361,277,211,66,0,43,41,8,185
2362,456,341,115,33,9,29,111,273
2363,288,166,122,16,39,21,26,186
2364,244,157,87,58,42,76,12,56
2365,311,231,80,67,54,29,49,112
2366,319,138,181,54,91,53,85,36
2367,336,229,107,34,92,25,66,119
2368,303,223,80,72,70,93,5,63
2369,428,209,219,143,159,38,14,73
2370,233,120,113,83,76,15,23,36
2371,451,228,223,66,196,71,71,46
2372,115,70,45,70,20,20,1,3
2373,633,345,288,336,129,87,8,73
2374,625,510,115,83,59,158,44,280
2375,1286,1012,274,82,129,328,78,669
2376,441,191,250,199,119,27,4,93
2377,432,267,165,150,113,89,14,66
2378,368,142,226,123,112,62,48,23
2379,227,128,99,17,68,88,29,25
2380,409,377,32,49,43,89,73,156
2381,228,89,139,64,66,26,42,31
2382,351,178,173,50,163,83,28,26
2383,1529,1338,191,258,0,294,301,676
2384,612,313,299,180,139,94,112,88
2385,417,189,228,120,170,44,39,44
2386,356,172,184,152,75,88,16,25
2387,385,286,99,77,29,77,33,169
2388,551,237,314,159,184,89,44,75
2389,349,144,205,87,95,68,75,24
2390,415,198,217,58,151,78,113,15
2391,474,398,76,136,104,53,78,104
2392,514,429,85,57,15,53,135,253
2393,85,78,7,41,16,10,9,9
2394,542,355,187,133,139,131,65,74
2395,719,611,108,25,122,139,115,319
2396,309,151,158,20,0,27,15,246
2397,445,255,190,38,72,62,42,230
2398,377,288,89,30,12,12,11,313
2399,440,241,199,254,68,76,25,16
2400,409,379,30,26,101,68,35,179
2401,255,111,144,91,46,28,9,81
2402,589,481,108,171,64,57,47,250
2403,506,382,124,161,115,21,31,179
2404,538,337,201,121,104,108,60,144
2405,263,157,106,7,21,7,11,216
2406,440,299,141,38,24,60,81,238
2407,304,231,73,100,145,18,30,11
2408,555,445,110,65,46,101,127,216
2409,393,242,151,56,57,32,36,212
2410,429,361,68,11,83,89,107,140
2411,538,320,218,205,39,105,129,60
2412,288,190,98,51,72,52,14,99
2413,487,300,187,164,98,136,14,75
2414,261,181,80,54,70,57,19,62
2415,354,160,194,83,95,0,120,55
2416,440,269,171,47,40,68,36,249
2417,452,399,53,107,137,83,63,62
2418,372,300,72,90,54,117,48,63
2419,404,327,77,31,66,92,25,191
2420,591,384,207,10,62,63,45,411
2421,427,259,168,86,113,51,78,98
2422,377,229,148,151,91,67,31,37
2423,404,238,166,57,55,23,15,255
2424,693,418,275,48,32,18,56,539
2425,355,213,142,186,64,34,29,42
2426,605,338,267,50,156,97,68,233
2427,491,250,241,181,123,97,35,54
2428,303,202,101,89,97,49,38,30
2429,332,169,163,122,82,108,0,20
2430,296,87,209,105,105,24,0,62
2431,358,251,107,139,77,48,14,80
2432,415,274,141,32,72,164,108,39
2433,288,210,78,65,66,22,74,61
2434,237,118,119,40,50,64,49,35
2435,462,304,158,164,58,115,28,96
2436,368,244,124,68,131,45,28,96
2437,485,238,247,43,236,139,33,34
2438,325,126,199,151,88,54,15,18
2439,826,591,235,416,127,119,80,83
2440,458,190,268,86,253,85,24,11
2441,140,105,35,16,20,18,22,64
2442,63,47,16,7,9,8,10,29
2443,815,715,100,245,98,68,74,329
2444,913,839,74,441,173,106,96,98
2445,55,55,0,0,0,0,0,0
2446,221,133,88,110,44,30,16,21
2447,525,317,208,262,105,71,39,49
2448,58,33,25,3,8,4,5,38
2449,253,199,54,36,38,23,40,116
2450,848,674,174,47,74,48,64,615
2451,0,0,0,0,0,0,0,0
2452,862,653,209,36,81,53,55,636
2453,1156,836,320,45,60,126,55,870
2454,673,501,172,40,38,66,51,477
2455,1557,1153,404,85,114,95,176,1087
2456,985,749,236,76,87,113,99,609
2457,0,0,0,0,0,0,0,0
2458,0,0,0,0,0,0,0,0
2459,0,0,0,0,0,0,0,0
2460,0,0,0,0,0,0,0,0
2461,0,0,0,0,0,0,0,0
2462,0,0,0,0,0,0,0,0
2463,0,0,0,0,0,0,0,0
2464,482,331,151,143,45,19,44,231
2465,676,529,147,49,81,123,106,317
2466,11,4,7,0,0,0,0,11
2467,241,206,35,39,27,87,34,54
2468,602,586,16,294,213,19,27,49
2469,293,243,50,131,13,37,0,112
2470,622,566,56,299,163,65,0,95
2471,289,183,106,35,26,52,21,155
2472,699,471,228,67,125,140,101,267
2473,223,170,53,88,38,13,24,60
2474,500,500,0,0,0,0,0,0
2475,14,13,1,3,2,3,2,5
2476,270,266,4,41,25,36,27,141
2477,227,205,22,21,23,19,19,145
2478,106,87,19,26,20,10,5,45
2479,552,321,231,78,52,59,109,255
2480,365,299,66,28,92,59,38,148
2481,620,559,61,172,55,114,51,227
2482,383,243,140,64,51,75,28,165
2483,352,211,141,108,0,66,25,153
2484,438,290,148,92,63,56,75,152
2485,218,218,0,0,0,0,0,0
2486,618,484,134,111,111,77,96,223
2487,336,271,65,64,46,61,29,136
2488,293,242,51,24,31,27,87,125
2489,319,305,14,0,38,50,36,195
2490,940,831,109,30,70,110,82,647
2491,1575,1049,526,192,195,481,282,425
2492,1923,1586,337,560,300,245,260,558
2493,918,868,50,376,140,60,24,318
2494,504,278,226,18,47,55,51,333
2495,222,154,68,3,13,22,20,164
2496,873,769,104,200,283,45,133,212
2497,857,668,189,67,155,102,95,438
2498,365,313,52,37,83,60,24,161
2499,350,280,70,48,17,44,44,197
2500,446,305,141,32,30,0,24,359
2501,527,329,198,85,43,59,54,286
2502,566,437,129,95,177,156,29,110
2503,705,631,74,136,138,109,32,289
2504,249,220,29,38,75,17,25,95
2505,425,336,89,141,88,17,17,163
2506,426,304,122,118,41,62,31,174
2507,395,332,63,56,106,64,58,112
2508,303,209,94,49,109,16,50,78
2509,428,241,187,51,70,41,79,188
2510,466,391,75,90,87,121,28,140
2511,424,345,79,99,54,57,22,192
2512,695,568,127,150,119,61,114,251
2513,803,753,50,519,120,66,16,83
2514,1263,1052,211,307,150,216,126,464
2515,464,325,139,117,156,30,20,141
2516,53,38,15,9,9,5,10,20
2517,421,354,67,190,41,9,16,165
2518,706,697,9,66,130,220,74,216
2519,358,317,41,122,0,40,33,163
2520,1110,515,595,326,347,207,104,127
2521,563,451,112,86,59,53,115,249
2522,778,778,0,313,219,73,36,137
2523,320,247,73,16,28,24,42,210
2524,519,473,46,74,40,63,46,296
2525,387,342,45,96,40,29,43,180
2526,738,600,138,88,102,60,74,414
2527,399,335,64,13,33,68,29,255
2528,560,464,96,35,36,163,53,272
2529,229,229,0,158,17,10,44,0
2530,1075,685,390,205,167,136,109,459
2531,250,145,105,26,68,17,32,107
2532,512,347,165,45,71,73,81,241
2533,349,232,117,0,23,12,86,227
2534,382,262,120,148,65,65,7,96
2535,316,167,149,43,35,32,61,145
2536,221,150,71,26,26,14,28,128
2537,419,285,134,61,43,54,34,228
2538,426,279,147,60,61,48,64,193
2539,419,217,202,16,128,58,20,197
2540,335,161,174,53,59,39,38,147
2541,491,242,249,0,44,36,13,398
2542,400,340,60,66,10,26,39,259
2543,489,281,208,67,107,31,86,198
2544,698,543,155,38,51,123,57,429
2545,514,459,55,99,150,70,11,184
2546,289,202,87,29,36,5,23,196
2547,420,307,113,77,62,109,9,163
2548,567,490,77,60,99,77,80,251
2549,658,475,183,148,125,40,51,293
2550,1095,1045,50,429,216,114,125,211
2551,251,206,45,21,25,43,29,133
2552,490,380,110,49,112,76,50,203
2553,781,689,92,282,106,143,82,169
2554,315,225,90,40,24,85,17,150
2555,406,298,108,39,43,77,59,188
2556,316,262,54,101,39,57,0,118
2557,480,351,129,137,28,14,65,237
2558,606,391,215,186,132,54,103,130
2559,357,270,87,31,82,76,33,136
2560,752,622,130,18,114,221,43,357
2561,389,291,98,60,42,67,48,172
2562,242,202,40,0,9,0,16,217
2563,475,368,107,41,123,52,57,203
2564,385,275,110,58,57,57,61,152
2565,277,195,82,60,51,57,42,67
2566,292,149,143,11,20,64,22,176
2567,167,138,29,35,33,26,31,42
2568,216,171,45,43,56,41,8,68
2569,449,373,76,71,46,66,61,205
2570,671,451,220,158,111,98,65,240
2571,288,288,0,0,0,0,0,0
2572,501,465,36,144,82,109,47,120
2573,571,424,147,88,49,55,68,312
2574,169,169,0,125,36,8,0,0
2575,252,148,104,16,29,15,21,172
2576,885,873,12,443,137,109,53,144
2577,765,712,53,247,180,128,75,134
2578,489,424,65,100,50,37,30,273
2579,271,262,9,104,60,38,13,56
2580,522,388,134,133,89,85,25,189
2581,385,298,87,129,56,32,42,126
2582,825,506,319,87,226,76,131,306
2583,310,258,52,27,29,46,17,191
2584,510,386,124,12,32,37,44,385
2585,366,178,188,13,46,78,19,209
2586,449,284,165,13,29,25,89,292
2587,746,561,185,87,167,148,157,186
2588,10,7,3,2,2,1,2,4
2589,495,394,101,28,43,28,37,359
2590,0,0,0,0,0,0,0,0
2591,136,136,0,0,0,0,0,0
2592,182,136,46,16,28,26,5,107
2593,218,218,0,0,0,0,0,0
2594,231,164,67,40,39,23,42,87
2595,233,165,68,40,39,23,42,88
2596,0,0,0,0,0,0,0,0
2597,243,218,25,47,48,38,11,100
2598,493,493,0,0,0,0,0,0
2599,222,191,31,131,26,48,0,18
2600,479,479,0,0,0,0,0,0
2601,308,308,0,0,0,0,0,0
2602,196,196,0,0,0,0,0,0
2603,225,225,0,0,0,0,0,0
2604,63,63,0,0,0,0,0,0
2605,141,141,0,0,0,0,0,0
2606,152,152,0,0,0,0,0,0
2607,162,162,0,0,0,0,0,0
2608,105,105,0,0,0,0,0,0
2609,209,175,34,33,27,41,25,83
2610,99,99,0,0,0,0,0,0
2611,45,45,0,0,0,0,0,0
2612,82,82,0,0,0,0,0,0
2613,102,102,0,0,0,0,0,0
2614,68,68,0,0,0,0,0,0
2615,90,90,0,0,0,0,0,0
2616,221,153,68,3,13,22,20,164
2617,196,196,0,0,0,0,0,0
2618,662,571,91,125,57,107,92,281
2619,186,186,0,0,0,0,0,0
2620,525,407,118,81,66,23,152,204
2621,1224,808,416,160,383,120,209,352
2622,693,523,170,279,276,54,16,68
2623,0,0,0,0,0,0,0,0
2624,976,732,244,85,95,54,84,659
2625,0,0,0,0,0,0,0,0
2626,2001,1505,496,81,178,292,180,1269
2627,1023,605,418,263,241,140,145,235
2628,1443,1135,308,135,287,285,289,447
2629,1906,1234,672,229,287,432,249,709
2630,0,0,0,0,0,0,0,0
2631,0,0,0,0,0,0,0,0
2632,1487,1192,295,202,212,221,286,566
2633,2278,1686,592,209,278,413,306,1072
2634,1502,1073,429,237,278,263,216,508
2635,1185,897,288,78,261,325,232,289
2636,3166,2316,850,341,393,402,439,1592
2637,1910,1334,576,248,341,350,278,693
2638,1140,825,315,68,279,217,110,465
2639,904,553,351,98,198,230,135,243
2640,0,0,0,0,0,0,0,0
2641,0,0,0,0,0,0,0,0
2642,546,393,153,144,154,126,17,105
2643,971,644,327,170,246,155,155,245
2644,1453,996,457,215,221,271,342,404
2645,0,0,0,0,0,0,0,0
2646,1061,966,95,172,101,147,68,573
2647,0,0,0,0,0,0,0,0
2648,1833,1653,180,153,325,307,303,745
2649,0,0,0,0,0,0,0,0
2650,408,274,134,23,54,45,13,274
2651,0,0,0,0,0,0,0,0
2652,354,279,75,41,20,44,42,207
2653,409,213,196,24,92,12,66,214
2654,584,195,389,90,265,92,36,101
2655,641,269,372,200,232,81,80,48
2656,1552,947,605,60,218,182,152,940
2657,414,291,123,28,47,110,42,187
2658,786,505,281,71,76,92,59,488
2659,648,496,152,67,81,175,22,304
2660,424,292,132,0,0,53,187,183
2661,405,163,242,14,169,106,44,72
2662,477,273,204,98,107,165,32,75
2663,313,232,81,69,36,105,25,78
2664,836,354,482,116,183,258,134,145
2665,297,280,17,23,17,139,18,99
2666,947,669,278,353,330,93,60,111
2667,621,480,141,97,108,91,161,163
2668,744,527,217,49,114,119,56,405
2669,392,233,159,60,55,44,51,181
2670,421,325,96,66,60,26,48,221
2671,463,274,189,90,98,46,81,147
2672,897,609,288,93,190,159,126,329
2673,498,170,328,229,100,91,34,44
2674,337,222,115,15,8,17,26,271
2675,977,472,505,92,50,26,102,707
2676,335,217,118,35,25,32,33,209
2677,299,225,74,8,46,40,55,150
2678,453,317,136,58,33,64,43,255
2679,723,501,222,51,35,77,84,475
2680,302,218,84,29,71,84,57,60
2681,242,157,85,19,24,17,24,158
2682,567,388,179,36,97,132,99,204
2683,493,262,231,162,69,179,24,60
2684,684,437,247,43,167,68,219,186
2685,1100,869,231,445,256,108,113,179
2686,753,623,130,84,97,127,102,343
2687,714,244,470,61,303,148,119,83
2688,305,262,43,16,89,29,27,145
2689,402,295,107,99,26,27,71,179
2690,526,409,117,169,163,67,19,107
2691,263,185,78,45,43,37,13,126
2692,358,207,151,49,51,68,14,177
2693,271,126,145,7,43,60,43,118
2694,490,385,105,89,149,54,41,158
2695,532,420,112,47,84,59,42,300
2696,338,179,159,173,91,24,31,18
2697,182,133,49,8,8,14,26,126
2698,1598,714,884,155,309,256,177,701
2699,568,360,208,255,181,29,84,19
2700,222,186,36,55,58,48,21,41
2701,1315,983,332,134,245,246,294,397
2702,235,170,65,35,19,20,29,132
2703,709,433,276,36,43,76,175,379
2704,288,260,28,11,0,69,0,208
2705,694,491,203,40,93,74,66,420
2706,1760,1101,659,327,315,300,210,606
2707,705,535,170,94,169,95,83,263
2708,309,231,78,39,47,36,116,71
2709,377,280,97,43,33,116,67,118
2710,567,302,265,146,126,116,80,100
2711,194,64,130,30,75,62,0,27
2712,412,213,199,86,175,84,15,52
2713,446,226,220,151,111,79,0,105
2714,339,189,150,76,45,27,104,88
2715,245,178,67,0,109,39,87,10
2716,360,280,80,98,78,39,117,27
2717,297,172,125,97,102,38,30,30
2718,373,134,239,116,109,71,42,35
2719,289,122,167,68,64,105,43,8
2720,426,173,253,24,107,120,84,91
2721,469,318,151,65,185,39,116,63
2722,391,269,122,70,45,121,71,85
2723,342,274,68,223,27,35,39,18
2724,510,295,215,116,140,141,64,49
2725,286,89,197,32,114,66,38,36
2726,464,154,310,115,76,147,63,63
2727,472,173,299,103,119,71,12,167
2728,442,282,160,158,166,78,0,39
2729,378,167,211,91,218,45,0,24
2730,349,269,80,160,73,50,7,58
2731,429,199,230,106,205,24,62,33
2732,321,217,104,122,126,12,50,12
2733,301,295,6,132,84,49,20,15
2734,360,186,174,96,77,48,95,44
2735,406,210,196,73,191,73,35,34
2736,468,212,256,164,146,92,41,25
2737,322,205,117,14,37,68,30,173
2738,564,362,202,115,225,134,0,90
2739,440,238,202,147,70,117,51,55
2740,535,260,275,231,100,124,75,6
2741,391,244,147,84,102,106,47,52
2742,804,357,447,313,259,81,68,83
2743,532,363,169,131,142,95,69,94
2744,528,447,81,68,77,173,82,128
2745,761,535,226,66,111,91,159,334
2746,402,302,100,50,128,89,54,82
2747,502,292,210,80,108,41,80,192
2748,840,510,330,162,204,200,107,168
2749,461,335,126,18,80,86,50,227
2750,376,302,74,47,62,68,60,140
2751,333,247,86,36,63,47,62,124
2752,441,298,143,102,100,68,54,117
2753,283,161,122,64,51,35,104,28
2754,292,109,183,37,117,81,0,57
2755,369,133,236,93,165,15,89,8
2756,386,211,175,5,103,121,7,151
2757,252,126,126,77,0,63,13,99
2758,531,328,203,88,92,179,33,139
2759,536,119,417,138,146,130,49,73
2760,643,394,249,66,118,133,177,149
2761,298,213,85,28,40,24,53,153
2762,306,215,91,11,30,34,36,195
2763,427,341,86,45,56,72,36,218
2764,510,222,288,100,92,94,60,164
2765,805,605,200,256,179,73,106,191
2766,255,132,123,84,54,50,12,56
2767,670,534,136,31,109,177,96,256
2768,281,202,79,23,20,27,104,108
2769,293,206,87,25,82,30,22,134
2770,0,0,0,0,0,0,0,0
2771,679,335,344,75,133,129,82,260
2772,559,423,136,118,47,218,110,66
2773,1660,1026,634,117,172,296,187,888
2774,1393,995,398,136,103,135,147,872
2775,2858,1877,981,293,372,460,543,1190
2776,1193,767,426,41,97,193,112,750
2777,452,330,122,45,38,51,40,278
2778,0,0,0,0,0,0,0,0
2779,1789,1184,605,138,281,331,361,678
2780,1792,1257,535,300,353,354,203,581
2781,241,150,91,26,44,55,32,85
2782,0,0,0,0,0,0,0,0
2783,1250,910,340,14,114,129,54,939
2784,968,700,268,63,66,204,98,537
2785,2503,1814,689,315,227,267,402,1292
2786,1559,1098,461,188,199,169,258,746
2787,1635,1155,480,232,157,245,115,886
2788,1431,843,588,59,351,179,270,572
2789,0,0,0,0,0,0,0,0
2790,731,507,224,216,68,97,100,251
2791,2689,1733,956,201,326,509,228,1425
2792,1978,1247,731,188,266,290,259,975
2793,1453,936,517,271,193,200,166,623
2794,3045,2274,771,460,674,493,331,1087
2795,0,0,0,0,0,0,0,0
2796,2686,1277,1409,683,755,509,304,435
2797,608,450,158,34,42,113,70,349
2798,844,547,297,65,159,87,130,403
2799,0,0,0,0,0,0,0,0
2800,0,0,0,0,0,0,0,0
2801,403,235,168,72,12,30,36,252
2802,3012,2093,919,203,300,276,299,1935
2803,1423,975,448,39,253,80,179,873
2804,2699,1644,1055,242,171,327,366,1592
2805,1377,900,477,48,122,120,197,890
2806,997,651,346,65,107,111,56,658
2807,95,68,27,28,37,14,5,10
2808,489,262,227,61,81,104,74,170
2809,495,400,95,237,59,53,55,90
2810,440,325,115,75,83,104,79,99
2811,863,696,167,170,63,145,90,395
2812,566,371,195,66,92,159,112,138
2813,739,519,220,70,76,78,55,461
2814,336,241,95,66,14,83,74,100
2815,554,419,135,82,111,69,118,174
2816,542,390,152,92,75,96,90,189
2817,712,581,131,151,126,91,48,297
2818,522,430,92,47,25,108,56,286
2819,516,272,244,21,152,109,33,200
2820,762,464,298,81,203,114,139,225
2821,692,501,191,99,292,201,60,39
2822,0,0,0,0,0,0,0,0
2823,1216,1097,119,147,112,147,203,607
2824,1299,1035,264,261,187,383,48,419
2825,853,366,487,194,187,156,168,148
2826,300,181,119,13,22,30,103,132
2827,2280,1095,1185,250,106,403,207,1315
2828,806,737,69,66,196,57,214,274
2829,1026,716,310,106,223,165,138,395
2830,422,265,157,168,123,62,59,11
2831,532,413,119,0,46,95,15,376
2832,834,659,175,0,42,60,130,601
2833,723,435,288,32,12,163,35,481
2834,835,576,259,75,79,143,88,450
2835,259,234,25,0,18,33,41,167
2836,572,446,126,64,72,131,98,207
2837,1011,681,330,235,264,283,67,161
2838,861,751,110,249,181,133,80,219
2839,434,376,58,271,73,51,30,9
2840,558,368,190,147,57,103,134,116
2841,456,255,201,67,58,84,75,172
2842,530,423,107,60,140,99,130,101
2843,539,405,134,126,73,44,99,197
2844,343,178,165,31,104,108,37,63
2845,490,311,179,44,104,62,73,207
2846,632,256,376,123,233,82,106,87
2847,623,383,240,165,170,121,56,111
2848,729,460,269,236,174,141,124,55
2849,318,267,51,27,56,51,110,74
2850,402,254,148,37,72,74,84,134
2851,495,388,107,58,98,73,64,203
2852,287,241,46,70,57,13,92,55
2853,743,424,319,57,79,176,88,344
2854,682,491,191,95,105,75,224,183
2855,455,343,112,38,47,142,46,181
2856,539,405,134,46,32,145,97,219
2857,115,94,21,8,55,4,22,26
2858,77,52,25,6,28,25,13,6
2859,875,547,328,55,225,252,177,165
2860,388,247,141,12,32,29,101,213
2861,298,229,69,35,59,44,76,85
2862,1167,767,400,250,130,81,140,566
2863,614,380,234,62,64,32,70,386
2864,691,440,251,26,21,138,36,471
2865,472,332,140,59,32,69,101,211
2866,554,433,121,64,49,53,101,287
2867,576,433,143,107,64,79,65,261
2868,361,257,104,26,73,78,85,98
2869,562,360,202,38,108,95,113,208
2870,352,268,84,45,18,87,37,165
2871,415,326,89,40,75,117,54,130
2872,0,0,0,0,0,0,0,0
2873,892,715,177,85,161,183,210,253
2874,0,0,0,0,0,0,0,0
2875,1958,1392,566,142,288,266,135,1127
2876,2257,1615,642,93,245,254,319,1346
2877,0,0,0,0,0,0,0,0
2878,1104,827,277,129,112,125,104,635
2879,2165,1361,804,141,190,170,158,1505
2880,1493,1179,314,145,132,174,150,892
2881,1337,837,500,29,214,112,134,849
2882,600,354,246,13,17,134,0,436
2883,0,0,0,0,0,0,0,0
2884,1482,959,523,90,80,73,184,1055
2885,0,0,0,0,0,0,0,0
2886,5855,5855,0,1092,1763,1123,764,1113
2887,843,571,272,39,64,50,99,591
2888,0,0,0,0,0,0,0,0
2889,919,552,367,16,41,42,82,737
2890,745,423,322,18,99,16,48,565
2891,1841,1073,768,119,135,96,79,1412
2892,2290,1492,798,240,249,327,257,1218
2893,1041,712,329,103,73,133,174,558
2894,479,309,170,30,23,55,49,323
2895,0,0,0,0,0,0,0,0
2896,1263,783,480,29,35,31,13,1156
2897,1217,785,432,86,42,80,105,903
2898,268,159,109,7,31,8,22,199
2899,724,469,255,29,47,49,54,544
2900,725,428,297,36,79,133,33,444
2901,1966,1367,599,252,160,275,378,901
2902,914,615,299,58,56,22,86,692
2903,993,843,150,123,237,92,181,360
2904,778,688,90,83,186,109,131,269
2905,1561,1249,312,357,293,162,205,544
2906,618,462,156,14,141,56,72,334
2907,398,291,107,54,39,56,137,112
2908,941,809,132,110,152,119,182,378
2909,724,639,85,103,105,224,95,197
2910,1196,850,346,63,134,238,139,621
2911,983,731,252,222,144,184,50,383
2912,569,314,255,32,45,53,10,429
2913,391,317,74,27,50,50,18,246
2914,492,278,214,103,27,41,17,304
2915,917,600,317,29,45,56,109,678
2916,278,208,70,0,23,77,17,162
2917,428,285,143,22,18,44,25,318
2918,259,134,125,61,30,0,0,168
2919,505,371,134,86,150,104,14,150
2920,600,427,173,111,139,44,46,260
2921,1062,783,279,162,237,132,115,417
2922,756,506,250,41,23,119,127,445
2923,627,491,136,65,105,85,80,292
2924,963,773,190,177,90,177,114,405
2925,271,163,108,20,53,12,16,169
2926,603,427,176,54,42,74,25,407
2927,689,543,146,34,94,111,119,330
2928,306,160,146,0,0,15,22,269
2929,457,357,100,104,14,19,103,217
2930,630,461,169,61,49,44,24,451
2931,650,460,190,14,153,80,112,291
2932,750,454,296,19,33,66,17,615
2933,516,350,166,124,68,101,51,172
2934,940,539,401,106,171,20,97,546
2935,906,706,200,157,144,8,247,350
2936,438,199,239,44,18,41,15,319
2937,877,570,307,0,114,50,59,654
2938,547,319,228,28,80,29,41,368
2939,876,690,186,197,154,18,0,507
2940,618,380,238,20,78,32,74,414
2941,470,266,204,13,72,15,26,344
2942,2048,972,1076,90,203,125,258,1372
2943,2316,1338,978,189,112,250,304,1462
2944,395,229,166,42,12,17,20,304
2945,1941,1226,715,189,166,140,186,1260
2946,0,0,0,0,0,0,0,0
2947,1318,893,425,107,138,74,61,938
2948,13835,5746,8089,906,876,855,1096,10102
2949,3998,2623,1375,200,236,320,382,2860
2950,2640,1761,879,127,213,281,314,1704
2951,2327,998,1329,145,167,142,522,1351
2952,4016,2522,1494,209,361,372,479,2594
2953,1360,1093,267,21,148,185,136,870
2954,2068,1221,847,91,87,99,163,1628
2955,2722,2053,669,121,250,313,204,1834
2956,4008,2238,1770,171,185,404,213,3035
2959,1376,768,608,116,10,59,123,1068
2960,1314,678,636,35,122,50,64,1044
2961,269,137,132,7,7,8,8,238
2962,555,286,269,26,19,41,5,464
2963,423,185,238,10,43,38,12,320
2964,746,587,159,31,131,156,87,341
2965,585,292,293,10,46,60,45,423
2966,374,211,163,28,43,89,6,208
2967,565,232,333,12,41,68,69,376
2968,977,572,405,72,25,75,122,684
2969,1311,533,778,86,114,228,165,719
2970,550,333,217,9,88,42,28,384
2971,0,0,0,0,0,0,0,0
2972,0,0,0,0,0,0,0,0
2973,1454,939,515,151,112,163,200,829
2974,0,0,0,0,0,0,0,0
2975,1424,895,529,157,224,384,158,501
2976,1051,589,462,222,294,249,144,141
2977,1445,634,811,534,445,262,135,69
2978,441,135,306,123,122,88,11,97
2979,0,0,0,0,0,0,0,0
2980,1315,900,415,211,257,296,211,340
2981,348,198,150,63,78,86,13,109
2982,1296,860,436,277,281,140,133,466
2983,0,0,0,0,0,0,0,0
2984,1239,589,650,61,32,76,149,922
2985,1685,963,722,41,278,106,105,1154
2986,1296,504,792,61,122,90,172,851
2987,0,0,0,0,0,0,0,0
2988,0,0,0,0,0,0,0,0
2989,1453,765,688,382,502,297,141,131
2990,1266,837,429,145,300,356,197,268
2991,2445,1507,938,852,454,513,355,270
2992,0,0,0,0,0,0,0,0
2993,0,0,0,0,0,0,0,0
2994,639,505,134,60,83,207,183,106
2995,2539,1647,892,395,213,413,403,1115
2996,1045,679,366,172,149,343,131,250
2997,0,0,0,0,0,0,0,0
2998,0,0,0,0,0,0,0,0
2999,1597,703,894,220,612,408,150,207
3000,4950,2797,2153,460,667,663,762,2397
3001,3505,1876,1629,349,479,625,446,1606
3006,5807,4079,1728,465,660,538,804,3340
3007,231,123,108,30,55,44,16,85
3010,378,202,176,18,17,160,68,115
3011,681,370,311,207,85,192,68,129
3012,224,169,55,11,42,36,27,108
3013,896,442,454,151,117,247,166,215
3014,432,252,180,20,86,146,90,89
3015,176,130,46,2,6,24,47,98
3016,498,299,199,112,61,67,105,154
3017,1351,750,601,225,104,151,218,652
3018,513,421,92,288,110,60,9,47
3019,843,505,338,65,66,145,236,330
3020,551,236,315,78,115,85,84,189
3021,989,558,431,34,49,138,106,662
3022,869,508,361,14,152,287,139,278
3023,630,357,273,151,30,142,43,264
3024,647,360,287,71,246,154,83,93
3025,746,451,295,131,83,57,73,403
3026,627,490,137,140,161,157,70,99
3027,512,293,219,203,92,121,32,65
3028,943,681,262,202,212,144,105,281
3029,873,311,562,120,175,107,116,356
3030,431,166,265,16,58,118,27,212
3031,808,497,311,41,96,125,135,411
3032,578,357,221,28,105,116,56,273
3033,1039,615,424,74,111,165,188,502
3034,504,311,193,24,87,86,118,188
3035,205,74,131,36,116,24,23,7
3036,482,261,221,85,143,153,33,68
3037,609,263,346,177,212,103,42,76
3038,284,156,128,54,57,25,106,42
3039,411,286,125,95,190,51,61,14
3040,368,239,129,130,91,129,0,19
3041,561,304,257,112,49,126,95,179
3042,484,262,222,113,170,42,104,55
3043,715,418,297,140,167,223,73,113
3044,568,226,342,150,127,130,67,93
3045,378,295,83,66,66,55,70,122
3046,236,155,81,23,37,132,31,13
3047,505,369,136,82,193,72,0,158
3048,810,562,248,95,51,126,191,348
3049,292,185,107,89,64,57,9,73
3050,390,242,148,85,91,92,49,72
3051,523,281,242,157,117,122,31,95
3052,621,228,393,171,60,159,113,119
3053,306,94,212,74,78,66,17,71
3054,759,452,307,337,135,100,95,92
3055,417,264,153,180,71,58,51,57
3056,912,623,289,332,249,121,37,173
3057,438,268,170,49,48,67,117,156
3058,693,312,381,203,169,184,74,63
3059,645,302,343,137,164,105,100,140
3060,394,224,170,49,157,67,68,53
3061,617,334,283,39,196,128,118,135
3062,1264,698,566,48,204,273,217,522
3063,394,189,205,74,66,95,20,138
3064,618,257,361,209,165,116,47,80
3065,390,283,107,158,102,0,93,38
3066,1157,450,707,484,182,214,142,136
3067,459,309,150,41,85,107,148,77
3068,656,437,219,58,53,203,68,274
3069,301,174,127,21,24,116,12,128
3070,992,341,651,219,220,273,76,203
3071,37,28,9,2,7,6,4,18
3072,473,246,227,41,87,66,110,170
3073,3270,2154,1116,244,473,386,519,1649
3074,1120,682,438,222,303,288,142,165
3075,1196,789,407,317,285,251,97,246
3076,1115,813,302,198,145,251,180,340
3077,1468,965,503,214,308,242,210,494
3078,2903,2200,703,217,304,671,337,1375
3079,1213,929,284,288,485,221,120,99
3080,287,190,97,23,29,37,28,170
3081,0,0,0,0,0,0,0,0
3082,700,449,251,173,182,91,159,96
3083,2338,1636,702,410,434,374,274,846
3084,1696,1027,669,360,506,270,300,261
3085,766,512,254,137,174,108,151,196
3086,601,416,185,151,155,159,46,91
3087,0,0,0,0,0,0,0,0
3088,0,0,0,0,0,0,0,0
3089,0,0,0,0,0,0,0,0
3090,0,0,0,0,0,0,0,0
3091,943,640,303,162,210,162,180,230
3092,318,188,130,33,53,39,54,139
3093,0,0,0,0,0,0,0,0
3094,1575,981,594,213,304,295,275,488
3095,1343,878,465,59,187,207,211,680
3096,1381,959,422,139,126,194,248,674
3097,0,0,0,0,0,0,0,0
3098,0,0,0,0,0,0,0,0
3099,0,0,0,0,0,0,0,0
3100,274,261,13,63,122,25,14,50
3101,2068,1662,406,374,251,370,219,855
3102,1546,1000,546,184,306,298,189,569
3103,1772,1303,469,228,341,216,368,619
3104,1630,881,749,126,103,161,191,1049
3105,1691,1160,531,234,169,254,257,778
3106,1215,826,389,107,267,222,127,492
3107,779,658,121,186,266,111,190,26
3108,819,574,245,125,206,125,157,205
3109,343,243,100,23,31,72,14,202
3110,415,224,191,15,152,50,91,108
3111,450,260,190,98,161,75,97,20
3112,515,416,99,287,69,75,36,47
3113,870,451,419,607,186,0,36,42
3114,357,196,161,70,66,111,44,66
3115,414,315,99,16,48,83,100,167
3116,399,290,109,110,78,122,31,57
3117,382,233,149,122,121,29,74,36
3118,321,202,119,143,57,31,56,34
3119,312,210,102,101,74,57,41,40
3120,308,259,49,102,59,55,29,64
3121,481,283,198,102,122,78,79,100
3122,450,374,76,61,149,56,55,130
3123,323,251,72,106,53,21,41,101
3124,581,375,206,42,109,113,155,162
3125,304,170,134,84,123,37,34,25
3126,483,293,190,146,64,120,27,126
3127,747,673,74,302,150,115,147,34
3128,287,169,118,139,76,50,6,16
3129,590,417,173,221,148,84,100,38
3130,321,209,112,48,63,96,33,80
3131,362,151,211,25,85,72,100,81
3132,811,569,242,176,208,185,58,184
3133,638,361,277,187,179,96,52,125
3134,289,221,68,64,101,47,9,67
3135,518,287,231,144,109,111,95,58
3136,231,85,146,12,118,9,63,28
3137,565,317,248,7,208,99,97,155
3138,573,305,268,170,218,66,50,69
3139,1230,861,369,658,275,116,72,109
3140,315,121,194,104,45,88,4,74
3141,247,105,142,17,26,77,47,80
3142,837,499,338,123,114,93,143,364
3143,0,0,0,0,0,0,0,0
3144,12,8,4,2,3,1,3,3
3145,339,183,156,46,57,69,50,117
3146,1740,1057,683,193,272,293,296,685
3147,760,180,580,81,179,218,127,155
3148,4293,2409,1884,224,552,528,779,2210
3149,1218,654,564,80,250,262,267,359
3150,0,0,0,0,0,0,0,0
3151,704,406,298,233,150,119,47,155
3152,1189,742,447,126,238,242,119,465
3153,1922,1404,518,116,260,329,282,936
3154,0,0,0,0,0,0,0,0
3155,3890,3340,550,641,1000,655,440,1154
3156,1248,874,374,227,181,153,197,490
3157,2994,2106,888,358,457,507,451,1220
3158,413,223,190,9,131,65,110,99
3159,1155,730,425,330,273,214,110,229
3160,572,537,35,19,91,158,30,274
3161,673,413,260,28,54,117,119,355
3162,1631,1084,547,29,163,267,332,841
3163,4016,2836,1180,321,450,600,500,2145
3164,3293,2016,1277,209,290,540,626,1628
3165,0,0,0,0,0,0,0,0
3166,1780,959,821,551,504,324,249,152
3167,1646,950,696,500,439,216,250,241
3168,1216,607,609,250,405,304,81,177
3169,2076,1153,923,324,509,515,291,436
3170,1612,1033,579,252,385,331,262,382
3171,1142,684,458,32,174,224,263,448
3172,1592,870,722,321,375,305,161,430
3173,2557,2115,442,567,438,367,353,832
3174,1540,1171,369,164,230,219,111,816
3175,3043,2189,854,285,335,646,417,1359
3176,1034,615,419,53,113,153,243,472
3177,1904,1122,782,176,252,280,371,825
3178,456,337,119,38,112,86,58,162
3179,2141,1331,810,413,571,520,269,368
3180,1429,794,635,268,199,261,210,491
3181,4173,2336,1837,546,804,712,529,1583
3182,1493,1000,493,257,313,357,153,413
3183,722,449,273,4,141,145,106,325
3184,0,0,0,0,0,0,0,0
3201,925,537,388,122,297,175,153,179
3202,311,159,152,16,53,74,92,75
3203,491,322,169,41,116,92,39,203
3204,976,586,390,120,156,199,154,347
3205,402,277,125,38,132,15,72,145
3206,666,382,284,71,216,155,90,135
3207,662,238,424,8,75,92,187,300
3208,0,0,0,0,0,0,0,0
3209,1824,809,1015,103,96,251,304,1069
3210,527,242,285,96,48,143,101,139
3211,639,292,347,126,126,103,42,241
3212,589,402,187,73,52,194,108,162
3213,452,261,191,139,63,21,158,71
3214,431,316,115,125,58,122,40,86
3215,289,115,174,92,26,56,68,47
3216,217,147,70,79,43,24,18,53
3217,858,636,222,121,152,125,184,275
3218,475,233,242,27,31,217,56,145
3219,586,403,183,78,232,41,122,112
3220,496,274,222,130,178,68,47,73
3221,172,122,50,19,21,34,22,75
3222,390,208,182,135,95,77,71,12
3223,264,117,147,77,91,68,4,24
3224,647,401,246,213,204,104,35,91
3225,234,140,94,8,43,49,87,47
3226,314,213,101,90,123,44,26,31
3227,571,221,350,89,287,46,46,103
3228,405,240,165,70,109,90,53,83
3229,0,0,0,0,0,0,0,0
3230,0,0,0,0,0,0,0,0
3231,340,143,197,41,115,72,56,56
3232,3379,2256,1123,541,550,521,298,1469
3233,2256,1214,1042,273,418,507,321,737
3234,1726,1286,440,115,120,213,217,1061
3235,0,0,0,0,0,0,0,0
3236,0,0,0,0,0,0,0,0
3237,0,0,0,0,0,0,0,0
3238,2563,1674,889,381,549,395,369,869
3239,2429,1761,668,261,369,346,310,1141
3240,1167,854,313,105,86,150,156,670
3241,2196,1429,767,233,407,405,374,776
3242,42,37,5,17,12,0,5,9
3243,1687,899,788,188,248,271,309,672
3244,1814,753,1061,262,153,158,192,1049
3245,342,200,142,15,112,33,97,85
3246,1105,616,489,200,217,188,115,385
3255,787,512,275,148,176,213,39,211
3256,363,273,90,23,37,62,125,116
3257,600,419,181,109,77,87,69,258
3258,567,353,214,140,121,157,23,127
3259,220,137,83,17,61,70,4,68
3260,435,310,125,58,113,55,66,143
3261,448,288,160,26,95,129,37,161
3262,1030,643,387,115,128,221,220,345
3263,277,216,61,26,132,55,52,12
3264,274,230,44,128,33,63,15,34
3265,439,204,235,48,106,66,141,78
3266,900,552,348,86,230,217,159,207
3267,834,417,417,123,259,108,56,288
3268,379,281,98,90,35,101,28,125
3269,854,521,333,38,193,103,94,426
3270,600,547,53,169,120,62,66,182
3271,579,453,126,11,67,102,75,324
3272,446,320,126,50,70,59,98,169
3273,402,283,119,28,112,108,90,64
3274,427,293,134,60,19,74,49,226
3275,511,288,223,58,41,53,66,292
3276,641,308,333,37,158,114,130,201
3277,789,403,386,87,163,91,85,364
3278,646,387,259,119,167,124,53,182
3279,1140,974,166,227,209,204,110,390
3280,2510,1882,628,422,460,267,343,1018
3281,867,661,206,112,171,208,109,266
3282,2055,1569,486,504,476,193,359,524
3283,1992,1527,465,357,502,319,181,633
3284,2840,2237,603,238,296,368,268,1669
3285,1027,800,227,73,214,162,112,465
3286,1928,1496,432,179,351,352,215,832
3287,727,618,109,93,120,118,45,352
3302,1095,855,240,124,109,185,130,548
3303,2237,2018,219,293,478,373,233,861
3304,1894,1293,601,77,385,266,309,857
3305,2262,1742,520,378,436,233,218,998
3306,3091,2108,983,266,401,531,386,1506
3307,1474,998,476,169,210,186,361,549
3308,2630,1923,707,506,321,513,240,1050
3309,4994,3301,1693,521,811,670,722,2269
3310,456,358,98,35,73,68,60,219
3311,1382,972,410,202,253,334,202,391
3312,519,360,159,102,125,162,77,52
3313,1549,1159,390,248,384,370,213,334
3314,225,162,63,35,19,21,10,141
3315,729,448,281,21,132,139,92,344
3316,1238,876,362,309,176,138,134,481
3317,1328,940,388,93,112,242,207,674
3318,748,505,243,73,69,117,76,414
3319,470,324,146,208,63,66,20,113
3320,1058,732,326,191,126,130,165,445
3321,1381,1078,303,115,314,194,281,477
3322,1774,1227,547,147,283,354,264,726
3323,2379,1673,706,393,527,393,382,684
3324,2230,1534,696,685,518,460,321,245
3325,378,257,121,26,57,92,50,153
3326,2001,1460,541,377,499,283,451,391
3327,1914,1349,565,165,292,368,332,756
3328,3882,3133,749,764,574,709,616,1219
3329,2609,2097,512,335,443,396,281,1155
3330,3381,2157,1224,718,799,638,450,777
3331,1296,645,651,179,162,200,319,436
3344,1316,899,417,73,182,192,269,600
3345,3827,3762,65,531,816,843,514,1123
3346,2024,1527,497,382,373,291,403,575
3347,4236,3404,832,261,290,605,604,2476
3348,1418,1072,346,260,347,271,174,366
3349,3248,2348,900,221,460,382,404,1781
3350,453,398,55,156,91,88,102,16
3351,663,350,313,90,152,124,143,154
3352,1297,1041,256,411,300,195,142,248
3353,1617,1335,282,304,390,305,251,367
3354,1579,1152,427,239,278,358,256,447
3355,1856,1254,602,192,320,283,245,816
3356,1259,829,430,302,285,292,260,120
3357,1447,841,606,191,440,294,196,326
3358,499,141,358,0,198,66,122,113
3359,1816,883,933,358,427,424,208,400
3360,2466,1775,691,446,401,396,387,837
3361,3344,2144,1200,192,727,549,593,1283
3362,1788,1216,572,197,219,449,305,619
3363,1250,797,453,360,305,277,78,230
3364,892,534,358,171,168,245,146,162
3365,2334,1623,711,281,460,336,354,902
3366,2574,1783,791,304,531,726,375,638
3367,1361,596,765,197,365,298,215,286
3368,2129,1335,794,454,285,504,394,491
3369,753,570,183,111,205,107,62,268
3370,1583,1168,415,302,265,253,241,522
3371,1708,1308,400,296,329,183,185,715
3372,1795,1419,376,209,191,324,315,756
3373,1603,1200,403,259,256,213,276,599
3374,2263,1825,438,452,470,315,240,787
3375,2195,1231,964,369,484,366,301,675
3376,3180,1946,1234,821,982,558,289,530
3377,2856,2162,694,333,602,622,416,883
3378,2790,1880,910,400,514,454,514,909
3379,1384,1087,297,65,93,101,165,961
3380,589,494,95,211,122,101,73,81
3381,608,515,93,118,175,89,110,115
3382,2777,1970,807,535,675,578,308,681
3383,1757,1456,301,595,269,251,165,477
3384,1800,1425,375,240,240,283,172,866
3395,2472,2149,323,766,475,307,362,563
3396,2231,1870,361,613,467,449,190,511
3397,1637,1357,280,361,405,309,144,418
3398,616,328,288,49,122,63,76,307
3399,1498,1111,387,188,195,187,233,695
3400,1313,1026,287,258,157,243,184,471
3401,1558,1199,359,247,263,240,156,652
3402,3873,2564,1309,576,877,686,512,1221
3403,3502,3135,367,439,846,728,449,1041
3404,2252,1907,345,298,524,354,171,906
3405,2103,1784,319,348,295,465,352,643
3406,291,198,93,22,101,33,45,89
3407,804,493,311,44,123,33,143,461
3408,1978,1630,348,324,182,366,238,868
3409,1421,858,563,163,378,286,122,472
3414,2797,1847,950,219,502,399,286,1390
3415,2629,1901,728,306,521,339,160,1303
3416,696,561,135,58,111,86,92,350
3417,645,434,211,30,66,137,78,334
3418,2754,1973,781,240,291,312,223,1687
3419,2845,2206,639,295,481,443,413,1212
3420,1961,1327,634,272,367,269,388,664
3421,1640,1252,388,204,232,200,332,672
3422,1529,907,622,216,193,71,105,944
3423,1073,892,181,79,98,122,100,674
3424,371,259,112,51,45,59,25,190
3425,2376,1489,887,184,258,238,246,1450
3426,1019,851,168,214,139,253,89,325
3427,1856,1360,496,234,279,219,292,833
3428,2296,1547,749,191,204,325,241,1335
3429,944,632,312,133,24,125,127,535
3430,1363,979,384,290,170,173,140,591
3431,2830,1800,1030,191,241,175,352,1872
3432,175,117,58,14,10,26,28,98
3433,1289,1123,166,236,214,293,131,415
3434,1773,1473,300,326,324,198,244,681
3435,1668,1311,357,133,330,225,175,804
3436,2379,1670,709,297,249,313,234,1286
3437,1147,791,356,83,175,112,129,648
3438,2369,1702,667,296,247,263,335,1228
3439,867,505,362,33,86,63,71,614
3440,2280,1511,769,233,277,216,270,1284
3441,716,558,158,72,0,94,85,465
3442,2336,1720,616,40,197,241,249,1608
3443,1972,1264,708,309,241,179,229,1014
3444,873,656,217,77,88,85,121,503
3445,2208,925,1283,562,615,343,212,476
3454,2301,1786,515,266,382,266,291,1095
3455,2266,1448,818,269,270,150,258,1319
3456,0,0,0,0,0,0,0,0
3457,1874,1295,579,218,290,256,191,920
3458,1288,781,507,355,478,146,73,235
3459,301,239,62,38,10,28,23,201
3460,2016,1396,620,171,150,158,177,1361
3461,2618,1904,714,377,290,373,218,1360
3462,911,803,108,275,106,44,206,280
3463,1011,695,316,76,92,80,35,728
3464,2132,1276,856,160,121,192,223,1436
3465,2765,2009,756,269,155,180,287,1874
3466,2607,1484,1123,131,154,174,300,1848
3467,2156,1542,614,341,294,275,312,934
3468,2272,1735,537,94,117,247,219,1596
3469,2645,1813,832,251,236,283,195,1681
3470,2034,1370,664,159,170,81,163,1460
3471,4529,4042,487,332,538,607,400,2653
3472,11,7,4,2,1,1,2,3
3473,1136,667,469,139,100,170,229,497
3474,824,438,386,151,191,107,73,302
3475,1049,568,481,339,159,142,65,345
3476,837,303,534,166,161,64,179,266
3477,0,0,0,0,0,0,0,0
3478,0,0,0,0,0,0,0,0
3479,822,522,300,63,184,126,64,385
3480,451,176,275,0,59,11,29,352
3481,643,368,275,34,99,120,80,310
3482,268,156,112,58,105,55,18,31
3483,388,236,152,33,92,98,43,121
3484,265,218,47,90,61,50,24,40
3485,0,0,0,0,0,0,0,0
3486,1379,760,619,75,83,223,177,821
3487,1995,1736,259,309,566,247,296,578
3488,808,204,604,145,66,94,124,378
3489,2886,1548,1338,214,384,302,315,1670
3490,800,396,404,73,135,102,116,373
3491,771,402,369,32,34,151,62,492
3492,1977,1094,883,247,341,177,238,975
3493,4,1,3,0,0,1,1,2
3494,0,0,0,0,0,0,0,0
3495,0,0,0,0,0,0,0,0
3496,1,0,1,0,0,0,0,1
3497,0,0,0,0,0,0,0,0
3498,0,0,0,0,0,0,0,0
3499,0,0,0,0,0,0,0,0
3500,0,0,0,0,0,0,0,0
3501,0,0,0,0,0,0,0,0
3502,1,0,1,0,0,0,0,1
3503,0,0,0,0,0,0,0,0
3504,1251,662,589,44,103,127,94,884
3505,1307,760,547,185,59,160,184,720
3506,1814,1007,807,114,108,336,176,1079
3507,770,420,350,42,85,86,191,367
3508,214,197,17,92,47,37,0,38
3509,78,55,23,0,33,19,14,11
3510,1202,745,457,35,184,259,219,504
3511,261,219,42,57,52,45,0,108
3512,661,395,266,0,107,126,201,227
3513,312,204,108,0,21,83,33,175
3514,1133,771,362,57,217,128,172,559
3515,706,312,394,37,137,134,36,362
3516,1772,945,827,175,283,193,201,920
3517,0,0,0,0,0,0,0,0
3518,404,330,74,101,130,56,63,56
3519,335,202,133,52,66,54,70,92
3520,677,451,226,30,121,130,101,294
3521,190,132,58,43,28,33,27,59
3522,320,174,146,45,45,57,27,145
3523,488,374,114,51,62,68,80,227
3524,294,226,68,13,54,38,22,167
3525,362,312,50,76,0,10,103,173
3526,327,160,167,30,69,80,57,91
3527,738,513,225,67,126,75,156,314
3528,735,576,159,112,67,48,64,445
3529,211,138,73,11,43,43,0,114
3530,0,0,0,0,0,0,0,0
3531,354,284,70,62,36,30,25,202
3532,469,275,194,82,117,119,50,101
3533,439,238,201,77,171,115,27,49
3534,980,783,197,334,262,230,89,66
3535,724,452,272,194,183,230,78,39
3536,565,355,210,20,211,94,25,215
3537,474,373,101,161,40,188,30,55
3538,350,257,93,39,81,116,88,26
3539,285,172,113,12,12,20,83,158
3540,266,214,52,8,40,51,14,153
3541,413,365,48,122,84,93,77,36
3542,377,195,182,90,57,108,53,69
3543,703,375,328,165,96,223,70,149
3544,386,328,58,66,45,165,30,81
3545,212,178,34,127,32,24,15,14
3546,282,132,150,71,108,62,19,22
3547,631,439,192,75,111,216,63,166
3548,405,340,65,20,72,58,74,182
3549,485,326,159,79,74,124,93,115
3550,457,324,133,97,96,122,58,85
3551,262,188,74,53,25,7,62,116
3552,118,118,0,0,0,0,0,0
3553,547,382,165,149,94,88,113,103
3554,414,356,58,58,50,49,79,179
3555,425,259,166,98,49,131,51,96
3556,349,273,76,26,31,135,58,98
3557,469,337,132,160,91,24,97,97
3558,777,639,138,72,190,119,147,249
3559,649,503,146,118,77,152,105,197
3560,495,292,203,0,128,153,17,198
3561,407,208,199,50,31,120,72,133
3562,370,280,90,33,29,103,42,162
3563,381,323,58,73,35,90,28,154
3564,306,229,77,42,36,45,47,136
3565,437,310,127,189,46,53,58,90
3566,392,315,77,29,74,27,97,164
3567,357,212,145,43,34,79,45,155
3568,387,289,98,14,52,98,43,180
3569,313,263,50,37,40,36,34,166
3570,16,11,5,5,2,3,3,3
3571,493,340,153,145,60,52,27,209
3572,748,504,244,213,89,149,142,155
3573,636,444,192,88,77,102,43,326
3574,1111,890,221,306,263,261,82,199
3575,883,422,461,8,139,161,86,489
3576,1035,819,216,93,145,298,117,383
3577,0,0,0,0,0,0,0,0
3578,0,0,0,0,0,0,0,0
3579,855,713,142,79,193,106,123,355
3580,1149,998,151,348,164,155,98,384
3581,210,148,62,34,0,13,0,163
3582,153,108,45,25,0,10,0,119
3583,357,260,97,14,96,13,25,210
3585,680,465,215,164,98,39,39,341
3586,719,613,106,148,172,116,52,231
3587,1718,1376,342,406,293,120,133,766
3588,146,11,135,26,52,27,21,19
3589,444,196,248,127,164,46,30,77
3590,681,366,315,62,48,22,38,511
3591,312,256,56,19,21,91,11,170
3592,249,208,41,58,31,16,20,123
3593,288,173,115,21,0,56,28,183
3594,0,0,0,0,0,0,0,0
3595,1635,882,753,149,212,133,110,1032
3596,83,73,10,25,10,4,19,26
3597,384,374,10,86,112,18,61,108
3598,301,257,44,30,66,70,26,108
3599,523,468,55,76,98,116,20,213
3600,416,231,185,57,108,99,75,76
3601,177,100,77,55,25,20,29,47
3602,273,158,115,79,91,25,31,46
3603,936,607,329,93,174,229,212,229
3604,425,337,88,86,121,42,21,155
3605,308,265,43,43,149,86,0,30
3606,280,124,156,49,94,14,74,49
3607,455,341,114,70,147,89,75,74
3608,660,346,314,29,64,79,146,342
3609,703,562,141,157,113,94,97,241
3610,515,445,70,134,117,96,26,142
3611,422,282,140,47,32,34,21,289
3612,933,833,100,215,88,40,230,360
3613,588,433,155,90,106,131,164,96
3614,1236,1070,166,122,133,117,109,754
3615,436,276,160,12,32,28,77,288
3616,332,229,103,11,59,6,26,229
3617,398,254,144,6,47,85,58,202
3618,0,0,0,0,0,0,0,0
3619,15,11,4,2,2,3,2,7
3620,1,1,0,0,0,0,0,0
3621,0,0,0,0,0,0,0,0
3622,5,3,2,0,1,1,1,2
3623,64,31,33,1,9,9,10,34
3624,314,220,94,33,27,17,18,220
3625,326,281,45,7,20,20,27,251
3626,209,168,41,24,15,24,25,120
3627,1134,746,388,34,240,107,173,581
3628,818,456,362,32,166,119,82,420
3629,2660,1461,1199,292,494,647,460,767
3630,139,85,54,8,21,6,25,80
3631,133,101,32,10,12,5,11,95
3632,486,416,70,252,138,96,0,0
3633,2516,1373,1143,641,604,454,392,425
3634,4052,2165,1887,1367,1458,640,426,161
3635,5625,3006,2619,874,1451,978,771,1551
3636,4032,2373,1659,843,941,981,491,776
3637,2251,1192,1059,160,508,595,313,675
3638,4531,2979,1552,1558,1363,675,351,584
3639,3487,2440,1047,521,777,628,394,1167
3640,2224,1433,791,447,436,240,310,790
3641,1464,1017,447,346,312,257,172,378
3642,2676,1647,1029,404,502,521,443,807
3643,406,269,137,212,145,13,0,36
3644,2292,1325,967,489,855,563,164,221
3645,119,62,57,41,19,24,26,9
3646,2965,2109,856,967,613,458,405,522
3647,2259,1406,853,1111,686,209,202,51
3648,1729,1176,553,284,184,168,265,828
3649,5284,3949,1335,1383,776,522,386,2217
3650,30,19,11,11,3,0,6,10
3651,4752,3650,1102,1072,761,618,482,1820
3652,3694,2422,1272,834,598,474,287,1501
3653,4506,3791,715,1517,731,574,286,1398
3654,1323,860,463,465,298,187,146,227
3655,4095,2658,1437,1036,1078,979,411,591
3656,4956,3324,1632,1036,1060,1049,551,1260
3657,4954,2643,2311,854,984,1004,535,1577
3658,2880,1892,988,223,492,615,527,1023
3659,240,140,100,51,49,54,33,54
3660,1435,739,696,177,139,189,246,683
3661,913,628,285,0,83,209,96,525
3662,2763,1517,1246,373,502,490,494,904
3663,1433,1010,423,369,361,231,150,322
3664,1885,1138,747,331,384,531,203,437
3665,6925,6086,839,3585,1814,790,153,583
3666,404,344,60,95,114,79,52,64
3667,3738,2366,1372,649,409,441,484,1756
3668,7965,4398,3567,826,828,1650,1072,3590
3669,2139,1469,670,943,386,498,145,167
3670,2983,1748,1235,686,890,597,436,373
3671,4447,2396,2051,1258,1174,961,517,537
3672,1475,990,485,696,403,228,65,82
3673,3877,2236,1641,922,1204,858,311,582
3674,2904,1339,1565,246,319,613,589,1137
3675,806,550,256,110,270,159,43,224
3676,1279,771,508,266,210,244,144,414
3677,1303,689,614,267,289,238,223,285
3678,2601,2128,473,305,515,458,479,845
3679,2135,1650,485,781,405,407,229,313
3680,166,75,91,0,15,35,16,100
3681,842,494,348,50,59,89,89,554
3682,522,295,227,57,26,51,85,303
3683,1342,900,442,76,262,166,275,564
3684,3252,2358,894,385,650,589,441,1187
3685,3137,1969,1168,179,313,424,240,1981
3686,2170,1349,821,190,205,203,275,1297
3687,4845,2694,2151,249,409,321,525,3341
3688,2332,1732,600,314,412,242,295,1069
3689,4463,3401,1062,916,845,642,408,1651
3690,3205,2555,650,589,664,681,333,938
3691,1753,1308,445,309,284,229,295,635
3692,3061,2303,758,584,458,464,502,1053
3693,2347,1551,796,385,610,351,328,673
3694,3905,2490,1415,333,429,642,572,1928
3695,245,215,30,53,38,23,34,98
3696,1249,996,253,249,291,192,192,324
3697,3779,2777,1002,905,661,817,274,1121
3698,2674,2024,650,547,712,487,311,617
3699,2649,1799,850,710,539,412,403,586
3700,1317,1026,291,184,241,225,247,421
3701,2049,1644,405,463,460,528,124,474
3702,2847,2119,728,303,507,599,440,998
3703,3162,1898,1264,391,244,518,304,1705
3704,5765,3115,2650,183,425,756,855,3545
3705,456,348,108,80,130,31,62,154
3706,4420,2828,1592,455,480,528,437,2520
3707,2105,1215,890,235,453,315,348,754
3708,5379,2608,2771,530,703,676,605,2865
3709,8667,7681,986,1243,1581,1530,1293,3019
3710,3185,2436,749,543,515,490,261,1376
3711,3001,2056,945,436,257,677,502,1128
3712,3895,2698,1197,571,568,650,530,1577
3713,4493,2004,2489,373,542,800,636,2141
3714,7010,4661,2349,1321,1168,970,1062,2488
3715,214,137,77,10,55,41,31,77
3716,1307,695,612,55,75,141,100,935
3717,270,247,23,125,79,0,66,0
3718,2038,1079,959,282,174,245,163,1175
3719,7687,5690,1997,1137,1433,1229,1113,2776
3720,2312,1681,631,327,580,377,438,590
3721,1568,1052,516,251,291,186,307,532
3722,3962,2333,1629,748,761,727,580,1146
3723,4929,3716,1213,978,643,823,649,1836
3724,580,459,121,59,114,45,74,288
3725,2740,2157,583,259,632,582,230,1037
3726,1200,936,264,99,278,245,152,425
3727,2401,1613,788,634,481,416,330,539
3728,1869,1246,623,185,173,443,313,755
3729,3719,2655,1064,538,587,623,440,1531
3730,3306,2361,945,668,824,480,393,941
3731,2717,2047,670,335,423,481,427,1051
3732,1354,1053,301,291,280,211,300,272
3733,1094,944,150,252,213,189,149,291
3734,2651,1994,657,550,657,425,348,671
3735,3776,2365,1411,447,445,597,394,1894
3736,3490,2125,1365,276,304,457,329,2124
3737,2617,1841,776,135,419,281,161,1622
3738,1029,654,375,91,0,92,108,739
3739,3626,1626,2000,253,342,404,453,2175
3740,2669,1453,1216,260,322,521,410,1156
3741,0,0,0,0,0,0,0,0
3742,3699,1777,1922,279,428,582,650,1761
3743,2574,1753,821,441,480,144,111,1398
3744,1730,1290,440,236,374,219,231,670
3745,93,93,0,81,6,3,2,1
3746,379,360,19,180,68,41,34,56
3747,835,792,43,336,135,61,30,274
3748,41,39,2,19,7,4,4,6
3749,751,695,56,218,175,140,36,183
3750,78,72,6,32,19,0,25,2
3751,549,248,301,410,121,18,0,0
3752,0,0,0,0,0,0,0,0
3753,853,819,34,346,196,133,34,143
3754,732,640,92,195,214,233,66,23
3755,47,29,18,26,16,4,1,0
3756,24,10,14,1,4,3,5,11
3757,0,0,0,0,0,0,0,0
3758,4957,3717,1240,480,563,596,691,2626
3759,2312,1806,506,250,165,380,492,1026
3760,2201,1811,390,478,513,385,259,566
3761,2630,1857,773,254,364,488,184,1340
3762,2445,1644,801,967,584,355,283,256
3763,3536,2596,940,531,548,753,468,1236
3764,1892,1330,562,712,524,244,180,232
3765,1995,1478,517,973,487,239,111,186
3766,3459,2233,1226,1554,991,498,282,135
3767,3627,1844,1783,1421,926,744,338,197
3768,2423,1456,967,403,859,478,317,366
3769,1724,1099,625,107,177,269,238,933
3770,2500,1479,1021,492,725,616,304,363
3771,4200,2552,1648,810,1097,750,653,890
3772,1973,1181,792,750,304,474,214,230
3773,312,299,13,145,72,38,17,39
3774,3008,2707,301,690,571,647,387,713
3775,53,53,0,46,3,2,1,1
3776,2218,2093,125,734,477,343,229,434
3777,1467,1423,44,432,476,218,171,170
3778,1785,1487,298,602,400,221,279,284
3779,2248,1965,283,553,581,572,223,319
3780,1059,1017,42,301,172,106,47,433
3781,3002,2462,540,559,696,510,550,687
3782,1683,1367,316,565,243,228,146,500
3783,5583,3818,1765,1110,494,666,558,2755
3784,1910,1485,425,187,335,229,270,890
3785,4233,3106,1127,1061,1104,976,581,512
3786,3445,2581,864,970,783,633,507,552
3787,2551,1407,1144,1162,802,320,125,142
3788,3298,2811,487,1964,851,228,174,81
3789,128,122,6,61,23,14,11,19
3790,2649,1732,917,785,379,528,307,650
3791,12067,7324,4743,1013,1832,2194,2188,4840
3792,1356,793,563,103,115,132,185,821
3793,757,549,208,65,136,187,150,219
3794,4031,3092,939,436,751,574,367,1903
3795,2797,2044,753,449,595,525,393,836
3796,1884,1417,467,352,420,278,200,634
3797,3370,2696,674,285,376,534,310,1866
3798,3459,2096,1363,814,831,655,419,740
3799,1768,1241,527,269,502,348,331,318
3800,6603,4730,1873,1303,1802,1406,784,1308
3801,2632,2032,600,433,610,393,204,991
3802,3734,2708,1026,507,538,772,540,1378
3803,3923,2629,1294,638,961,903,643,778
3804,3078,2236,842,562,1032,581,302,602
3805,3825,2523,1302,978,1093,760,345,650
3806,3851,2930,921,815,1065,791,376,804
3807,4040,2800,1240,995,964,990,424,667
3808,3739,2719,1020,511,540,732,855,1100
3809,3494,2452,1042,880,741,578,507,788
3810,4699,3592,1107,876,982,842,614,1385
3811,4581,3491,1090,1111,931,789,395,1355
3812,3747,2436,1311,1614,1116,427,323,267
3813,3952,2843,1109,1277,1206,574,255,639
3814,3523,2514,1009,458,646,512,551,1356
3815,2580,1797,783,1030,450,481,256,364
3816,3210,2220,990,602,711,751,362,784
3817,3549,2238,1311,1691,818,473,351,217
3818,5086,4217,869,1600,1666,883,336,601
3819,3500,1806,1694,1448,1074,566,265,148
3820,3535,1954,1581,695,1064,858,538,380
3821,1587,941,646,473,555,290,122,147
3822,3535,2426,1109,739,864,928,398,606
3823,4312,2573,1739,996,1166,1000,550,600
3824,925,510,415,77,206,163,174,306
3825,3568,1789,1779,583,758,661,584,981
3826,2627,1731,896,315,711,639,356,606
3827,2172,1378,794,415,465,468,237,586
3828,1919,1195,724,470,430,301,250,468
3829,1510,912,598,139,502,403,218,249
3830,3563,2862,701,749,524,455,462,1373
3831,1519,1035,484,176,245,288,268,543
3832,2703,1729,974,391,684,723,349,557
3833,2641,1736,905,331,654,730,371,554
3834,4349,3167,1182,535,948,1124,707,1034
3835,1439,824,615,51,265,245,248,629
3836,3120,1716,1404,1346,1029,464,99,182
3837,4183,2181,2002,700,829,835,743,1077
3838,2683,1370,1313,109,407,487,604,1076
3839,2895,2244,651,210,310,354,373,1649
3840,2517,1674,843,249,222,273,292,1481
3841,2567,1767,800,186,538,542,181,1120
3842,3150,2250,900,729,936,438,375,672
3843,3007,2217,790,624,683,538,480,682
3844,1835,1182,653,586,535,257,130,326
3845,1478,855,623,212,441,374,182,268
3846,2672,1351,1321,546,828,435,271,592
3847,184,118,66,112,24,19,14,15
3848,2819,1717,1102,619,1258,277,221,445
3849,3050,1766,1284,456,650,869,458,616
3850,2704,1802,902,803,755,609,239,299
3851,5304,3120,2184,1758,1300,1103,599,545
3852,2002,1552,450,195,208,280,213,1105
3853,1676,1247,429,228,263,439,163,582
3854,3595,2599,996,530,610,704,505,1246
3855,2064,1467,597,176,360,321,304,902
3856,2169,1395,774,404,471,408,485,402
3857,3215,2535,680,657,962,703,331,562
3858,3515,2657,858,772,1291,694,415,344
3859,2481,1703,778,485,527,485,359,626
3860,1801,1223,578,151,392,440,306,511
3861,2346,1675,671,235,517,312,496,785
3862,2756,1806,950,157,330,253,421,1594
3863,2087,1322,765,323,261,384,293,825
3864,2488,1672,816,309,415,380,339,1045
3865,1501,1032,469,338,312,179,210,461
3866,5239,3528,1711,1012,1137,967,589,1535
3867,67,48,19,9,19,0,0,39
3868,4839,2907,1932,871,801,921,694,1551
3869,0,0,0,0,0,0,0,0
3870,1333,783,550,561,428,163,80,102
3871,1685,1225,460,455,424,402,180,225
3872,219,210,9,54,124,14,17,10
3873,26,25,1,8,11,5,1,2
3874,475,354,121,12,77,107,55,223
3875,350,173,177,16,17,43,66,207
3876,1231,701,530,256,150,191,183,451
3877,0,0,0,0,0,0,0,0
3878,1105,685,420,321,297,119,112,256
3879,245,152,93,71,66,26,25,57
3880,2693,1369,1324,193,225,278,472,1524
3881,4416,2028,2388,347,445,504,601,2520
3882,2970,1648,1322,701,336,327,354,1253
3883,9173,4149,5024,748,1045,1311,1749,4321
3884,251,194,57,38,36,91,59,26
3885,1371,866,505,294,377,273,99,328
3886,2800,1411,1389,585,695,524,314,683
3887,4114,2221,1893,429,1075,995,810,805
3888,1749,1016,733,335,552,299,282,281
3889,4117,2436,1681,620,819,892,605,1180
3890,3509,2282,1227,379,544,750,390,1447
3891,4416,2749,1667,805,694,716,504,1697
3892,5003,3069,1934,635,719,1065,909,1675
3893,3461,1624,1837,1176,1061,577,365,283
3894,2390,1076,1314,468,874,608,262,178
3895,3943,2430,1513,1281,1204,655,242,561
3896,3703,2897,806,857,669,777,347,1053
3897,4654,3671,983,792,1184,850,743,1085
3898,6200,4657,1543,1003,1304,970,651,2272
3899,3282,1821,1461,1058,950,488,464,322
3900,2351,1154,1197,809,778,265,194,304
3901,3213,1998,1215,1011,992,505,425,279
3902,2659,1269,1390,1115,734,384,218,209
3903,4150,2281,1869,1706,1178,519,373,374
3904,1510,739,771,579,544,208,109,71
3905,3117,1596,1521,660,671,572,494,720
3906,1999,1010,989,308,586,421,285,400
3907,3368,2168,1200,423,605,725,427,1188
3908,4726,2489,2237,592,642,1088,876,1527
3909,2178,1257,921,409,397,272,266,834
3910,1615,963,652,365,427,229,153,442
3911,3380,2038,1342,696,732,838,431,683
3912,3882,1969,1913,445,627,532,751,1527
3913,708,462,246,74,77,148,51,358
3914,2418,1700,718,257,379,298,507,977
3915,2387,1806,581,266,261,271,352,1236
3916,5126,2817,2309,194,499,707,518,3208
3917,1005,546,459,43,72,101,77,712
3918,7324,3871,3453,561,700,729,644,4689
3919,4385,2764,1621,819,1437,840,551,737
3920,445,336,109,71,212,92,56,14
3921,4818,3502,1316,1025,1241,1022,567,964
3922,4345,3005,1340,403,912,1129,683,1217
3923,3593,2380,1213,539,918,826,662,648
3924,2667,1678,989,747,894,589,229,208
3925,2647,2141,506,247,358,573,333,1137
3926,3846,2709,1137,494,623,788,700,1241
3927,2508,1441,1067,906,628,359,327,289
3928,2635,1669,966,904,905,532,142,152
3929,2128,1308,820,376,579,376,439,356
3930,461,247,214,176,171,58,27,29
3931,1266,611,655,637,350,71,71,137
3932,1899,1213,686,337,534,450,210,368
3933,2368,1270,1098,748,688,446,254,232
3934,1428,1114,314,276,244,253,179,476
3935,2829,2129,700,676,493,442,460,758
3936,6,6,0,2,2,1,0,0
3937,1907,1157,750,225,179,353,341,809
3938,2132,1256,876,306,442,514,249,621
3939,3129,1612,1517,416,738,642,496,837
3940,3836,1814,2022,471,530,677,563,1595
3941,1731,1086,645,172,209,207,244,898
3942,1575,864,711,329,436,335,205,270
3943,3289,1677,1612,1033,1036,622,246,353
3944,54,52,2,13,30,3,4,3
3945,2371,1848,523,606,768,455,219,322
3946,1588,943,645,79,168,259,281,802
3947,3524,1631,1893,142,304,468,568,2043
3948,135,135,0,0,0,0,0,0
3949,0,0,0,0,0,0,0,0
3950,4608,2165,2443,422,657,746,738,2045
3951,41,23,18,10,5,5,5,17
3952,535,471,64,168,140,80,75,71
3953,339,199,140,27,62,81,83,87
3954,509,375,134,82,121,83,35,188
3955,206,139,67,31,51,74,23,26
3956,27,18,9,4,7,10,3,3
3957,0,0,0,0,0,0,0,0
3958,396,268,128,59,99,142,45,51
3959,42,28,14,6,10,15,5,5
3960,464,353,111,52,85,83,62,182
3961,198,170,28,40,62,47,34,14
3962,441,336,105,50,81,79,59,173
3963,816,699,117,166,257,195,140,58
3964,479,441,38,223,90,72,69,25
3965,65,48,17,17,17,12,14,5
3966,1080,821,259,314,162,253,163,188
3967,0,0,0,0,0,0,0,0
3968,923,614,309,167,243,187,123,204
3969,10,6,4,0,3,3,0,3
3970,414,241,173,104,143,74,95,0
3971,579,483,96,251,73,142,46,66
3972,1490,819,671,197,179,237,205,673
3973,879,674,205,262,300,74,112,131
3974,0,0,0,0,0,0,0,0
3975,722,546,176,75,121,151,92,284
3976,1462,979,483,163,310,323,225,441
3977,877,618,259,264,274,142,105,93
3978,830,613,217,186,246,180,85,133
3979,721,489,232,87,272,100,58,204
3980,2109,1469,640,356,578,392,227,556
3981,512,483,29,108,40,137,37,190
3982,1,1,0,0,0,0,0,0
3983,72,30,42,2,12,10,14,33
3984,382,277,105,78,95,83,38,88
3985,1243,1115,128,208,131,388,365,151
3986,331,205,126,108,99,90,19,14
3987,278,252,26,56,54,44,67,57
3988,1335,1203,132,432,345,252,71,236
3989,269,257,12,146,24,54,22,24
3990,189,180,9,103,17,38,15,17
3991,353,234,119,86,16,57,0,194
3992,1164,1038,126,488,268,136,89,182
3993,554,450,104,229,84,46,60,136
3994,637,497,140,187,114,51,72,213
3995,31,29,2,15,6,3,3,5
3996,1515,1010,505,556,317,218,211,212
3997,329,218,111,172,118,10,0,29
3998,213,193,20,43,42,34,51,44
3999,268,255,13,127,48,29,24,39
4000,16,15,1,8,3,2,1,2
4001,0,0,0,0,0,0,0,0
4002,0,0,0,0,0,0,0,0
4003,15,7,8,11,3,1,0,0
4004,0,0,0,0,0,0,0,0
4005,0,0,0,0,0,0,0,0
4006,0,0,0,0,0,0,0,0
4007,0,0,0,0,0,0,0,0
4008,182,82,100,136,40,6,0,0
4009,568,544,24,92,143,116,63,154
4010,399,310,89,178,45,52,41,83
4011,281,214,67,159,47,13,34,28
4012,421,421,0,368,25,14,8,6
4013,551,543,8,153,127,60,37,173
4014,1138,1055,83,410,336,115,141,136
4015,86,86,0,9,12,16,9,40
4016,0,0,0,0,0,0,0,0
4017,192,135,57,51,65,44,4,28
4018,100,75,25,29,32,15,7,18
4019,35,25,10,9,12,8,1,5
4020,305,230,75,88,96,45,20,56
4021,356,288,68,40,51,36,72,156
4022,4,3,1,1,1,1,0,1
4023,415,313,102,119,131,61,27,76
4024,170,114,56,36,26,49,14,45
4025,189,127,62,40,29,54,15,50
4026,202,136,66,43,31,58,17,54
4027,2011,1179,832,157,112,327,339,1075
4028,1611,1131,480,272,106,121,166,947
4029,4382,1995,2387,575,969,862,744,1232
4030,177,95,82,50,33,26,37,31
4031,344,298,46,198,42,14,33,57
4032,988,571,417,406,214,133,117,119
4033,1089,458,631,229,219,288,169,185
4034,3224,1935,1289,659,582,501,529,953
4035,2987,1721,1266,536,689,585,510,667
4036,2726,1659,1067,578,749,527,313,559
4037,2355,1339,1016,820,635,369,228,303
4038,4628,2445,2183,431,840,800,736,1822
4039,1435,1035,400,259,457,220,166,334
4040,2115,1027,1088,739,713,373,76,214
4041,1717,920,797,402,476,476,172,191
4042,3061,1754,1307,1097,875,479,312,298
4043,2487,1292,1195,675,880,447,264,222
4044,734,511,223,219,103,161,42,209
4045,974,590,384,517,257,115,51,33
4046,4743,2073,2670,722,1022,1082,755,1162
4047,2801,1365,1436,1108,785,523,221,165
4048,1420,611,809,644,365,191,131,89
4049,536,333,203,117,152,174,51,42
4050,471,174,297,123,109,131,27,80
4051,2721,1255,1466,860,561,603,313,384
4052,2966,1626,1340,1000,1189,418,163,196
4053,1506,778,728,624,706,112,49,15
4054,1472,862,610,597,410,261,100,104
4055,2544,1639,905,1352,617,148,123,305
4056,1685,999,686,857,500,136,119,73
4057,1696,813,883,434,659,393,118,91
4058,2302,1305,997,893,478,571,155,205
4059,3372,2242,1130,711,847,573,383,858
4060,2266,1429,837,404,483,543,466,371
4061,1589,997,592,998,433,123,0,35
4062,1042,791,251,664,227,61,20,69
4063,3051,2215,836,569,770,704,447,561
4064,3197,1968,1229,1101,885,689,205,318
4065,3267,2192,1075,845,888,641,394,499
4066,1993,1279,714,609,527,392,161,304
4067,3155,2376,779,810,833,581,347,584
4068,2142,1331,811,880,674,341,131,116
4069,2821,1712,1109,1181,771,379,228,263
4070,3347,2467,880,897,930,665,179,676
4071,1325,907,418,557,324,222,83,139
4072,1382,875,507,447,300,356,118,161
4073,3794,1789,2005,1010,1073,972,273,465
4074,387,198,189,31,0,33,64,259
4075,270,166,104,29,59,77,14,92
4076,975,572,403,145,167,197,151,315
4077,735,310,425,64,92,156,141,281
4078,577,208,369,86,177,187,46,81
4079,0,0,0,0,0,0,0,0
4080,1972,1090,882,282,310,125,230,1025
4081,6673,2529,4144,589,248,880,640,4316
4082,2492,1408,1084,316,369,236,543,1028
4083,2912,1198,1714,167,341,614,568,1222
4084,1806,739,1067,120,172,285,549,680
4085,2003,1056,947,88,75,268,300,1271
4086,530,431,99,132,111,99,79,109
4087,291,213,78,63,55,54,16,103
4088,329,185,144,44,43,59,37,146
4089,2530,1565,965,266,356,761,334,814
4090,337,255,82,20,62,45,109,102
4091,2756,1954,802,354,561,351,441,1049
4092,985,678,307,263,283,216,90,132
4093,2997,2081,916,513,604,536,357,987
4094,498,362,136,57,215,25,55,146
4095,1538,893,645,275,244,354,165,500
4096,668,521,147,108,144,91,33,292
4097,1066,664,402,89,250,219,146,362
4098,1219,637,582,248,192,189,128,462
4099,2454,1674,780,484,429,382,345,814
4100,1383,928,455,183,437,305,102,356
4101,5119,3167,1952,621,937,790,743,2028
4102,2502,1286,1216,433,437,578,416,637
4103,413,212,201,34,83,53,66,177
4104,744,500,244,193,187,101,75,188
4105,2444,1422,1022,448,314,274,231,1177
4106,3963,2672,1291,1101,1296,713,141,711
4107,797,398,399,116,142,245,116,179
4108,1735,848,887,181,214,365,326,649
4109,1160,589,571,150,265,188,206,351
4110,3295,1768,1527,371,663,960,411,889
4111,2246,1237,1009,337,430,470,368,642
4112,2874,1640,1234,732,849,534,502,258
4113,414,324,90,35,19,151,0,209
4114,2128,1070,1058,639,852,371,158,107
4115,2008,1378,630,498,466,384,224,436
4116,2106,1524,582,464,451,440,213,537
4117,3728,2590,1138,874,768,760,472,854
4118,2246,1292,954,456,393,358,305,735
4119,1488,926,562,332,421,271,185,279
4120,2844,1506,1338,672,796,496,288,592
4121,1765,928,837,473,578,446,82,185
4122,1498,1010,488,151,342,204,67,734
4123,1712,913,799,228,245,294,309,637
4124,1320,659,661,514,415,223,112,56
4125,242,114,128,69,103,29,25,16
4126,248,160,88,72,90,22,23,40
4127,1061,612,449,172,277,292,80,240
4128,1182,844,338,195,185,207,155,440
4129,1220,640,580,127,290,277,278,248
4130,1109,660,449,272,350,239,141,107
4131,1961,1040,921,447,540,494,163,317
4132,1622,1011,611,308,527,288,189,309
4133,2248,1191,1057,413,528,479,317,511
4134,4935,3159,1776,669,882,906,985,1494
4135,1350,850,500,174,255,296,209,416
4136,1652,859,793,139,135,184,409,784
4137,218,113,105,19,15,34,30,119
4138,3389,1752,1637,301,238,527,474,1849
4139,1658,851,807,235,169,279,342,633
4140,2345,979,1366,105,204,283,439,1314
4141,246,157,89,25,72,25,63,59
4142,1079,541,538,189,168,146,237,339
4143,4667,2831,1836,395,761,932,792,1786
4144,362,277,85,122,170,44,13,12
4145,340,243,97,89,75,90,36,50
4146,245,125,120,46,96,34,19,50
4147,1519,927,592,225,488,308,216,281
4148,2697,1277,1420,784,807,361,299,445
4149,2919,1291,1628,239,614,645,600,821
4150,1821,1133,688,249,282,426,193,671
4151,764,500,264,106,196,112,79,272
4152,891,465,426,81,290,206,176,137
4153,2902,1289,1613,410,797,366,542,787
4154,2101,1111,990,301,351,510,248,691
4155,1635,980,655,337,444,293,166,396
4156,439,297,142,72,68,82,56,161
4157,518,392,126,115,126,15,81,181
4158,6590,3876,2714,1257,1082,1114,997,2141
4159,3085,1842,1243,787,827,640,356,474
4160,1693,863,830,690,505,185,201,111
4161,2338,1163,1175,604,683,593,216,242
4162,2642,1683,959,965,793,335,254,294
4163,1478,927,551,116,261,285,221,594
4164,2218,1193,1025,409,730,390,256,433
4165,1510,763,747,244,314,327,153,472
4166,2302,1320,982,343,282,408,222,1047
4167,935,610,325,323,225,110,46,231
4168,1895,1350,545,260,314,286,253,781
4169,3665,2397,1268,863,883,675,504,741
4170,1130,784,346,92,113,196,132,597
4171,4467,2343,2124,959,1060,709,484,1255
4172,3066,1604,1462,727,731,844,389,375
4173,2627,1389,1238,117,395,294,526,1295
4174,2379,1533,846,437,348,453,267,874
4175,592,398,194,117,194,101,92,88
4176,2194,1196,998,403,527,434,357,472
4177,3225,1796,1429,923,955,476,512,360
4178,1591,1131,460,227,265,336,179,583
4179,2612,1727,885,342,641,548,305,776
4180,2421,1707,714,297,578,354,305,888
4181,2167,1579,588,431,523,308,271,633
4182,2404,1587,817,474,618,511,230,571
4183,2821,1924,897,904,804,429,269,414
4184,4327,3053,1274,1154,1009,835,614,715
4185,3331,2204,1127,780,957,608,464,521
4186,892,603,289,128,180,165,189,230
4187,3668,2582,1086,1241,600,534,390,904
4188,4656,2899,1757,1146,1443,766,554,748
4189,3483,2247,1236,1151,983,567,407,375
4190,3068,2196,872,586,711,763,429,580
4191,3899,2707,1192,656,747,666,557,1272
4192,2193,1205,988,320,625,294,277,677
4193,932,693,239,121,209,273,94,235
4194,906,682,224,323,185,99,127,172
4195,1813,878,935,482,560,267,289,216
4196,411,254,157,130,111,49,86,35
4197,958,351,607,335,365,90,125,42
4198,1325,637,688,552,339,294,53,88
4199,882,678,204,480,234,83,27,59
4200,1725,1206,519,416,640,145,266,257
4201,428,212,216,94,109,121,57,47
4202,1848,905,943,483,446,399,206,314
4203,3482,2341,1141,398,910,844,383,947
4204,3326,2539,787,557,757,746,319,947
4205,3144,2146,998,884,742,603,370,545
4206,1609,651,958,404,592,322,122,169
4207,1860,769,1091,759,468,344,189,100
4208,2199,888,1311,777,712,343,209,158
4209,745,500,245,359,212,103,42,28
4210,2854,967,1887,802,788,670,414,181
4211,1588,790,798,465,432,393,168,130
4212,4464,2443,2021,1156,1215,703,640,750
4213,5072,2164,2908,1196,1326,1068,670,812
4214,3104,1520,1584,616,954,574,353,608
4215,133,52,81,4,32,34,22,40
4216,295,164,131,134,53,71,28,9
4217,1729,809,920,225,600,480,253,171
4218,2350,1487,863,369,615,514,294,559
4219,1342,842,500,161,133,278,238,531
4220,2620,1313,1307,436,673,326,357,828
4221,14,7,7,6,4,3,1,0
4222,465,325,140,87,102,55,51,170
4223,1723,967,756,178,412,333,300,500
4224,1285,735,550,481,463,147,62,132
4225,454,404,50,302,48,49,0,55
4226,571,362,209,459,49,60,3,0
4227,253,133,120,91,52,42,28,40
4228,766,329,437,200,250,22,133,161
4229,1565,787,778,512,466,353,115,118
4230,791,470,321,211,228,126,59,168
4231,628,250,378,152,178,140,85,74
4232,693,381,312,89,211,51,19,323
4233,2097,1381,716,492,743,330,196,336
4234,1538,883,655,183,457,318,229,350
4235,2890,1459,1431,846,918,494,335,297
4236,3369,1424,1945,882,1120,546,435,386
4237,3084,1489,1595,579,852,608,530,514
4238,1271,852,419,303,0,156,183,629
4239,2809,1880,929,560,645,567,392,644
4240,1114,640,474,344,231,262,107,170
4241,2867,1240,1627,616,810,710,341,390
4242,1253,533,720,232,309,300,195,217
4243,1067,457,610,267,366,109,97,227
4244,1220,632,588,160,191,325,262,282
4245,1270,677,593,221,428,208,78,335
4246,1162,581,581,284,404,262,70,142
4247,1678,1309,369,201,356,577,315,228
4248,3033,1439,1594,952,828,496,345,412
4249,3355,1788,1567,561,801,904,376,713
4250,1787,981,806,440,563,390,177,217
4251,2640,1298,1342,777,699,612,261,292
4252,2090,1157,933,205,404,299,275,906
4253,5011,2582,2429,1646,1394,886,448,637
4254,393,304,89,87,77,89,34,105
4255,1087,704,383,182,332,150,141,282
4256,1248,654,594,338,421,231,51,207
4257,225,144,81,20,34,38,31,101
4258,5112,3198,1914,904,1029,1035,690,1453
4259,3972,2803,1169,1603,1183,674,235,277
4260,1657,1119,538,639,428,277,103,211
4261,2262,898,1364,812,673,375,189,214
4262,3395,1290,2105,1701,1026,263,182,223
4263,2140,1393,747,737,583,391,178,251
4264,955,536,419,99,228,184,167,277
4265,871,557,314,78,133,147,120,392
4266,448,216,232,54,106,98,48,142
4267,0,0,0,0,0,0,0,0
4268,0,0,0,0,0,0,0,0
4269,0,0,0,0,0,0,0,0
4270,6,3,3,1,1,1,1,2
4271,287,138,149,35,68,62,31,91
4272,0,0,0,0,0,0,0,0
4273,13,6,7,2,3,3,1,4
4274,1336,563,773,117,167,284,256,511
4275,1954,879,1075,341,415,399,300,499
4276,348,258,90,42,79,64,37,125
4277,2543,1633,910,423,450,500,288,883
4278,380,201,179,30,34,145,42,129
4279,4127,2925,1202,254,662,660,447,2104
4280,3020,1412,1608,251,393,476,589,1310
4281,2283,1306,977,144,508,339,359,934
4282,2714,1459,1255,461,440,481,382,951
4283,1743,1328,415,224,302,188,259,771
4284,4386,3469,917,724,588,505,582,1987
4285,3274,2397,877,503,605,470,319,1377
4286,1478,1084,394,166,160,333,176,643
4287,1429,989,440,163,215,183,221,646
4288,1861,762,1099,428,545,333,214,341
4289,2842,2080,762,353,451,216,441,1381
4290,1807,1458,349,133,254,217,210,993
4291,3527,2788,739,682,729,597,597,922
4292,3808,2921,887,751,572,486,417,1583
4293,4316,3417,899,978,694,652,454,1537
4294,3565,3006,559,827,665,478,463,1132
4295,3152,2319,833,547,408,441,518,1238
4296,1436,1036,400,423,147,227,125,514
4297,4824,3713,1111,632,665,593,492,2442
4298,4769,3317,1452,370,491,789,913,2206
4299,1382,1152,230,393,324,300,75,290
4300,2758,2313,445,1101,613,365,161,519
4301,2723,1554,1169,375,541,562,440,805
4302,1408,867,541,338,194,246,191,439
4303,5073,3861,1212,645,691,688,713,2335
4304,1311,957,354,164,226,250,140,531
4305,2092,1411,681,281,455,287,150,919
4306,2198,883,1315,392,585,520,201,500
4307,1869,1033,836,281,418,417,213,541
4308,3868,2339,1529,985,916,767,536,664
4309,1177,489,688,343,399,194,138,103
4310,2125,1069,1056,290,726,238,223,648
4311,2118,1178,940,578,607,351,208,374
4312,2892,1942,950,200,269,296,213,1914
4313,4357,3053,1304,643,694,694,658,1667
4314,2642,2022,620,433,464,521,301,923
4315,3247,2187,1060,442,651,520,691,943
4316,3350,2447,903,663,535,558,355,1239
4317,2110,1724,386,587,332,348,130,713
4318,2391,727,1664,628,942,474,196,152
4319,377,254,123,23,54,91,80,129
4320,2732,1267,1465,450,781,664,433,404
4321,1536,732,804,211,509,280,301,235
4322,1549,642,907,132,341,428,200,449
4323,1954,1006,948,217,429,379,226,703
4324,1280,788,492,160,180,250,236,454
4325,3389,2807,582,509,428,371,396,1685
4326,810,659,151,104,156,226,128,196
4327,2520,1974,546,197,460,415,345,1103
4328,2707,1000,1707,443,846,650,455,313
4329,998,480,518,117,218,357,85,221
4330,1181,480,701,242,442,244,125,127
4331,1308,495,813,115,267,322,206,398
4332,1438,688,750,483,406,256,170,123
4333,3067,1469,1598,556,1030,704,152,624
4334,2727,1932,795,360,542,560,483,781
4335,1762,652,1110,335,497,485,277,168
4336,2424,1767,657,468,452,282,321,900
4337,2184,1348,836,420,533,456,315,460
4338,3172,2267,905,452,661,600,514,946
4339,2874,1520,1354,590,726,525,452,581
4340,1956,947,1009,519,654,495,128,161
4341,1509,442,1067,262,472,285,209,280
4342,2268,1180,1088,342,563,388,395,580
4343,2708,1231,1477,602,834,595,427,250
4344,1183,446,737,384,389,276,27,107
4345,1160,404,756,217,403,238,186,116
4346,1381,475,906,238,591,335,115,103
4347,1687,651,1036,298,318,370,228,473
4348,3179,1643,1536,321,545,580,512,1220
4349,1838,1116,722,436,267,425,289,421
4350,2129,1068,1061,149,343,530,369,737
4351,1473,1120,353,171,283,273,315,432
4352,1562,871,691,251,422,367,67,455
4353,2340,1741,599,148,249,356,532,1054
4354,1641,720,921,191,383,333,154,580
4355,854,544,310,182,220,197,138,117
4356,1590,1400,190,291,339,226,139,595
4357,486,422,64,110,69,96,78,132
4358,907,696,211,91,194,161,106,355
4359,2408,1953,455,249,448,435,314,961
4360,2986,2243,743,389,446,472,461,1218
4361,2625,2083,542,332,356,364,253,1321
4362,3898,2866,1032,491,571,492,522,1823
4363,1036,648,388,500,325,135,46,30
4364,101,46,55,43,19,25,7,8
4365,1768,1578,190,322,369,401,258,418
4366,2286,1542,744,141,252,325,307,1260
4367,331,221,110,13,80,64,42,132
4368,1171,436,735,146,274,178,155,418
4369,4584,3320,1264,174,459,395,519,3036
4370,1347,818,529,297,316,238,144,352
4371,2013,1598,415,141,308,198,209,1157
4372,2473,2012,461,402,375,472,470,753
4373,1714,1340,374,201,419,320,300,475
4374,1355,1025,330,199,277,212,143,525
4375,1742,1258,484,384,336,268,295,460
4376,1933,1178,755,401,616,430,255,231
4377,2489,1532,957,447,467,589,323,663
4378,929,640,289,287,178,129,88,246
4379,1603,1035,568,379,254,322,283,364
4380,2245,1124,1121,205,617,418,437,568
4381,3088,2096,992,708,722,543,457,658
4382,895,350,545,178,257,199,106,155
4383,2741,1029,1712,425,880,594,252,590
4384,11979,9046,2933,2775,2824,2241,1372,2767
4385,3377,2582,795,694,794,696,291,902
