TAZ,HHLESSGQ,HHCHILDNO,HHCHILDYES,HHINC1,HHINC2,HHINC3,HHINC4,HHINC5,HHINC6,HHGQYES,HHGQNO,HHBASE
1,698,662,36,177,175,104,66,96,80,2,1078,700
2,415,167,248,184,133,51,24,9,14,13,1242,428
3,2194,1972,222,536,274,217,233,398,536,12,4448,2206
4,1885,1679,206,385,133,124,170,383,690,0,3978,1885
5,2494,2298,196,353,249,200,188,471,1033,4,4342,2498
6,987,856,131,111,92,98,96,193,397,12,2173,999
7,380,340,40,169,82,38,29,32,30,0,923,380
8,639,599,40,95,45,78,50,85,286,0,1091,639
9,586,126,460,140,124,112,42,65,103,595,1978,1181
10,1238,999,239,82,33,35,73,192,823,100,2764,1338
11,741,662,79,330,160,75,56,63,57,0,1578,741
12,595,557,38,107,77,88,78,113,132,0,919,595
13,502,470,32,90,65,74,66,95,112,0,853,502
14,784,740,44,345,180,83,58,82,36,208,1089,992
15,454,429,25,200,105,48,33,47,21,0,860,454
16,1034,977,57,455,238,110,76,108,47,171,1478,1205
17,932,880,52,410,215,99,69,97,42,0,1204,932
18,1138,1031,107,613,322,88,41,48,26,196,1607,1334
19,1071,971,100,577,303,83,39,45,24,112,1636,1183
20,896,798,98,313,228,103,73,87,92,63,1502,959
21,1468,1311,157,192,124,118,95,253,686,94,2590,1562
22,744,664,80,97,63,60,48,128,348,27,1181,771
23,928,749,179,61,25,27,55,144,616,60,1541,988
24,862,807,55,154,112,127,114,164,191,205,1338,1067
25,1314,1230,84,235,170,194,173,249,293,0,2040,1314
26,1712,1615,97,537,363,263,159,177,213,42,2987,1754
27,1164,1098,66,365,247,179,108,120,145,0,1994,1164
28,1635,1542,93,513,346,252,152,169,203,365,2689,2000
29,1059,954,105,374,278,112,84,98,113,9,1822,1068
30,1524,1373,151,538,399,162,120,141,164,77,2767,1601
31,382,344,38,135,100,41,30,35,41,323,548,705
32,501,435,66,56,47,50,49,98,201,0,904,501
33,923,801,122,103,86,92,90,180,372,0,1527,923
34,432,302,130,131,63,16,12,29,181,7,885,439
35,648,600,48,242,110,56,46,57,137,0,1317,648
36,612,567,45,229,104,53,44,54,128,2,1252,614
37,607,562,45,227,103,53,43,54,127,0,1011,607
38,424,379,45,189,91,43,32,36,33,0,1117,424
39,854,763,91,380,184,86,65,72,67,0,1818,854
40,1139,1026,113,402,299,121,90,106,121,110,1734,1249
41,1093,985,108,386,286,116,86,101,118,27,1632,1120
42,1340,1215,125,721,379,104,49,56,31,1336,2398,2676
43,928,841,87,500,263,72,34,39,20,74,1267,1002
44,1022,917,105,128,92,132,130,202,338,0,1951,1022
45,816,732,84,102,73,105,103,161,272,0,1625,816
46,708,635,73,89,64,91,90,140,234,0,1351,708
47,949,890,59,140,66,116,74,126,427,0,1704,949
48,1036,971,65,153,72,127,81,138,465,0,1641,1036
49,547,516,31,74,36,50,45,94,248,0,962,547
50,948,895,53,129,62,86,77,164,430,2,2033,950
51,1024,967,57,139,67,93,83,177,465,7,1994,1031
52,1166,1079,87,260,151,72,111,194,378,12,1957,1178
53,1289,1193,96,287,167,79,122,214,420,0,2025,1289
54,611,565,46,136,79,38,58,101,199,2,852,613
55,832,772,60,171,81,75,68,117,320,0,1315,832
56,369,342,27,76,36,33,30,52,142,2,694,371
57,719,667,52,148,70,65,58,101,277,0,1363,719
58,608,541,67,223,145,51,35,70,84,0,1431,608
59,916,814,102,336,219,76,53,105,127,1,1444,917
60,1145,1091,54,146,120,133,131,216,399,19,1806,1164
61,622,566,56,103,84,135,108,115,77,212,1020,834
62,170,152,18,48,36,18,14,25,29,19,294,189
63,52,49,3,12,10,12,9,4,5,8,77,60
64,713,643,70,332,175,39,44,77,46,11,1545,724
65,570,542,28,239,101,40,24,41,125,291,779,861
66,1101,1047,54,462,196,77,47,79,240,0,1757,1101
67,1436,1366,70,603,255,101,62,103,312,44,2413,1480
68,828,729,99,196,127,91,68,120,226,47,1577,875
69,2012,1797,215,263,170,162,130,346,941,150,3501,2162
70,1301,1225,76,435,315,178,128,116,129,31,1937,1332
71,1164,1096,68,389,282,159,115,104,115,37,1909,1201
72,1517,1381,136,252,205,329,264,281,186,313,2404,1830
73,320,293,27,174,99,18,15,6,8,2,526,322
74,1120,907,213,532,402,77,53,42,14,8,2606,1128
75,664,538,126,315,239,45,31,25,9,0,1440,664
76,1654,1510,144,517,226,123,68,309,411,67,1967,1721
77,762,696,66,238,104,57,31,142,190,29,2262,791
78,1399,1246,153,489,356,161,114,136,143,48,2449,1447
79,75,67,8,26,19,9,6,7,8,6,86,81
80,685,646,39,78,60,56,44,114,333,13,1173,698
81,141,128,13,15,13,3,7,15,88,216,238,357
82,260,260,0,23,3,0,19,62,153,10,358,270
83,34,30,4,10,6,5,4,3,6,7,59,41
84,332,332,0,27,6,0,20,84,195,7,773,339
85,268,238,30,71,63,25,24,41,44,40,463,308
86,0,0,0,0,0,0,0,0,0,14,0,14
87,0,0,0,0,0,0,0,0,0,1,0,1
88,675,594,81,160,104,74,55,98,184,219,1448,894
89,178,168,10,20,16,14,11,29,88,217,298,395
90,172,157,15,18,15,4,9,18,108,21,316,193
91,23,21,2,2,2,0,1,2,16,13,48,36
92,2096,1801,295,178,152,236,245,411,874,8,3637,2104
93,3581,3233,348,324,270,341,363,836,1447,45,6301,3626
94,3171,2810,361,308,239,284,318,648,1374,14,5406,3185
95,2333,1886,447,299,195,137,167,340,1195,2,4733,2335
96,597,537,60,36,33,57,52,101,318,0,1202,597
97,2239,1725,514,309,369,276,269,288,728,52,5730,2291
98,1475,1153,322,191,225,184,179,287,409,10,3853,1485
99,1549,1315,234,175,209,271,218,245,431,0,3858,1549
100,57,55,2,0,3,7,7,12,28,0,99,57
101,284,162,122,20,20,26,26,38,154,0,783,284
102,713,619,94,124,109,110,90,113,167,0,1535,713
103,646,533,113,84,93,80,81,135,173,0,1585,646
104,395,326,69,51,57,49,50,82,106,0,947,395
105,367,303,64,48,53,46,46,77,97,2,902,369
106,536,442,94,69,77,66,68,112,144,0,1183,536
107,673,550,123,87,95,80,82,113,216,0,1558,673
108,576,471,105,74,82,68,70,97,185,14,1368,590
109,391,319,72,51,55,46,48,66,125,8,971,399
110,726,593,133,94,103,86,89,122,232,0,1705,726
111,860,754,106,173,179,88,87,117,216,9,1819,869
112,863,757,106,174,179,89,87,117,217,17,1845,880
113,807,707,100,163,168,83,82,109,202,0,1708,807
114,212,121,91,15,15,20,20,28,114,0,593,212
115,439,250,189,31,31,41,41,59,236,0,1121,439
116,589,499,90,80,85,60,56,95,213,0,1517,589
117,554,470,84,75,80,57,53,90,199,4,1358,558
118,973,825,148,132,140,99,92,158,352,4,2249,977
119,554,444,110,86,93,57,65,95,158,1,1305,555
120,777,623,154,121,131,81,91,134,219,0,1798,777
121,453,363,90,70,76,47,53,78,129,0,1063,453
122,490,393,97,76,82,51,57,84,140,0,1306,490
123,743,595,148,115,125,77,87,128,211,3,1623,746
124,646,510,136,77,89,96,87,117,180,2,1523,648
125,553,437,116,66,76,82,75,100,154,3,1488,556
126,449,354,95,54,62,67,61,81,124,1,1150,450
127,641,506,135,77,88,95,87,116,178,0,1494,641
128,514,398,116,64,76,69,59,103,143,0,1347,514
129,682,592,90,119,104,106,87,108,158,3,1513,685
130,550,477,73,96,84,85,70,87,128,0,1288,550
131,606,469,137,76,89,82,70,122,167,2,1499,608
132,409,315,94,56,67,50,49,53,134,5,1273,414
133,623,595,28,90,86,83,67,81,216,22,1163,645
134,1211,635,576,41,49,77,92,140,812,3,3790,1214
135,551,526,25,80,76,73,59,72,191,3,988,554
136,642,613,29,93,89,86,69,84,221,7,1057,649
137,421,326,95,52,62,57,48,85,117,0,1203,421
138,964,910,54,96,80,86,81,158,463,61,1608,1025
139,1440,1360,80,143,120,128,121,236,692,1,2345,1441
140,787,743,44,78,66,70,66,129,378,31,1331,818
141,787,743,44,78,66,70,66,129,378,0,1408,787
142,134,107,27,25,23,15,13,16,42,0,310,134
143,830,665,165,152,145,93,81,100,259,0,1889,830
144,770,617,153,141,135,87,75,93,239,74,1910,844
145,693,555,138,127,121,78,68,84,215,32,1475,725
146,854,684,170,156,149,96,84,103,266,31,1736,885
147,647,584,63,95,119,64,59,111,199,34,1482,681
148,575,519,56,85,106,57,52,99,176,0,1208,575
149,460,415,45,68,85,46,42,79,140,0,733,460
150,677,611,66,100,125,67,61,116,208,19,1053,696
151,571,515,56,84,105,57,52,98,175,70,1198,641
152,601,542,59,89,111,60,54,103,184,44,983,645
153,647,525,122,54,74,51,50,102,316,0,1362,647
154,544,442,102,46,62,43,42,86,265,69,1197,613
155,586,476,110,49,67,46,45,92,287,2,1200,588
156,304,247,57,26,35,24,24,48,147,0,702,304
157,768,624,144,65,88,60,59,121,375,14,1690,782
158,622,559,63,38,34,59,54,105,332,0,1206,622
159,663,596,67,40,37,63,58,112,353,0,1265,663
160,784,705,79,47,43,74,68,133,419,0,1368,784
161,335,246,89,32,28,25,31,52,167,0,751,335
162,625,520,105,54,37,44,56,135,299,22,1399,647
163,320,266,54,28,19,22,29,69,153,2,648,322
164,1293,1076,217,113,77,90,116,279,618,0,1963,1293
165,313,229,84,30,26,23,29,49,156,0,844,313
166,509,373,136,48,43,38,47,80,253,160,894,669
167,271,199,72,26,23,20,25,42,135,0,749,271
168,530,388,142,50,44,40,49,83,264,0,1116,530
169,752,621,131,86,72,45,59,99,391,0,1590,752
170,773,638,135,88,74,46,61,102,402,0,1498,773
171,467,385,82,53,45,28,37,62,242,0,900,467
172,733,663,70,80,60,50,68,174,301,26,1222,759
173,860,777,83,93,70,59,79,204,355,0,1352,860
174,939,922,17,129,112,119,132,176,271,83,1425,1022
175,639,627,12,88,77,81,90,120,183,7,958,646
176,440,398,42,83,64,50,43,39,161,0,890,440
177,789,713,76,149,116,90,77,69,288,0,1553,789
178,1173,1061,112,221,172,134,114,103,429,0,1852,1173
179,513,440,73,42,54,66,65,75,211,0,1099,513
180,439,377,62,36,47,57,56,65,178,21,933,460
181,593,492,101,64,66,54,68,101,240,0,1174,593
182,386,320,66,41,43,35,44,66,157,0,787,386
183,491,407,84,53,55,45,57,83,198,0,995,491
184,699,579,120,75,78,64,80,119,283,0,1250,699
185,726,602,124,78,81,67,84,123,293,1,1581,727
186,278,270,8,75,53,26,25,36,63,4,641,282
187,1169,1136,33,317,224,108,105,153,262,83,1706,1252
188,935,909,26,253,179,87,84,122,210,0,1340,935
189,436,367,69,69,71,54,54,73,115,1,988,437
190,392,330,62,62,64,49,49,65,103,8,856,400
191,617,520,97,97,101,77,76,103,163,0,1379,617
192,457,344,113,42,50,46,56,85,178,1801,995,2258
193,481,362,119,45,53,48,59,90,186,2,1179,483
194,907,684,223,84,100,90,111,170,352,12,2103,919
195,587,442,145,54,65,58,72,110,228,6,1240,593
196,972,850,122,228,223,91,88,115,227,5,1985,977
197,1102,964,138,259,253,104,99,130,257,0,2357,1102
198,1763,1699,64,455,367,144,164,200,433,11,2807,1774
199,735,613,122,277,229,57,56,41,75,0,1660,735
200,1187,990,197,447,369,92,90,66,123,0,2161,1187
201,322,269,53,121,100,25,24,18,34,9,850,331
202,381,318,63,143,119,30,29,21,39,0,877,381
203,351,309,42,46,50,23,24,46,162,0,738,351
204,615,541,74,80,88,41,42,80,284,9,1354,624
205,1060,932,128,139,151,71,73,139,487,60,2424,1120
206,795,738,57,48,86,85,104,171,301,6,1649,801
207,1056,981,75,64,114,112,139,227,400,18,2066,1074
208,485,411,74,58,50,48,47,83,199,20,1053,505
209,625,529,96,74,64,62,61,107,257,35,1464,660
210,505,428,77,60,52,50,49,86,208,14,1189,519
211,674,571,103,80,69,67,66,115,277,95,1682,769
212,789,724,65,39,70,103,95,167,315,6,1774,795
213,459,421,38,22,41,60,55,97,184,36,1179,495
214,608,558,50,30,54,79,73,129,243,6,1479,614
215,645,592,53,31,57,84,78,137,258,13,1354,658
216,637,565,72,34,63,46,41,93,360,13,1330,650
217,770,684,86,42,76,56,49,113,434,0,1679,770
218,736,586,150,99,113,89,89,137,209,3,1569,739
219,1020,813,207,138,157,123,124,190,288,0,2212,1020
220,439,350,89,59,67,53,53,82,125,2,969,441
221,491,391,100,66,75,59,60,92,139,1,1145,492
222,523,417,106,71,80,63,64,97,148,1,1221,524
223,482,377,105,62,73,60,58,94,135,4,1202,486
224,707,553,154,92,108,88,86,137,196,0,1810,707
225,452,353,99,59,69,56,55,88,125,43,1109,495
226,446,396,50,24,44,33,28,65,252,47,865,493
227,298,265,33,16,30,22,19,44,167,1,702,299
228,820,696,124,72,108,122,70,158,290,0,1664,820
229,471,400,71,41,62,70,40,90,168,0,965,471
230,1395,1239,156,101,82,117,108,229,758,0,2371,1395
231,515,458,57,37,30,43,40,84,281,0,995,515
232,591,525,66,43,35,50,46,97,320,0,1179,591
233,0,0,0,0,0,0,0,0,0,56,0,56
234,104,54,50,3,4,7,8,12,70,4,327,108
235,524,425,99,44,60,41,41,83,255,0,1118,524
236,0,0,0,0,0,0,0,0,0,0,0,0
237,85,82,3,2,3,12,10,30,28,52,124,137
238,426,321,105,39,47,42,52,80,166,47,921,473
239,1233,1115,118,82,101,170,135,245,500,0,2282,1233
240,1453,1105,348,84,113,115,107,275,759,4,3072,1457
241,640,526,114,77,68,43,42,136,274,0,1222,640
242,728,525,203,96,97,83,86,195,171,44,2294,772
243,1412,1196,216,89,130,177,124,236,656,73,2937,1485
244,1208,928,280,77,87,73,85,231,655,0,2592,1208
245,1159,900,259,116,217,216,172,267,171,21,3806,1180
246,1344,966,378,108,156,135,142,172,631,0,3411,1344
247,966,415,551,345,292,118,93,47,71,0,3446,966
248,559,497,62,123,138,34,25,95,144,4,983,563
249,1146,1036,110,242,348,136,77,153,190,38,1785,1184
250,1299,1156,143,286,322,80,58,222,331,27,2609,1326
251,1035,956,79,110,136,106,88,189,406,14,1813,1049
252,393,363,30,42,52,40,33,72,154,3,794,396
253,801,740,61,85,105,82,68,146,315,18,1504,819
254,494,437,57,52,49,34,27,101,231,0,961,494
255,475,421,54,50,47,33,26,97,222,4,845,479
256,936,829,107,98,93,65,51,192,437,2,1562,938
257,837,741,96,88,83,58,45,171,392,0,1578,837
258,425,377,48,31,44,34,33,60,223,2,821,427
259,962,853,109,71,99,77,74,137,504,26,1820,988
260,1176,1043,133,87,121,94,91,167,616,10,2312,1186
261,912,796,116,167,183,78,63,182,239,86,1979,998
262,721,629,92,132,145,61,50,144,189,27,1424,748
263,626,546,80,115,126,53,43,125,164,0,1388,626
264,535,467,68,98,108,46,37,107,139,1,1345,536
265,341,277,64,66,63,39,26,52,95,0,852,341
266,332,270,62,65,62,38,25,50,92,1,896,333
267,507,412,95,99,94,58,38,77,141,1,1129,508
268,694,564,130,135,129,80,52,105,193,54,1853,748
269,448,383,65,42,62,46,36,77,185,117,1041,565
270,774,580,194,102,113,62,66,97,334,0,1827,774
271,435,346,89,50,39,53,37,100,156,15,1428,450
272,479,325,154,67,118,56,62,71,105,6,1916,485
273,410,271,139,90,120,64,46,34,56,54,1474,464
274,377,152,225,167,121,46,22,9,12,0,1023,377
275,746,638,108,70,102,77,60,129,308,25,1473,771
276,487,416,71,45,67,51,39,84,201,0,1096,487
277,460,393,67,43,63,48,37,79,190,5,1049,465
278,408,323,85,18,22,47,43,64,214,0,943,408
279,479,379,100,21,26,55,50,75,252,0,1075,479
280,575,455,120,25,31,66,60,90,303,0,1313,575
281,468,370,98,20,25,53,49,73,248,1,915,469
282,393,307,86,28,32,41,33,65,194,2,838,395
283,707,552,155,51,57,74,59,117,349,0,1534,707
284,618,483,135,44,50,65,51,103,305,0,1434,618
285,604,496,108,63,78,44,46,110,263,0,1256,604
286,433,356,77,45,56,31,33,79,189,0,859,433
287,478,393,85,50,62,35,37,87,207,0,943,478
288,483,397,86,50,62,35,37,88,211,0,981,483
289,511,420,91,53,66,37,39,93,223,40,1036,551
290,837,688,149,100,89,56,56,178,358,0,1820,837
291,677,557,120,81,72,46,45,144,289,0,1330,677
292,615,461,154,81,89,50,52,77,266,0,1269,615
293,413,309,104,54,60,33,35,52,179,0,1060,413
294,448,346,102,40,46,49,45,64,204,0,969,448
295,303,234,69,27,31,33,30,43,139,0,698,303
296,463,301,162,63,96,62,58,89,95,34,1750,497
297,618,392,226,80,123,96,92,129,98,4,2275,622
298,293,195,98,138,88,2,12,43,10,106,822,399
299,197,138,59,44,39,18,23,31,42,0,513,197
300,502,388,114,45,51,55,50,72,229,22,1030,524
301,521,403,118,47,53,57,52,74,238,0,1098,521
302,601,521,80,33,25,38,41,83,381,1,1515,602
303,300,260,40,16,12,19,20,41,192,3,528,303
304,428,329,99,41,60,49,26,58,194,20,1066,448
305,805,619,186,76,112,93,49,110,365,14,2243,819
306,486,399,87,21,19,43,28,82,293,1,1123,487
307,688,529,159,65,96,79,42,94,312,8,1944,696
308,636,397,239,111,121,88,55,115,146,12,2066,648
309,715,568,147,83,64,87,62,164,255,5,1866,720
310,428,340,88,50,38,52,37,98,153,0,1332,428
311,568,355,213,99,108,79,49,103,130,15,2025,583
312,191,162,29,29,36,25,21,43,37,6,429,197
313,337,211,126,59,64,47,29,61,77,0,1274,337
314,433,369,64,35,43,60,20,92,183,44,1307,477
315,397,338,59,32,40,55,19,85,166,15,1225,412
316,478,325,153,67,118,56,62,71,104,20,1915,498
317,358,259,99,48,45,40,31,72,122,7,978,365
318,345,234,111,48,85,40,45,51,76,0,1311,345
319,301,190,111,18,31,31,36,50,135,0,842,301
320,402,294,108,25,57,41,33,75,171,3,1201,405
321,332,243,89,21,47,33,27,62,142,0,993,332
322,394,219,175,88,95,44,45,66,56,16,1362,410
323,413,229,184,92,100,47,47,69,58,9,1488,422
324,537,372,165,41,59,78,50,87,222,36,1580,573
325,475,329,146,36,52,69,45,77,196,13,1293,488
326,498,305,193,96,134,62,55,54,97,0,1560,498
327,310,143,167,86,96,24,27,33,44,0,1223,310
328,257,119,138,71,80,20,22,28,36,0,994,257
329,306,214,92,18,28,41,25,42,152,14,889,320
330,616,431,185,36,56,82,51,85,306,22,1735,638
331,418,292,126,25,38,56,34,57,208,19,1107,437
332,442,306,136,34,49,64,42,71,182,104,1297,546
333,550,346,204,33,57,57,65,92,246,3,1622,553
334,462,291,171,28,48,48,55,77,206,0,1336,462
335,451,349,102,27,40,70,58,104,152,0,1139,451
336,734,569,165,44,65,114,95,169,247,0,1933,734
337,551,427,124,33,49,85,71,127,186,0,1608,551
338,497,385,112,30,44,77,64,114,168,2,1423,499
339,259,201,58,16,23,40,33,60,87,0,779,259
340,463,362,101,64,97,93,78,77,54,13,1659,476
341,244,191,53,34,51,49,41,41,28,0,858,244
342,426,333,93,59,89,86,72,71,49,13,1515,439
343,388,303,85,54,81,78,66,65,44,8,1382,396
344,401,313,88,56,84,81,68,67,45,36,1520,437
345,625,432,193,48,69,90,59,101,258,22,1514,647
346,592,455,137,50,82,66,57,65,272,13,1503,605
347,493,379,114,42,68,55,48,54,226,10,1181,503
348,357,274,83,30,50,40,35,39,163,5,1035,362
349,379,291,88,32,53,42,37,42,173,28,909,407
350,375,274,101,24,53,38,30,70,160,3,1050,378
351,630,321,309,50,138,83,35,136,188,0,2160,630
352,559,348,211,48,93,63,47,83,225,3,1667,562
353,785,399,386,63,173,104,43,170,232,13,2874,798
354,415,259,156,35,69,47,35,61,168,0,1342,415
355,614,460,154,42,67,117,100,111,177,20,1945,634
356,456,322,134,54,58,52,48,93,151,16,1455,472
357,395,279,116,46,50,45,42,81,131,0,1321,395
358,455,321,134,54,58,52,48,93,150,0,1614,455
359,584,412,172,69,74,67,62,119,193,0,1862,584
360,343,242,101,40,44,39,36,70,114,30,1219,373
361,307,217,90,36,39,35,32,63,102,4,1048,311
362,471,330,141,75,100,67,55,73,101,4,1681,475
363,447,313,134,71,95,63,52,69,97,0,1579,447
364,341,239,102,54,72,48,40,53,74,2,1095,343
365,346,242,104,55,73,49,40,53,76,0,1135,346
366,257,182,75,31,54,48,34,43,47,18,732,275
367,377,266,111,45,79,71,50,64,68,0,1099,377
368,589,425,164,77,78,67,70,157,140,5,1957,594
369,175,126,49,23,23,20,21,47,41,0,569,175
370,716,459,257,66,140,121,97,147,145,0,2770,716
371,709,515,194,116,155,109,95,98,136,0,2652,709
372,799,492,307,137,220,104,105,116,117,0,2965,799
373,581,373,208,54,113,99,79,120,116,3,2268,584
374,386,289,97,27,42,74,63,70,110,0,1303,386
375,363,278,85,46,69,46,37,79,86,4,1348,367
376,223,171,52,28,43,29,23,48,52,0,741,223
377,473,363,110,60,90,61,48,103,111,0,1787,473
378,343,263,80,44,65,44,35,74,81,0,1197,343
379,495,353,142,35,68,107,76,115,94,8,1869,503
380,361,257,104,26,50,78,55,84,68,6,1405,367
381,338,241,97,24,47,73,52,78,64,0,1372,338
382,331,236,95,24,46,72,51,77,61,11,1325,342
383,299,213,86,21,41,65,46,69,57,24,1199,323
384,306,192,114,27,46,50,47,66,70,0,1219,306
385,361,262,99,59,79,55,48,50,70,6,1281,367
386,369,231,138,32,56,60,57,79,85,0,1608,369
387,380,295,85,38,71,71,56,88,56,0,1343,380
388,309,225,84,50,68,47,41,43,60,1,1128,310
389,464,291,173,40,70,75,71,100,108,0,1916,464
390,624,430,194,121,139,116,108,110,30,0,2002,624
391,491,332,159,83,108,85,76,76,63,14,1659,505
392,542,367,175,92,119,94,83,84,70,0,1905,542
393,433,363,70,50,51,52,40,75,165,24,1042,457
394,600,503,97,70,71,72,56,104,227,68,1339,668
395,421,353,68,49,50,50,39,73,160,1,1006,422
396,663,556,107,77,79,79,62,115,251,10,1293,673
397,1043,853,190,69,97,142,115,206,414,301,2004,1344
398,814,666,148,53,76,110,90,161,324,0,1744,814
399,12,10,2,2,1,1,1,2,5,16,19,28
400,44,38,6,5,3,4,3,8,21,0,84,44
401,465,397,68,69,43,35,26,67,225,0,959,465
402,412,337,75,27,38,56,45,82,164,0,872,412
403,907,583,324,109,116,133,90,211,248,0,2271,907
404,521,335,186,63,67,77,52,121,141,0,1746,521
405,227,181,46,43,36,11,14,32,91,0,517,227
406,1468,1328,140,97,120,203,161,291,596,0,2694,1468
407,530,423,107,101,84,25,33,75,212,10,1442,540
408,506,416,90,21,20,44,30,86,305,0,1107,506
409,13,11,2,2,2,2,1,3,3,73,26,86
410,495,358,137,66,62,55,43,99,170,1,1601,496
411,323,234,89,43,40,36,28,65,111,29,914,352
412,826,539,287,109,157,129,120,145,166,0,2703,826
413,376,245,131,50,71,59,55,66,75,0,1213,376
414,434,270,164,37,73,49,36,64,175,11,1293,445
415,657,412,245,96,127,119,94,87,134,0,2552,657
416,777,487,290,113,150,140,111,102,161,0,2778,777
417,822,506,316,140,226,107,108,120,121,4,2967,826
418,724,459,265,93,144,113,107,151,116,10,2803,734
419,529,364,165,102,117,99,91,93,27,9,1885,538
420,412,198,214,66,114,66,49,43,74,5,1794,417
421,309,148,161,50,86,50,36,32,55,0,1267,309
422,354,197,157,79,86,40,40,59,50,69,1363,423
423,606,548,58,40,50,84,67,120,245,0,1195,606
424,473,428,45,31,39,65,52,94,192,0,873,473
425,751,679,72,50,61,104,82,149,305,1,1596,752
426,743,591,152,51,42,71,48,107,424,3,1505,746
427,851,677,174,59,48,81,55,122,486,0,1840,851
428,542,353,189,74,112,73,68,104,111,14,1926,556
429,386,251,135,52,80,52,49,74,79,1,1382,387
430,353,230,123,48,73,47,44,68,73,7,1344,360
431,416,271,145,57,86,56,52,80,85,6,1459,422
432,709,528,181,68,117,118,92,155,159,14,2711,723
433,506,377,129,49,84,84,66,110,113,20,1815,526
434,254,189,65,24,42,42,33,55,58,7,887,261
435,381,284,97,37,63,63,50,83,85,0,1376,381
436,468,349,119,45,77,78,61,102,105,0,1770,468
437,527,393,134,51,87,88,69,115,117,0,2070,527
438,807,588,219,138,136,148,121,117,147,88,2857,895
439,321,277,44,39,31,47,32,72,100,8,701,329
440,586,530,56,124,178,70,39,78,97,113,812,699
441,770,696,74,163,234,91,51,103,128,78,1807,848
442,30,26,4,4,3,4,3,7,9,139,61,169
443,596,539,57,126,181,71,40,80,98,13,1311,609
444,1379,1227,152,304,341,85,62,235,352,47,2457,1426
445,873,599,274,159,111,70,52,133,348,4,2249,877
446,1055,724,331,192,134,84,63,161,421,7,2392,1062
447,645,443,202,117,82,51,38,99,258,0,1508,645
448,11,8,3,2,2,1,1,3,2,14,16,25
449,562,366,196,76,116,75,71,108,116,1,2044,563
450,0,0,0,0,0,0,0,0,0,0,0,0
451,39,30,9,5,8,4,3,10,9,11,86,50
452,2198,1875,323,325,206,166,122,317,1062,58,4567,2256
453,289,250,39,35,28,42,29,64,91,62,806,351
454,100,86,14,12,10,15,10,22,31,5,225,105
455,0,0,0,0,0,0,0,0,0,2,0,2
456,7,6,1,1,1,1,1,2,1,15,19,22
457,418,365,53,52,30,43,32,75,186,90,795,508
458,891,760,131,132,83,67,49,129,431,15,1690,906
459,7,6,1,1,1,1,0,1,3,178,10,185
460,106,90,16,16,20,14,12,24,20,0,278,106
461,388,329,59,59,74,50,42,88,75,0,1074,388
462,1,1,0,0,0,0,0,0,1,0,4,1
463,0,0,0,0,0,0,0,0,0,28,0,28
464,0,0,0,0,0,0,0,0,0,2,0,2
465,213,185,28,12,9,13,15,29,135,0,314,213
466,0,0,0,0,0,0,0,0,0,0,0,0
467,42,32,10,6,9,5,3,11,8,0,53,42
468,0,0,0,0,0,0,0,0,0,20,0,20
469,0,0,0,0,0,0,0,0,0,2,0,2
470,36,28,8,5,7,4,2,9,9,2,74,38
471,8,6,2,1,2,1,1,2,1,5,14,13
472,0,0,0,0,0,0,0,0,0,0,0,0
473,0,0,0,0,0,0,0,0,0,0,0,0
474,559,245,314,186,192,61,31,35,54,0,1745,559
475,991,434,557,330,340,107,55,62,97,5,2798,996
476,127,51,76,56,41,16,7,3,4,2,457,129
477,41,25,16,8,11,5,5,4,8,0,145,41
478,491,301,190,95,133,61,54,53,95,0,1724,491
479,94,43,51,26,29,7,8,10,14,0,294,94
480,249,115,134,69,77,19,21,27,36,0,920,249
481,55,31,24,12,13,6,6,9,9,1,187,56
482,67,42,25,6,10,11,10,14,16,0,280,67
483,37,24,13,4,5,5,4,9,10,0,88,37
484,203,131,72,24,26,30,20,47,56,6,696,209
485,301,231,70,38,57,39,30,65,72,6,1127,307
486,305,234,71,39,58,39,31,66,72,0,1007,305
487,247,174,73,29,31,28,26,50,83,0,841,247
488,705,507,198,56,82,71,74,90,332,0,1792,705
489,676,486,190,54,79,68,71,86,318,0,1736,676
490,307,262,45,45,29,23,17,44,149,559,639,866
491,613,394,219,40,57,52,51,96,317,0,1665,613
492,594,476,118,127,165,86,67,65,84,0,1565,594
493,706,513,193,35,49,54,82,129,357,32,1880,738
494,244,177,67,12,17,19,28,44,124,4,721,248
495,299,217,82,15,21,23,35,54,151,0,966,299
496,290,211,79,14,20,22,34,53,147,7,867,297
497,391,272,119,14,22,29,37,68,221,1,1275,392
498,275,191,84,10,16,20,26,48,155,0,764,275
499,284,197,87,11,16,21,27,50,159,0,828,284
500,342,238,104,13,19,25,32,60,193,0,1007,342
501,487,338,149,18,27,36,46,85,275,7,1411,494
502,227,158,69,8,13,17,21,40,128,0,674,227
503,316,220,96,12,18,23,30,55,178,5,951,321
504,292,230,62,27,38,36,33,55,103,2,860,294
505,537,423,114,49,70,66,62,101,189,0,1383,537
506,311,245,66,29,41,38,36,59,108,5,944,316
507,464,365,99,43,61,57,53,88,162,0,1382,464
508,302,238,64,28,40,37,35,57,105,0,898,302
509,290,228,62,27,38,36,33,55,101,0,878,290
510,288,227,61,26,38,35,33,54,102,0,862,288
511,445,328,117,41,53,74,63,73,141,0,1338,445
512,438,322,116,41,52,73,62,72,138,0,1349,438
513,480,353,127,45,57,80,68,79,151,9,1374,489
514,397,292,105,37,47,66,56,66,125,0,1201,397
515,568,418,150,53,67,95,80,94,179,20,1696,588
516,440,324,116,41,52,73,62,73,139,3,1342,443
517,531,379,152,57,74,56,56,84,204,3,1522,534
518,289,206,83,31,40,31,30,46,111,0,750,289
519,372,265,107,40,52,39,39,59,143,0,1044,372
520,222,158,64,24,31,24,23,35,85,0,632,222
521,726,588,138,107,95,136,99,139,150,0,1870,726
522,603,489,114,89,79,113,82,116,124,27,1553,630
523,507,375,132,44,56,65,45,109,188,0,1454,507
524,499,369,130,43,55,64,44,107,186,3,1511,502
525,403,298,105,35,44,52,36,87,149,0,1219,403
526,282,209,73,25,31,36,25,61,104,3,965,285
527,341,252,89,30,37,44,30,73,127,0,1105,341
528,334,247,87,29,37,43,30,72,123,0,1067,334
529,485,359,126,42,53,63,43,104,180,0,1687,485
530,550,446,104,81,72,103,75,106,113,0,1430,550
531,377,272,105,43,50,62,42,87,93,0,1217,377
532,341,246,95,39,45,56,38,79,84,0,1148,341
533,384,277,107,43,51,63,43,89,95,0,1221,384
534,346,250,96,39,46,57,39,80,85,0,1151,346
535,517,371,146,73,85,75,69,111,104,0,1539,517
536,364,261,103,51,60,53,49,78,73,13,1027,377
537,547,392,155,77,90,79,73,118,110,0,1541,547
538,372,267,105,52,61,54,50,80,75,3,1081,375
539,486,348,138,69,80,70,65,105,97,0,1335,486
540,339,243,96,48,56,49,45,73,68,0,958,339
541,452,366,86,64,69,55,47,78,139,0,1167,452
542,477,386,91,68,73,58,50,82,146,0,1332,477
543,504,408,96,72,77,61,52,87,155,0,1520,504
544,443,359,84,63,68,54,46,76,136,4,1215,447
545,902,732,170,61,93,182,135,208,223,0,1967,902
546,472,383,89,32,48,95,70,109,118,3,1112,475
547,737,578,159,63,76,79,73,110,336,0,1812,737
548,534,434,100,36,55,108,80,123,132,0,1365,534
549,711,629,82,67,69,82,74,159,260,0,1474,711
550,770,681,89,73,75,89,80,172,281,15,1519,785
551,453,355,98,39,47,48,45,68,206,0,1198,453
552,559,400,159,174,237,44,50,33,21,1,1502,560
553,690,541,149,59,71,74,68,103,315,11,1652,701
554,504,373,131,30,44,48,54,119,209,0,1432,504
555,461,362,99,39,48,49,46,69,210,0,1130,461
556,494,365,129,30,43,47,53,116,205,0,1418,494
557,274,195,79,20,25,22,24,40,143,0,817,274
558,524,374,150,38,47,42,47,77,273,0,1468,524
559,442,315,127,32,40,35,39,65,231,0,1217,442
560,332,237,95,24,30,27,30,49,172,0,903,332
561,306,196,110,20,28,26,25,48,159,6,857,312
562,609,443,166,30,42,47,71,111,308,4,1865,613
563,634,561,73,60,62,73,66,142,231,10,1327,644
564,490,362,128,29,43,47,52,115,204,0,1253,490
565,409,303,106,57,72,61,49,85,85,9,1304,418
566,605,448,157,84,106,91,72,125,127,6,1862,611
567,520,385,135,72,91,78,62,108,109,0,1635,520
568,524,388,136,73,92,79,63,109,108,0,1736,524
569,512,379,133,71,90,77,61,106,107,0,1728,512
570,465,344,121,65,82,70,56,96,96,0,1513,465
571,690,546,144,74,76,120,88,130,202,4,1851,694
572,598,473,125,64,66,104,77,112,175,0,1687,598
573,596,472,124,64,66,103,76,112,175,4,1704,600
574,773,612,161,82,85,134,99,145,228,13,2238,786
575,519,411,108,55,57,90,66,98,153,0,1450,519
576,432,342,90,46,48,75,55,81,127,5,1288,437
577,507,388,119,50,64,69,64,105,155,0,1503,507
578,556,425,131,55,70,76,70,115,170,1,1538,557
579,440,337,103,43,55,60,55,91,136,0,1250,440
580,521,399,122,51,66,71,66,107,160,0,1377,521
581,531,406,125,52,67,72,67,110,163,0,1535,531
582,450,344,106,44,57,61,57,93,138,0,1394,450
583,399,295,104,45,48,62,48,63,133,0,1337,399
584,438,323,115,50,53,68,53,70,144,0,1394,438
585,445,329,116,51,53,69,53,71,148,0,1471,445
586,563,416,147,64,68,87,68,89,187,7,1757,570
587,403,298,105,46,48,62,48,64,135,0,1319,403
588,450,332,118,51,54,70,54,71,150,7,1504,457
589,472,349,123,54,57,73,57,75,156,0,1473,472
590,624,500,124,134,173,90,70,69,88,0,1642,624
591,408,327,81,88,113,59,46,45,57,0,1103,408
592,757,606,151,162,210,109,85,83,108,0,2047,757
593,409,328,81,88,113,59,46,45,58,0,1085,409
594,516,373,143,58,69,85,58,120,126,0,1450,516
595,650,526,124,92,100,79,67,112,200,0,1833,650
596,322,306,16,82,81,48,31,45,35,2,529,324
597,0,0,0,0,0,0,0,0,0,0,0,0
598,296,219,77,41,52,44,35,61,63,0,1045,296
599,330,264,66,71,92,48,37,36,46,0,817,330
600,58,42,16,18,25,5,5,3,2,1834,164,1892
601,119,87,32,6,8,9,14,22,60,0,319,119
602,428,305,123,31,38,34,38,63,224,0,1222,428
603,282,236,46,40,23,21,19,42,137,0,355,282
604,43,36,7,6,4,3,3,6,21,0,165,43
605,823,689,134,117,68,61,56,123,398,0,1794,823
606,20,17,3,3,2,1,1,3,10,0,78,20
607,368,346,22,82,56,101,53,38,38,42,530,410
608,76,71,5,17,12,21,11,8,7,15,146,91
609,53,50,3,12,8,15,8,5,5,8,56,61
610,425,425,0,35,7,0,26,108,249,35,332,460
611,0,0,0,0,0,0,0,0,0,11,0,11
612,101,101,0,8,2,0,6,26,59,0,77,101
613,0,0,0,0,0,0,0,0,0,0,0,0
614,10,10,0,1,0,0,0,3,6,1,13,11
615,188,188,0,15,4,0,10,50,109,11,259,199
616,1136,746,390,130,279,254,188,178,107,0,3357,1136
617,510,394,116,66,106,68,68,73,129,0,1448,510
618,1534,1034,500,88,149,162,166,378,591,116,5383,1650
619,1640,1057,583,122,226,191,213,380,508,0,5179,1640
620,2579,1675,904,185,307,357,312,431,987,7,7357,2586
621,12,9,3,1,2,0,2,2,5,0,40,12
622,3055,2415,640,284,467,439,408,569,888,8,7370,3063
623,1229,876,353,81,126,200,179,307,336,0,3809,1229
624,1287,941,346,117,153,241,188,301,287,18,4414,1305
625,2006,1279,727,163,220,282,260,438,643,9,6972,2015
626,1393,959,434,94,145,266,183,347,358,15,5836,1408
627,309,223,86,32,44,39,42,80,72,0,1047,309
628,1957,1339,618,145,205,236,241,522,608,3,7020,1960
629,624,318,306,93,115,120,121,91,84,16,2128,640
630,3160,2344,816,227,295,429,465,853,891,5,9863,3165
631,1620,1105,515,125,208,194,195,393,505,23,5101,1643
632,1548,1111,437,120,194,261,229,348,396,6,3592,1554
633,1848,1376,472,208,337,287,199,300,517,36,4272,1884
634,1213,809,404,77,141,149,120,300,426,0,3389,1213
635,1399,947,452,86,159,193,182,329,450,0,3709,1399
636,1901,1246,655,168,259,248,200,347,679,0,5271,1901
637,1812,1177,635,88,146,203,244,483,648,26,5836,1838
638,1658,1207,451,137,196,285,266,327,447,220,5137,1878
639,333,227,106,30,49,33,27,48,146,0,968,333
640,974,610,364,69,85,134,82,164,440,0,2994,974
641,648,474,174,45,63,73,63,111,293,16,1726,664
642,535,379,156,43,63,66,55,85,223,2,1318,537
643,308,187,121,21,37,26,21,41,162,7,929,315
644,1970,1298,672,131,227,333,311,466,502,24,6809,1994
645,0,0,0,0,0,0,0,0,0,1,0,1
646,1061,675,386,147,212,151,175,266,110,74,3380,1135
647,533,297,236,58,95,92,84,97,107,0,2066,533
648,369,258,111,23,37,47,53,91,118,0,1030,369
649,420,271,149,38,53,55,51,70,153,0,1187,420
650,286,184,102,26,36,38,35,48,103,1,817,287
651,423,273,150,38,53,56,52,70,154,0,1276,423
652,1426,1266,160,191,219,243,181,211,381,0,2082,1426
653,555,371,184,39,70,52,84,120,190,81,1762,636
654,634,353,281,69,113,109,100,116,127,0,2258,634
655,722,460,262,100,144,103,119,181,75,8,2378,730
656,614,455,159,65,95,104,93,139,118,1,1783,615
657,711,453,258,99,142,101,117,178,74,8,2349,719
658,1001,607,394,67,121,83,67,132,531,56,3042,1057
659,328,219,109,23,41,30,49,71,114,39,1071,367
660,431,288,143,31,54,40,65,93,148,0,1404,431
661,1532,1036,496,129,180,215,247,337,424,22,4842,1554
662,419,274,145,55,85,82,75,59,63,0,1273,419
663,269,176,93,35,55,52,48,38,41,0,977,269
664,2120,1517,603,178,288,297,300,356,701,19,5427,2139
665,282,201,81,22,34,41,34,50,101,0,877,282
666,811,609,202,94,130,108,107,202,170,33,2552,844
667,722,512,210,59,85,90,74,114,300,27,2056,749
668,307,186,121,21,37,26,21,41,161,0,894,307
669,244,160,84,32,50,48,44,34,36,29,934,273
670,1775,903,872,266,326,342,345,259,237,87,6260,1862
671,899,694,205,116,188,120,120,130,225,20,2376,919
672,788,477,311,53,96,66,53,104,416,9,1908,797
673,410,248,162,28,50,34,27,54,217,0,1191,410
674,1064,757,307,84,127,156,129,190,378,0,2291,1064
675,224,120,104,13,20,22,18,22,129,0,678,224
676,355,190,165,20,32,35,28,35,205,0,1028,355
677,343,184,159,20,31,34,27,34,197,14,994,357
678,641,421,220,73,157,143,106,100,62,0,1907,641
679,651,476,175,59,77,122,95,152,146,0,2537,651
680,381,318,63,33,51,59,60,92,86,6,1125,387
681,295,246,49,26,39,46,46,71,67,0,928,295
682,314,168,146,18,29,31,25,31,180,0,949,314
683,496,360,136,88,80,63,100,93,72,0,1757,496
684,689,500,189,122,110,87,139,128,103,0,2596,689
685,372,272,100,34,44,70,54,87,83,0,1447,372
686,752,502,250,106,145,94,81,171,155,0,2785,752
687,761,508,253,107,146,95,82,173,158,0,2855,761
688,540,349,191,64,98,107,73,104,94,10,1971,550
689,423,273,150,50,77,84,57,81,74,2,1488,425
690,780,504,276,92,142,154,105,150,137,105,2744,885
691,394,254,140,47,72,78,53,76,68,7,1440,401
692,1759,1218,541,370,469,311,242,263,104,5,4720,1764
693,711,529,182,73,106,76,75,131,250,0,2008,711
694,1566,796,770,224,456,229,209,291,157,9,5375,1575
695,857,586,271,78,131,165,159,161,163,0,2665,857
696,323,221,102,29,49,62,60,60,63,4,986,327
697,849,708,141,74,113,131,133,205,193,0,1986,849
698,849,581,268,77,130,164,157,159,162,9,2545,858
699,798,616,182,103,167,107,106,115,200,9,2226,807
700,835,627,208,97,133,112,110,208,175,0,2378,835
701,725,545,180,84,116,97,95,181,152,19,2271,744
702,437,309,128,41,55,100,75,87,79,0,1438,437
703,944,667,277,89,119,217,161,187,171,6,3108,950
704,820,579,241,78,104,188,140,163,147,22,2916,842
705,1032,874,158,78,137,195,163,294,165,0,2504,1032
706,1077,778,299,110,154,136,147,280,250,10,3188,1087
707,807,563,244,49,81,103,115,198,261,5,2235,812
708,605,449,156,64,93,103,92,137,116,0,1535,605
709,583,432,151,62,90,99,89,132,111,0,1400,583
710,772,526,246,70,113,77,63,111,338,7,2068,779
711,233,159,74,21,34,23,19,33,103,11,688,244
712,347,254,93,24,34,39,34,59,157,0,986,347
713,507,346,161,36,43,59,58,122,189,14,1968,521
714,427,292,135,31,36,50,49,103,158,5,1721,432
715,829,566,263,59,70,96,94,200,310,0,3173,829
716,647,481,166,67,97,69,68,120,226,0,1823,647
717,425,307,118,39,57,63,44,61,161,0,1149,425
718,901,650,251,82,120,133,92,129,345,0,2366,901
719,545,393,152,50,73,81,56,78,207,5,1412,550
720,168,117,51,19,28,30,25,41,25,0,489,168
721,389,292,97,45,62,52,51,97,82,73,1216,462
722,472,240,232,67,138,69,63,88,47,14,1534,486
723,483,245,238,69,141,71,64,90,48,0,1648,483
724,0,0,0,0,0,0,0,0,0,0,0,0
725,0,0,0,0,0,0,0,0,0,81,0,81
726,402,274,128,29,34,47,46,97,149,0,1344,402
727,570,396,174,63,96,103,84,140,84,0,2098,570
728,1161,704,457,71,148,142,156,230,414,48,4051,1209
729,948,575,373,58,121,116,127,188,338,35,3240,983
730,885,598,287,74,104,124,143,195,245,0,3253,885
731,424,327,97,55,88,57,57,61,106,20,1256,444
732,330,230,100,20,33,42,47,81,107,11,892,341
733,616,430,186,38,62,79,88,151,198,10,1683,626
734,2,1,1,0,0,0,0,0,2,0,12,2
735,0,0,0,0,0,0,0,0,0,0,0,0
736,184,163,21,25,28,31,23,27,50,0,784,184
737,1112,678,434,133,198,139,170,234,238,10,3856,1122
738,355,243,112,15,22,34,37,82,165,0,936,355
739,1246,859,387,72,110,100,104,254,606,8,3305,1254
740,1579,1074,505,117,139,167,169,255,732,0,3903,1579
741,248,139,109,19,27,26,22,26,128,0,721,248
742,747,416,331,71,93,117,130,186,150,97,2512,844
743,382,219,163,31,41,81,32,69,128,27,1232,409
744,1450,1220,230,132,163,180,151,352,472,0,2608,1450
745,1318,902,416,128,128,117,123,274,548,0,3114,1318
746,1411,858,553,84,107,119,115,237,749,0,3703,1411
747,3531,2396,1135,365,409,312,294,662,1489,0,8765,3531
748,624,378,246,45,57,66,56,98,302,2,1856,626
749,1403,920,483,69,87,82,83,281,801,39,3975,1442
750,1996,1285,711,89,136,128,150,257,1236,0,5847,1996
751,2948,2006,942,301,465,318,366,482,1016,0,6804,2948
752,400,191,209,18,31,19,19,52,261,0,1262,400
753,1331,785,546,43,74,55,56,177,926,0,4140,1331
754,627,370,257,30,44,36,28,61,428,3,1783,630
755,893,546,347,38,53,62,81,160,499,11,2398,904
756,424,240,184,19,36,88,38,102,141,42,1426,466
757,1501,1011,490,72,110,140,143,313,723,6,3843,1507
758,1411,918,493,80,148,217,162,260,544,0,3793,1411
759,1666,1080,586,84,125,127,106,360,864,13,4584,1679
760,2285,1424,861,77,161,274,211,476,1086,16,6713,2301
761,1574,878,696,105,188,210,160,453,458,26,4790,1600
762,2283,1261,1022,156,220,366,238,299,1004,14,6681,2297
763,3589,2515,1074,439,522,405,331,448,1444,78,9075,3667
764,1800,1158,642,159,261,240,260,300,580,11,4644,1811
765,386,233,153,14,16,34,28,42,252,0,996,386
766,318,192,126,12,13,28,23,34,208,0,909,318
767,271,164,107,10,11,24,19,29,178,0,797,271
768,1088,844,244,122,169,174,165,196,262,160,2213,1248
769,769,597,172,86,120,123,117,138,185,16,1850,785
770,355,246,109,34,43,38,29,64,147,39,971,394
771,867,553,314,57,102,79,92,141,396,8,1899,875
772,677,432,245,44,79,62,72,110,310,24,1884,701
773,658,420,238,43,77,60,70,107,301,0,1796,658
774,608,472,136,68,94,97,92,110,147,5,1215,613
775,831,543,288,115,162,165,110,114,165,0,2463,831
776,608,357,251,61,101,119,123,74,130,9,2093,617
777,427,251,176,43,71,84,86,52,91,0,1464,427
778,318,187,131,32,53,62,64,39,68,6,1251,324
779,480,266,214,57,95,95,106,62,65,0,1343,480
780,763,423,340,91,151,151,168,98,104,112,2842,875
781,705,391,314,84,140,140,155,90,96,30,2564,735
782,382,244,138,25,45,35,41,62,174,393,1075,775
783,495,275,220,59,98,98,109,64,67,0,1619,495
784,417,305,112,62,65,69,47,66,108,81,727,498
785,437,319,118,65,68,72,49,69,114,7,904,444
786,470,293,177,48,66,48,33,73,202,0,1135,470
787,962,703,259,143,150,159,108,153,249,0,2674,962
788,378,212,166,28,41,40,33,40,196,0,1050,378
789,433,242,191,32,47,46,38,46,224,0,1285,433
790,524,354,170,51,81,52,61,89,190,0,1360,524
791,547,370,177,53,84,55,63,93,199,0,1337,547
792,315,151,164,14,24,15,15,41,206,0,973,315
793,1376,900,476,190,268,273,182,188,275,11,2941,1387
794,1304,651,653,139,166,142,131,274,452,44,3704,1348
795,1345,951,394,172,184,209,132,312,336,55,3330,1400
796,514,364,150,66,70,80,50,119,129,0,1189,514
797,726,489,237,50,67,78,83,113,335,16,1971,742
798,569,394,175,55,68,62,46,103,235,31,1343,600
799,603,418,185,58,72,65,48,109,251,1,1380,604
800,276,191,85,26,33,30,22,50,115,7,787,283
801,673,473,200,57,83,125,83,116,209,0,1524,673
802,445,313,132,37,55,83,55,77,138,5,1098,450
803,605,425,180,51,74,113,74,105,188,0,1532,605
804,360,253,107,30,44,67,44,62,113,0,927,360
805,369,259,110,31,45,69,45,64,115,0,951,369
806,617,415,202,43,57,67,71,96,283,35,1683,652
807,507,356,151,80,97,48,37,79,166,31,1352,538
808,1071,752,319,169,204,100,78,167,353,51,2428,1122
809,292,205,87,46,56,27,21,46,96,20,793,312
810,1730,1035,695,145,172,232,194,430,557,11,4520,1741
811,1374,1094,280,103,197,219,169,273,413,1,2431,1375
812,984,784,200,74,141,157,121,196,295,10,2158,994
813,319,254,65,24,46,51,39,63,96,0,913,319
814,653,375,278,54,69,139,55,118,218,62,2172,715
815,418,233,185,40,52,66,73,104,83,15,1418,433
816,396,224,172,17,34,82,35,95,133,55,1392,451
817,985,690,295,79,91,162,111,222,320,0,2940,985
818,1398,979,419,113,129,230,157,316,453,0,3599,1398
819,529,307,222,27,53,81,45,97,226,17,1417,546
820,522,303,219,27,52,80,45,96,222,21,1595,543
821,324,188,136,17,32,50,28,59,138,29,945,353
822,370,215,155,19,37,57,32,68,157,0,1142,370
823,1124,874,250,71,117,160,128,286,362,0,2631,1124
824,330,158,172,15,25,16,15,43,216,0,1052,330
825,421,248,173,14,23,17,18,56,293,0,1251,421
826,915,691,224,97,131,91,103,148,345,0,1523,915
827,880,421,459,39,67,42,41,114,577,0,2734,880
828,692,474,218,29,42,65,73,159,324,0,1703,692
829,585,442,143,62,84,58,66,95,220,0,1076,585
830,392,296,96,41,56,39,44,64,148,4,1059,396
831,626,473,153,66,89,62,71,102,236,44,1342,670
832,247,146,101,12,17,14,11,24,169,0,722,247
833,386,228,158,18,27,22,17,38,264,0,1028,386
834,446,278,168,45,62,45,31,69,194,15,1191,461
835,492,307,185,50,69,50,34,76,213,0,1309,492
836,166,117,49,16,21,20,22,24,63,0,485,166
837,1964,1304,660,71,132,134,176,386,1065,125,4919,2089
838,1614,1062,552,97,73,129,98,245,972,30,4593,1644
839,766,532,234,43,74,84,93,128,344,0,1970,766
840,1775,1033,742,236,371,392,274,364,138,18,6058,1793
841,1464,849,615,207,406,250,154,277,170,102,5503,1566
842,1014,547,467,49,89,103,112,148,513,0,3038,1014
843,725,457,268,51,85,65,67,94,363,0,1964,725
844,1769,1203,566,113,204,189,211,317,735,26,4870,1795
845,3412,2118,1294,141,256,287,312,417,1999,0,8687,3412
846,429,247,182,66,127,57,42,74,63,0,1696,429
847,1829,1141,688,168,434,320,356,209,342,0,5343,1829
848,958,627,331,69,78,102,100,127,482,31,2584,989
849,805,435,370,44,53,83,51,84,490,74,2302,879
850,855,418,437,101,192,186,96,159,121,87,4143,942
851,1587,704,883,191,354,319,241,315,167,18,7321,1605
852,1448,991,457,201,317,135,111,264,420,153,3757,1601
853,666,361,305,37,32,84,41,94,378,0,1998,666
854,1036,516,520,29,35,100,70,121,681,8,3410,1044
855,1823,1137,686,178,175,152,80,206,1032,6,4739,1829
856,1308,824,484,165,138,146,103,182,574,7,3432,1315
857,2608,1675,933,184,182,170,157,250,1665,18,6890,2626
858,957,622,335,68,53,66,50,70,650,0,2860,957
859,1170,806,364,87,60,64,51,178,730,0,3227,1170
860,2117,1586,531,184,313,312,355,354,599,41,5506,2158
861,2098,1429,669,139,209,294,347,381,728,28,5766,2126
862,2440,1550,890,134,233,193,219,334,1327,47,6678,2487
863,1963,1373,590,195,150,246,176,340,856,13,5286,1976
864,735,482,253,61,50,30,34,75,485,0,2142,735
865,1415,820,595,228,371,217,178,247,174,1,5509,1416
866,2684,1660,1024,372,581,408,314,471,538,63,10247,2747
867,2751,1610,1141,484,746,463,391,345,322,29,8648,2780
868,650,445,205,80,70,57,43,110,290,47,1380,697
869,207,136,71,17,14,8,10,21,137,450,587,657
870,460,301,159,38,31,19,21,47,304,0,1236,460
871,311,201,110,28,46,33,39,53,112,0,915,311
872,453,295,158,26,36,36,33,58,264,0,1341,453
873,237,148,89,10,9,11,9,18,180,0,711,237
874,313,195,118,13,13,14,12,24,237,0,932,313
875,361,225,136,15,14,16,14,27,275,0,1027,361
876,1178,605,573,62,131,78,107,143,657,30,3404,1208
877,1059,600,459,37,79,73,85,108,677,0,3009,1059
878,813,461,352,29,61,56,65,83,519,2,2324,815
879,329,191,138,18,19,26,21,37,208,0,853,329
880,494,349,145,46,62,60,66,70,190,0,1397,494
881,972,686,286,91,122,119,129,139,372,11,2363,983
882,903,638,265,85,114,110,120,129,345,10,2250,913
883,412,223,189,23,19,52,25,58,235,0,1267,412
884,274,207,67,27,33,27,12,29,146,165,710,439
885,599,452,147,59,72,59,26,64,319,0,1566,599
886,804,558,246,45,77,88,97,134,363,0,1574,804
887,316,219,97,18,30,35,38,53,142,19,827,335
888,796,545,251,98,86,70,52,135,355,1,1958,797
889,443,257,186,25,26,35,29,50,278,2,1266,445
890,528,398,130,45,39,89,53,68,234,0,1426,528
891,497,375,122,42,37,84,50,64,220,0,963,497
892,406,306,100,34,30,68,41,52,181,1,850,407
893,623,331,292,78,206,73,106,86,74,17,2258,640
894,462,245,217,58,153,54,79,64,54,0,1676,462
895,1474,1182,292,224,429,136,193,132,360,8,3246,1482
896,1189,750,439,139,186,94,104,136,530,0,3977,1189
897,510,294,216,78,151,68,50,89,74,0,2247,510
898,790,558,232,74,99,96,105,113,303,21,1408,811
899,356,189,167,45,118,42,61,49,41,0,1169,356
900,782,541,241,115,171,124,125,86,161,93,2234,875
901,212,147,65,31,46,34,34,23,44,0,487,212
902,317,205,112,29,47,34,40,54,113,9,848,326
903,1135,691,444,34,91,73,78,129,730,0,3038,1135
904,667,434,233,39,52,53,49,86,388,9,1921,676
905,512,389,123,51,85,59,71,72,174,23,1400,535
906,1040,789,251,103,173,120,144,147,353,8,2231,1048
907,539,409,130,54,90,62,75,76,182,6,1310,545
908,883,558,325,85,159,141,147,177,174,0,2362,883
909,664,382,282,102,197,89,65,115,96,270,1999,934
910,661,349,312,67,199,132,129,69,65,5,2223,666
911,766,534,232,87,224,112,122,88,133,0,1906,766
912,340,233,107,42,37,30,22,58,151,0,893,340
913,642,484,158,54,48,108,64,83,285,0,1379,642
914,543,287,256,55,163,108,106,57,54,126,2190,669
915,330,230,100,38,96,48,53,38,57,0,796,330
916,828,577,251,95,242,121,132,95,143,29,2329,857
917,792,552,240,90,232,116,126,91,137,30,2273,822
918,1181,805,376,107,156,91,101,191,535,0,3227,1181
919,356,243,113,32,47,28,30,57,162,0,821,356
920,708,402,306,53,72,33,53,121,376,0,1890,708
921,1937,1256,681,243,329,109,114,169,973,23,4958,1960
922,2020,1107,913,68,118,161,139,295,1239,10,6397,2030
923,1521,752,769,64,89,71,62,131,1104,2,4804,1523
924,1664,1013,651,119,130,119,125,210,961,0,4310,1664
925,558,327,231,32,44,27,28,44,383,0,1661,558
926,2068,1344,724,184,245,178,183,340,938,0,5886,2068
927,470,276,194,66,69,32,31,78,194,0,1186,470
928,961,475,486,67,74,48,42,74,656,0,2936,961
929,0,0,0,0,0,0,0,0,0,2966,0,2966
930,1555,956,599,71,90,82,79,174,1059,11,4489,1566
931,522,418,104,66,107,71,59,82,137,20,1138,542
932,588,368,220,36,51,62,53,77,309,19,1661,607
933,1432,795,637,62,80,174,82,125,909,11,4162,1443
934,1024,609,415,68,76,86,79,153,562,0,2911,1024
935,894,551,343,54,60,61,64,144,511,0,2419,894
936,1536,1005,531,125,148,86,105,182,890,8,4276,1544
937,1191,701,490,46,77,92,77,154,745,0,3277,1191
938,893,484,409,34,37,63,52,93,614,0,2621,893
939,0,0,0,0,0,0,0,0,0,0,0,0
940,899,566,333,20,22,26,36,75,720,351,2580,1250
941,2903,2018,885,132,183,229,191,336,1832,124,7372,3027
942,1224,786,438,85,152,141,107,182,557,10,3376,1234
943,881,632,249,72,122,88,91,149,359,0,2078,881
944,983,717,266,87,174,129,121,192,280,0,2140,983
945,1272,1026,246,64,118,105,116,216,653,23,2865,1295
946,783,612,171,48,75,75,72,146,367,0,1633,783
947,787,566,221,70,117,122,89,122,267,0,1595,787
948,1187,732,455,120,185,82,105,231,464,17,2739,1204
949,681,490,191,61,101,106,77,106,230,0,1711,681
950,506,312,194,51,79,35,45,99,197,0,1720,506
951,366,263,103,33,54,57,41,57,124,0,710,366
952,2004,1600,404,308,355,193,159,241,748,68,3718,2072
953,0,0,0,0,0,0,0,0,0,0,0,0
954,0,0,0,0,0,0,0,0,0,0,0,0
955,927,744,183,104,129,143,108,138,305,20,1302,947
956,1440,843,597,53,75,102,79,153,978,6,4150,1446
957,1201,959,242,184,213,116,95,144,449,6,2335,1207
958,330,214,116,29,39,28,29,54,151,0,753,330
959,981,810,171,97,152,108,100,143,381,0,2121,981
960,881,587,294,342,187,104,120,75,53,1891,1983,2772
961,487,350,137,40,67,49,50,82,199,0,1369,487
962,650,385,265,51,65,77,60,88,309,0,1691,650
963,676,390,286,41,54,52,48,77,404,1,1927,677
964,719,441,278,53,81,93,72,104,316,0,1720,719
965,914,560,354,67,103,118,92,132,402,0,2439,914
966,393,241,152,29,44,51,40,57,172,11,1069,404
967,704,460,244,57,68,40,48,84,407,0,1683,704
968,729,436,293,95,115,69,100,152,198,0,1945,729
969,280,173,107,28,44,19,25,55,109,0,605,280
970,537,336,201,32,46,56,49,71,283,0,1339,537
971,754,514,240,68,100,58,64,122,342,6,1559,760
972,104,81,23,6,10,10,10,19,49,1,233,105
973,544,425,119,33,52,52,50,102,255,0,1254,544
974,576,420,156,51,102,75,71,112,165,0,1466,576
975,199,160,39,10,19,16,18,34,102,0,448,199
976,722,446,276,73,113,50,64,141,281,0,1903,722
977,740,540,200,65,131,97,91,144,212,31,1829,771
978,170,136,34,21,35,23,19,27,45,0,282,170
979,504,310,194,31,34,35,36,81,287,7,1324,511
980,491,393,98,62,100,67,55,78,129,0,1022,491
981,525,420,105,66,107,72,59,83,138,0,1050,525
982,357,274,83,30,60,30,30,59,148,0,745,357
983,362,278,84,30,61,30,30,59,152,0,990,362
984,311,268,43,29,39,24,31,64,124,0,612,311
985,752,577,175,63,126,63,63,123,314,0,1719,752
986,637,548,89,60,80,48,64,132,253,0,911,637
987,1402,839,563,183,221,133,193,293,379,0,3225,1402
988,778,669,109,73,97,59,78,161,310,0,1784,778
989,732,630,102,69,92,56,73,151,291,2,1726,734
990,369,283,86,31,62,31,31,61,153,18,1158,387
991,0,0,0,0,0,0,0,0,0,0,0,0
992,819,482,337,32,53,63,53,106,512,5,2029,824
993,515,425,90,51,80,56,52,75,201,0,1359,515
994,377,228,149,26,24,40,24,27,236,0,989,377
995,436,264,172,30,28,46,27,31,274,0,1200,436
996,229,138,91,16,15,24,14,16,144,0,598,229
997,220,133,87,15,14,23,14,16,138,0,585,220
998,609,486,123,94,108,59,48,73,227,22,1758,631
999,376,232,144,23,25,26,27,61,214,0,1024,376
1000,0,0,0,0,0,0,0,0,0,0,0,0
1001,707,583,124,70,110,78,72,103,274,0,1294,707
1002,352,206,146,13,18,25,19,37,240,0,1097,352
1003,420,208,212,29,32,21,18,32,288,0,1303,420
1004,388,192,196,27,30,19,17,30,265,14,1242,402
1005,603,353,250,34,47,30,31,47,414,0,1605,603
1006,614,364,250,48,62,73,57,83,291,0,1734,614
1007,758,449,309,60,76,90,70,103,359,81,2008,839
1008,528,311,217,75,77,36,34,88,218,0,1267,528
1009,445,262,183,17,29,34,29,58,278,0,1249,445
1010,287,179,108,18,22,20,21,23,183,4,762,291
1011,902,724,178,101,125,139,105,134,298,0,2170,902
1012,0,0,0,0,0,0,0,0,0,0,0,0
1013,2710,1489,1221,169,244,239,269,446,1343,14,8043,2724
1014,1421,877,544,69,94,145,158,179,776,0,4094,1421
1015,1990,1060,930,111,158,171,201,266,1083,2,5811,1992
1016,1325,727,598,96,127,78,119,226,679,0,3798,1325
1017,930,601,329,49,82,69,92,92,546,5,2531,935
1018,168,97,71,12,15,17,18,24,82,0,527,168
1019,1301,754,547,92,118,130,137,183,641,0,3712,1301
1020,3351,2214,1137,367,412,317,387,801,1067,10,8805,3361
1021,3197,2359,838,268,424,397,313,569,1226,4,7106,3201
1022,367,287,80,45,72,75,55,54,66,0,905,367
1023,2558,1951,607,245,322,278,291,352,1070,0,6086,2558
1024,777,456,321,39,82,98,137,106,315,26,3064,803
1025,1403,889,514,156,234,185,132,221,475,6,3999,1409
1026,788,510,278,57,86,102,74,149,320,1,2463,789
1027,2575,1802,773,215,288,289,278,721,784,0,6566,2575
1028,2545,1725,820,197,346,444,270,558,730,6,6910,2551
1029,1438,822,616,156,274,240,258,165,345,0,4290,1438
1030,1089,713,376,89,113,128,142,182,435,20,2698,1109
1031,1942,1254,688,148,207,218,269,415,685,0,5096,1942
1032,3047,1877,1170,317,447,431,415,471,966,34,8396,3081
1033,2474,1358,1116,226,259,157,178,220,1434,13,7010,2487
1034,1069,650,419,45,62,123,94,128,617,12,3049,1081
1035,1982,1130,852,144,175,208,242,422,791,5,5667,1987
1036,824,572,252,47,63,80,93,132,409,0,1726,824
1037,612,450,162,58,69,59,64,105,257,0,1364,612
1038,1707,1055,652,158,307,223,250,304,465,0,5312,1707
1039,2,0,2,0,1,1,1,0,-1,0,13,2
1040,854,589,265,147,195,147,71,120,174,0,1985,854
1041,1780,1454,326,349,243,329,219,314,326,9,3564,1789
1042,456,334,122,29,55,61,57,98,156,0,1085,456
1043,0,0,0,0,0,0,0,0,0,0,0,0
1044,100,79,21,6,5,5,7,22,55,0,215,100
1045,0,0,0,0,0,0,0,0,0,0,0,0
1046,4190,3306,884,270,210,217,299,911,2283,22,8833,4212
1047,620,443,177,65,62,66,56,146,225,0,2277,620
1048,192,122,70,13,22,19,16,37,85,3,584,195
1049,665,410,255,52,79,69,96,160,209,9,2549,674
1050,0,0,0,0,0,0,0,0,0,0,0,0
1051,647,452,195,40,40,4,17,87,459,0,1549,647
1052,69,52,17,3,3,6,6,16,35,0,141,69
1053,8,6,2,0,1,0,2,1,4,0,18,8
1054,0,0,0,0,0,0,0,0,0,0,0,0
1055,573,443,130,74,106,100,94,129,70,0,1407,573
1056,190,22,168,14,23,44,30,40,39,0,735,190
1057,2747,2134,613,309,461,337,382,613,645,0,7170,2747
1058,962,456,506,67,117,153,113,226,286,285,3792,1247
1059,269,165,104,36,46,32,19,55,81,0,920,269
1060,2094,1352,742,331,396,298,218,487,364,0,5991,2094
1061,596,419,177,74,83,71,56,137,175,0,1527,596
1062,1109,698,411,112,136,140,127,259,335,14,3083,1123
1063,1548,1064,484,107,201,243,166,379,452,23,4272,1571
1064,1472,981,491,134,193,214,204,263,464,0,3177,1472
1065,1161,774,387,106,152,168,161,207,367,0,3502,1161
1066,204,204,0,0,204,0,0,0,0,0,276,204
1067,29,21,8,3,3,3,3,7,10,0,67,29
1068,3870,2768,1102,408,390,414,349,911,1398,0,7329,3870
1069,490,309,181,10,13,34,43,145,245,0,1167,490
1070,1293,925,368,136,130,138,116,304,469,0,5293,1293
1071,456,295,161,36,44,48,37,89,202,0,1486,456
1072,467,302,165,37,45,50,37,91,207,0,1033,467
1073,118,87,31,7,13,16,17,26,39,0,177,118
1074,466,328,138,58,65,55,44,107,137,4,1235,470
1075,707,497,210,87,99,84,66,163,208,8,2054,715
1076,328,231,97,41,46,39,31,76,95,0,987,328
1077,2044,1363,681,681,0,0,0,681,682,0,5190,2044
1078,233,181,52,11,14,19,21,52,116,0,445,233
1079,294,190,104,21,32,38,28,55,120,0,981,294
1080,592,387,205,49,61,69,77,99,237,2,1707,594
1081,1245,781,464,41,100,149,155,248,552,0,3125,1245
1082,471,288,183,62,81,56,33,97,142,0,1557,471
1083,247,151,96,33,42,29,17,51,75,0,741,247
1084,694,396,298,51,61,73,85,148,276,0,1682,694
1085,542,310,232,59,103,91,97,62,130,36,1768,578
1086,570,326,244,62,109,95,102,65,137,0,1926,570
1087,741,530,211,66,82,59,80,175,279,0,1719,741
1088,913,671,242,86,102,88,95,156,386,0,2377,913
1089,502,369,133,47,56,48,52,86,213,0,1253,502
1090,695,498,197,61,77,55,75,165,262,12,2046,707
1091,638,469,169,60,72,62,66,109,269,0,1680,638
1092,297,210,87,28,39,26,33,59,112,0,766,297
1093,401,66,335,83,80,40,40,11,147,0,1820,401
1094,824,533,291,66,80,88,66,160,364,0,2238,824
1095,4064,2554,1510,206,227,245,273,954,2159,12,10423,4076
1096,508,374,134,48,57,49,53,87,214,0,1074,508
1097,655,463,192,62,86,57,72,130,248,4,1806,659
1098,1068,754,314,101,140,92,117,213,405,0,2172,1068
1099,563,322,241,41,65,60,58,96,243,107,1732,670
1100,512,293,219,38,59,55,53,87,220,0,1460,512
1101,276,158,118,20,32,30,28,47,119,0,699,276
1102,480,333,147,27,37,47,54,77,238,0,1256,480
1103,322,215,107,29,42,47,45,57,102,0,944,322
1104,524,363,161,30,40,51,59,84,260,0,1588,524
1105,1058,730,328,182,242,183,88,148,215,9,2767,1067
1106,491,360,131,32,59,66,62,106,166,0,1249,491
1107,175,128,47,11,21,23,22,38,60,0,337,175
1108,32,21,11,4,4,3,4,8,9,0,75,32
1109,859,498,361,61,78,86,90,121,423,7,2348,866
1110,626,397,229,57,89,126,78,130,146,8,2207,634
1111,763,545,218,52,78,98,110,167,258,87,1623,850
1112,4,3,1,1,2,0,0,0,1,0,9,4
1113,1376,878,498,94,156,136,112,266,612,0,4844,1376
1114,550,337,213,73,94,65,39,113,166,6,1779,556
1115,423,282,141,39,55,61,59,76,133,0,1159,423
1116,0,0,0,0,0,0,0,0,0,0,0,0
1117,226,166,60,14,26,31,32,49,74,7,384,233
1118,131,96,35,8,15,18,19,28,43,0,370,131
1119,2376,1315,1061,153,234,219,281,472,1017,10,6491,2386
1120,1064,520,544,43,66,65,69,102,719,0,3302,1064
1121,1122,652,470,71,82,58,52,149,710,0,3278,1122
1122,1415,822,593,86,147,85,106,203,788,6,4470,1421
1123,2271,1081,1190,125,197,199,205,202,1343,8,6805,2279
1124,341,260,81,30,48,67,57,57,82,0,722,341
1125,2321,1529,792,138,177,354,363,380,909,0,6612,2321
1126,2559,1554,1005,370,530,575,479,283,322,11,6995,2570
1127,2255,1544,711,296,418,347,312,275,607,47,5811,2302
1128,1951,1456,495,164,245,221,248,426,647,4,4353,1955
1129,2559,1861,698,345,470,302,327,569,546,0,6232,2559
1130,1363,763,600,107,138,108,127,227,656,0,4016,1363
1131,2531,1435,1096,197,253,249,274,457,1101,14,7305,2545
1132,1356,752,604,87,112,102,143,270,642,0,4083,1356
1133,1931,1013,918,180,236,212,240,298,765,14,6220,1945
1134,2132,1232,900,112,212,231,268,405,904,8,5821,2140
1135,1941,1136,805,103,209,189,198,480,762,17,5651,1958
1136,1287,690,597,73,136,86,96,250,646,0,3608,1287
1137,2628,1525,1103,114,198,228,336,457,1295,0,7850,2628
1138,2965,2114,851,210,256,224,289,425,1561,85,6802,3050
1139,994,601,393,52,70,75,74,85,638,88,2836,1082
1140,1268,717,551,69,96,124,123,182,674,0,3280,1268
1141,926,577,349,66,70,55,58,61,616,0,2521,926
1142,2365,1636,729,200,218,159,214,269,1305,10,6351,2375
1143,1070,654,416,62,93,57,84,157,617,0,3155,1070
1144,1476,916,560,124,185,130,146,146,745,24,4118,1500
1145,1961,1175,786,50,93,98,117,149,1454,0,5629,1961
1146,1150,722,428,75,82,64,91,155,683,0,3148,1150
1147,2031,1300,731,112,168,139,189,256,1167,0,6043,2031
1148,2776,1566,1210,189,229,204,238,381,1535,16,8164,2792
1149,1923,870,1053,135,220,94,144,322,1008,0,6052,1923
1150,1768,947,821,98,122,124,145,262,1017,0,5308,1768
1151,1593,928,665,76,91,96,172,248,910,0,4950,1593
1152,2095,1091,1004,234,291,106,182,346,936,0,6294,2095
1153,2965,1889,1076,305,350,247,336,442,1285,14,7831,2979
1154,2954,1600,1354,198,366,286,334,645,1125,35,9328,2989
1155,1158,663,495,58,97,75,131,221,576,2,3076,1160
1156,3035,2400,635,316,453,391,266,503,1106,8,6820,3043
1157,1768,1256,512,135,199,223,207,468,536,22,4588,1790
1158,1590,1087,503,99,139,144,157,378,673,0,4038,1590
1159,2485,1612,873,198,266,215,300,466,1040,4,6957,2489
1160,2317,1307,1010,267,375,248,317,491,619,0,6536,2317
1161,2056,1398,658,161,295,316,316,491,477,0,5036,2056
1162,1041,789,252,117,176,151,124,134,339,23,2146,1064
1163,2420,1340,1080,437,667,296,376,291,353,0,7411,2420
1164,1592,984,608,192,278,166,160,227,569,0,4408,1592
1165,1595,994,601,156,223,263,219,205,529,11,4261,1606
1166,1590,980,610,166,246,187,207,206,578,0,4489,1590
1167,1347,761,586,119,165,104,159,265,535,13,3890,1360
1168,2327,1304,1023,143,267,293,259,322,1043,32,7140,2359
1169,1237,776,461,111,157,168,191,138,472,1,2747,1238
1170,1836,1274,562,112,185,178,173,201,987,0,4613,1836
1171,1915,1045,870,79,109,121,166,243,1197,6,5740,1921
1172,2079,1247,832,123,179,131,181,323,1142,1,5910,2080
1173,1591,1024,567,75,124,133,163,331,765,20,4465,1611
1174,1951,1429,522,165,263,341,254,306,622,17,4894,1968
1175,3034,2068,966,188,324,404,342,517,1259,31,7410,3065
1176,364,234,130,25,36,52,51,70,130,10,960,374
1177,1717,1249,468,132,218,234,188,308,637,31,4407,1748
1178,1598,931,667,147,215,155,154,281,646,41,4800,1639
1179,2073,1244,829,205,279,255,243,271,820,11,5809,2084
1180,1447,842,605,101,181,174,146,356,489,0,4467,1447
1181,0,0,0,0,0,0,0,0,0,0,0,0
1182,902,514,388,61,97,128,184,194,238,35,3651,937
1183,821,241,580,65,97,123,114,127,295,9,4411,830
1184,1162,754,408,80,180,179,214,184,325,47,4624,1209
1185,604,346,258,29,75,76,113,114,197,39,2801,643
1186,781,370,411,136,291,118,78,80,78,92,2426,873
1187,1902,1025,877,197,198,365,253,339,550,70,6000,1972
1188,219,112,107,43,22,22,22,31,79,73,673,292
1189,749,491,258,177,160,126,97,88,101,22,2366,771
1190,2638,1567,1071,502,531,564,345,283,413,81,7383,2719
1191,1455,1097,358,161,206,236,162,266,424,0,3095,1455
1192,1185,907,278,119,154,101,84,163,564,7,2780,1192
1193,2244,1408,836,232,339,256,238,392,787,32,6036,2276
1194,657,471,186,148,228,52,57,58,114,43,2116,700
1195,2857,1655,1202,377,510,349,263,387,971,29,7719,2886
1196,617,265,352,57,116,106,101,114,123,18,2686,635
1197,2625,1439,1186,418,933,461,365,339,109,111,9483,2736
1198,1071,860,211,147,116,177,159,166,306,3,1862,1074
1199,1935,1382,553,218,180,362,243,333,599,47,4988,1982
1200,3097,2129,968,634,690,471,337,452,513,0,7144,3097
1201,2655,1902,753,233,379,413,327,389,914,12,6397,2667
1202,599,423,176,42,58,78,68,116,237,2,1542,601
1203,2031,1264,767,167,203,121,167,301,1072,19,5505,2050
1204,2994,2454,540,250,360,491,392,527,974,24,6405,3018
1205,1056,762,294,121,116,86,84,205,444,0,2769,1056
1206,614,210,404,107,131,118,61,80,117,6,2540,620
1207,2078,1388,690,450,347,364,250,301,366,9,5549,2087
1208,2739,1738,1001,170,241,347,284,400,1297,38,7556,2777
1209,1938,1275,663,135,185,232,202,306,878,10,5300,1948
1210,1613,1128,485,153,197,125,127,190,821,24,3971,1637
1211,2466,1375,1091,371,630,480,362,415,208,0,8794,2466
1212,1146,275,871,179,416,287,131,118,15,0,5245,1146
1213,1112,493,619,60,162,189,210,216,275,69,5470,1181
1214,811,351,460,182,189,106,103,90,141,154,2174,965
1215,548,387,161,38,53,72,62,106,217,12,1416,560
1216,778,458,320,201,250,129,66,70,62,64,1438,842
1217,1213,715,498,314,390,201,103,110,95,464,4023,1677
1218,260,52,208,59,72,43,19,32,35,0,770,260
1219,857,602,255,127,158,132,111,129,200,0,2391,857
1220,1404,987,417,209,258,216,182,212,327,0,2984,1404
1221,241,82,159,63,70,32,36,20,20,3572,746,3813
1222,45,33,12,5,12,9,9,5,5,63,90,108
1223,1871,1436,435,159,241,208,223,411,629,0,4286,1871
1224,188,157,31,37,23,21,20,25,62,19,754,207
1225,455,298,157,60,43,50,53,79,170,0,1641,455
1226,458,300,158,60,43,50,53,80,172,84,1600,542
1227,479,399,80,95,58,53,51,64,158,3,804,482
1228,760,491,269,151,118,108,94,110,179,19,1886,779
1229,2144,1263,881,554,689,355,183,194,169,1,5689,2145
1230,742,359,383,119,203,147,100,120,53,0,2684,742
1231,1656,914,742,312,328,356,235,209,216,29,5470,1685
1232,523,282,241,54,54,100,69,93,153,0,1886,523
1233,536,387,149,61,59,44,43,104,225,0,1317,536
1234,1305,473,832,272,328,235,129,167,174,0,4925,1305
1235,387,78,309,88,107,63,28,48,53,254,1503,641
1236,775,619,156,83,91,113,115,176,197,54,1829,829
1237,331,112,219,86,97,44,49,28,27,0,910,331
1238,379,248,131,89,81,64,49,45,51,26,917,405
1239,1209,782,427,241,188,172,149,175,284,1,3831,1210
1240,462,219,243,98,105,108,63,49,39,47,1637,509
1241,234,138,96,60,75,39,20,21,19,333,655,567
1242,418,260,158,34,42,25,34,62,221,0,1128,418
1243,1136,373,763,131,143,149,150,218,345,1618,2994,2754
1244,495,350,145,34,48,65,56,96,196,0,1230,495
1245,418,295,123,29,41,55,47,81,165,0,1102,418
1246,409,289,120,28,40,53,46,79,163,0,984,409
1247,490,161,329,56,62,64,65,94,149,2,1188,492
1248,296,209,87,21,29,39,34,57,116,0,780,296
1249,520,224,296,48,98,89,85,96,104,8,2378,528
1250,675,542,133,92,73,112,100,105,193,0,1929,675
1251,432,283,149,57,40,47,50,75,163,0,1153,432
1252,229,117,112,45,23,23,23,32,83,477,687,706
1253,447,292,155,59,42,49,52,78,167,0,1226,447
1254,431,86,345,98,119,71,32,53,58,25,1793,456
1255,318,154,164,65,103,38,55,24,33,0,1637,318
1256,1626,770,856,283,607,245,163,167,161,43,6399,1669
1257,258,93,165,32,56,47,47,50,26,7,1121,265
1258,419,150,269,52,92,77,76,80,42,0,1750,419
1259,1231,929,302,192,117,175,137,157,453,54,2343,1285
1260,226,45,181,51,63,37,17,28,30,0,965,226
1261,565,370,195,133,120,95,73,67,77,126,1682,691
1262,524,343,181,124,112,88,68,62,70,104,1638,628
1263,134,88,46,32,29,23,17,16,17,0,487,134
1264,591,202,389,103,126,113,58,77,114,45,2303,636
1265,719,340,379,153,163,168,98,77,60,0,2500,719
1266,356,168,188,76,81,83,49,38,29,0,1252,356
1267,816,439,377,87,159,173,136,167,94,16,3889,832
1268,402,144,258,50,88,74,73,77,40,0,1842,402
1269,960,517,443,103,187,204,160,197,109,0,3270,960
1270,439,317,122,50,48,36,35,85,185,0,1208,439
1271,633,478,155,99,60,90,71,81,232,11,1474,644
1272,563,381,182,84,97,111,64,53,154,52,1303,615
1273,471,241,230,92,47,48,47,66,171,332,1507,803
1274,533,302,231,76,96,84,69,109,99,0,1817,533
1275,266,136,130,52,27,27,26,37,97,26,798,292
1276,274,155,119,39,49,43,36,56,51,0,780,274
1277,185,105,80,26,33,29,24,38,35,9,662,194
1278,680,440,240,135,106,97,84,98,160,293,1573,973
1279,318,180,138,45,57,50,41,65,60,4,1112,322
1280,405,192,213,86,92,95,55,43,34,0,1199,405
1281,469,345,124,88,127,77,62,80,35,0,1466,469
1282,569,275,294,91,156,113,76,92,41,107,2383,676
1283,1019,750,269,191,275,166,134,174,79,0,2394,1019
1284,613,490,123,65,72,89,91,139,157,0,1680,613
1285,0,0,0,0,0,0,0,0,0,0,0,0
1286,701,560,141,75,83,102,104,159,178,158,1799,859
1287,476,370,106,140,123,57,42,51,63,29,1076,505
1288,618,400,218,123,96,88,76,89,146,7,1899,625
1289,325,252,73,96,84,39,29,35,42,56,718,381
1290,223,173,50,66,58,27,20,24,28,1,382,224
1291,444,345,99,131,115,54,39,47,58,0,854,444
1292,561,436,125,165,145,68,50,60,73,10,1444,571
1293,1065,897,168,262,183,118,102,167,233,21,1920,1086
1294,1025,863,162,252,176,114,99,160,224,96,2173,1121
1295,558,421,137,87,53,80,62,71,205,0,1283,558
1296,432,394,38,26,28,67,47,78,186,101,993,533
1297,449,304,145,67,77,88,51,42,124,48,1181,497
1298,216,116,100,23,42,46,36,44,25,0,919,216
1299,610,393,217,111,124,70,52,100,153,0,1658,610
1300,788,508,280,144,160,91,67,129,197,56,2719,844
1301,490,316,174,89,100,56,42,80,123,0,1309,490
1302,290,156,134,31,56,62,48,59,34,2,1075,292
1303,864,420,444,175,280,104,150,66,89,13,3407,877
1304,416,268,148,76,85,48,36,68,103,0,1265,416
1305,371,161,210,83,86,48,47,41,66,1103,831,1474
1306,0,0,0,0,0,0,0,0,0,0,0,0
1307,827,635,192,70,107,92,98,182,278,0,2045,827
1308,331,276,55,65,40,37,35,44,110,0,364,331
1309,1497,942,555,231,239,276,153,381,217,40,6090,1537
1310,859,421,438,143,157,193,106,158,102,20,3897,879
1311,1088,752,336,117,131,179,134,229,298,5,3894,1093
1312,2058,989,1069,130,204,340,391,503,490,29,8845,2087
1313,1836,979,857,135,233,310,352,357,449,135,7290,1971
1314,3182,1156,2026,64,109,142,197,623,2047,52,12444,3234
1315,1111,699,412,46,99,198,106,274,388,31,4964,1142
1316,1056,629,427,68,82,169,130,234,373,54,4347,1110
1317,917,526,391,46,110,124,98,164,375,16,3635,933
1318,1090,540,550,94,123,80,123,240,430,31,4319,1121
1319,1628,1013,615,145,196,222,201,325,539,10,5534,1638
1320,1540,891,649,71,125,282,226,423,413,24,5520,1564
1321,693,488,205,154,109,35,38,86,271,0,1787,693
1322,1583,793,790,128,127,91,94,273,870,7,5606,1590
1323,507,292,215,32,41,74,73,140,147,0,1661,507
1324,831,500,331,70,75,101,99,185,301,0,3050,831
1325,1393,658,735,212,254,201,149,325,252,13,5406,1406
1326,1432,969,463,102,128,167,151,373,511,8,4635,1440
1327,1029,581,448,113,93,173,130,225,295,13,3858,1042
1328,1799,939,860,231,230,267,197,359,515,10,6374,1809
1329,177,127,50,17,23,22,20,33,62,0,481,177
1330,619,464,155,66,63,85,63,92,250,0,1811,619
1331,1863,1085,778,367,401,302,238,311,244,23,7000,1886
1332,1318,755,563,16,57,118,135,273,719,0,4626,1318
1333,3947,3257,690,432,508,637,485,574,1311,7,8972,3954
1334,1215,646,569,69,152,172,124,338,360,48,4912,1263
1335,927,336,591,130,186,207,135,158,111,5,4598,932
1336,1227,487,740,184,340,285,150,153,115,8,6110,1235
1337,1183,373,810,130,182,261,215,282,113,6,6281,1189
1338,418,108,310,40,32,64,33,113,136,11,2845,429
1339,885,429,456,68,123,184,110,193,207,0,4101,885
1340,861,475,386,63,105,148,77,255,213,0,3837,861
1341,1746,644,1102,391,388,293,195,321,158,11,7993,1757
1342,468,234,234,57,61,116,72,111,51,0,2022,468
1343,1715,1189,526,166,275,274,197,380,423,30,5782,1745
1344,1361,674,687,269,232,252,131,240,237,0,6449,1361
1345,1759,1138,621,141,243,287,250,419,419,24,5436,1783
1346,578,412,166,48,60,51,61,102,256,0,1779,578
1347,1303,612,691,149,168,130,113,286,457,31,4951,1334
1348,845,516,329,62,96,92,82,172,341,34,2926,879
1349,1910,751,1159,101,149,88,121,301,1150,0,7834,1910
1350,1483,800,683,188,266,159,213,315,342,21,5164,1504
1351,4107,1952,2155,144,196,195,249,628,2695,28,14233,4135
1352,1284,485,799,208,259,266,178,202,171,11,6438,1295
1353,1301,544,757,109,269,261,170,228,264,7,6746,1308
1354,1389,720,669,178,280,297,164,259,211,23,6257,1412
1355,232,112,120,54,55,45,29,25,24,2,986,234
1356,945,394,551,165,229,173,137,175,66,0,4282,945
1357,2508,1767,741,746,691,335,320,308,108,0,7031,2508
1358,221,151,70,37,33,39,28,46,38,0,836,221
1359,2259,1411,848,208,309,506,251,465,520,71,8358,2330
1360,1451,927,524,127,280,231,193,233,387,16,4955,1467
1361,2466,1293,1173,266,479,549,265,374,533,52,9275,2518
1362,1606,784,822,256,373,339,192,250,196,0,6712,1606
1363,1088,617,471,110,165,247,134,203,229,391,4443,1479
1364,1324,616,708,113,202,297,166,318,228,7,6098,1331
1365,1748,1048,700,184,229,119,128,227,861,23,5337,1771
1366,1483,1041,442,65,107,116,137,313,745,22,4799,1505
1367,1516,1048,468,179,226,143,147,193,628,2,4362,1518
1368,646,421,225,44,71,92,88,135,216,0,1599,646
1369,2001,1181,820,195,227,279,214,476,610,22,6591,2023
1370,729,429,300,74,84,101,82,156,232,15,2567,744
1371,1322,708,614,133,165,275,254,249,246,0,5103,1322
1372,1624,786,838,151,187,146,127,290,723,2,5792,1626
1373,1407,706,701,123,106,189,134,282,573,6,5369,1413
1374,2237,981,1256,336,341,272,250,433,605,0,7193,2237
1375,1522,991,531,104,168,216,207,319,508,0,4630,1522
1376,281,127,154,43,78,74,49,36,1,0,1009,281
1377,289,185,104,22,23,25,31,63,125,9,972,298
1378,391,144,247,88,87,66,44,72,34,84,1471,475
1379,111,67,44,37,33,14,9,10,8,1,343,112
1380,111,67,44,37,33,14,9,10,8,0,318,111
1381,437,285,152,30,48,62,59,92,146,0,1386,437
1382,690,424,266,43,37,112,94,141,263,17,2820,707
1383,650,423,227,44,72,92,88,136,218,0,1615,650
1384,515,323,192,77,84,75,63,81,135,0,1801,515
1385,895,670,225,96,92,124,91,134,358,22,2237,917
1386,630,303,327,148,150,121,78,69,64,0,2263,630
1387,1607,967,640,539,473,204,136,144,111,0,5738,1607
1388,567,388,179,96,83,99,73,118,98,8,2028,575
1389,674,337,337,82,87,167,103,160,75,94,2884,768
1390,487,234,253,114,116,94,61,53,49,0,1942,487
1391,310,155,155,38,40,77,47,74,34,0,1171,310
1392,709,392,317,152,141,137,98,112,69,30,2417,739
1393,179,99,80,38,36,35,25,28,17,105,576,284
1394,600,346,254,38,48,87,87,165,175,13,2082,613
1395,716,450,266,108,116,104,87,112,189,10,2677,726
1396,594,367,227,48,59,79,88,133,187,30,2077,624
1397,591,365,226,48,58,78,87,133,187,0,1965,591
1398,1209,716,493,112,202,168,168,258,301,19,4059,1228
1399,552,339,213,35,30,89,75,113,210,15,2096,567
1400,251,148,103,25,29,35,28,54,80,0,860,251
1401,1184,756,428,89,93,104,127,257,514,0,3585,1184
1402,456,268,188,46,53,63,51,97,146,10,1770,466
1403,721,470,251,49,80,102,98,151,241,52,2426,773
1404,1115,796,319,92,116,99,117,197,494,1,3477,1116
1405,937,599,338,70,73,82,100,203,409,7,2962,944
1406,932,576,356,76,92,123,138,209,294,6,3332,938
1407,283,128,155,43,78,74,50,36,2,0,855,283
1408,757,540,217,63,79,67,80,133,335,0,1844,757
1409,0,0,0,0,0,0,0,0,0,0,0,0
1410,696,521,175,75,71,96,71,104,279,0,1814,696
1411,2921,1677,1244,342,514,403,292,357,1013,31,8321,2952
1412,1228,706,522,61,103,98,92,253,621,0,3683,1228
1413,2839,1695,1144,92,153,148,143,345,1958,0,8373,2839
1414,2413,1744,669,185,307,327,251,323,1020,7,6303,2420
1415,1764,962,802,52,84,158,135,301,1034,2,5429,1766
1416,1944,1153,791,119,155,190,181,300,999,26,5834,1970
1417,1163,681,482,88,153,155,161,280,326,0,3252,1163
1418,1076,604,472,67,109,95,88,250,467,0,3214,1076
1419,925,501,424,47,59,55,55,147,562,0,2836,925
1420,1436,732,704,57,90,126,104,200,859,12,4366,1448
1421,2194,1414,780,130,240,246,250,408,920,29,6821,2223
1422,1657,985,672,68,130,211,168,394,686,36,5629,1693
1423,778,300,478,125,184,129,142,125,73,1,3019,779
1424,2054,1133,921,158,331,253,233,483,596,29,6362,2083
1425,2081,1220,861,189,490,327,290,510,275,11,6001,2092
1426,1350,702,648,101,234,168,187,315,345,0,4178,1350
1427,516,359,157,28,50,69,56,142,171,18,1634,534
1428,957,485,472,31,63,144,105,253,361,0,2814,957
1429,725,434,291,51,72,118,91,148,245,7,2596,732
1430,849,465,384,54,101,114,109,186,285,23,2329,872
1431,1394,845,549,114,123,152,135,302,568,0,4541,1394
1432,1781,953,828,150,198,173,168,382,710,31,5683,1812
1433,2902,1857,1045,224,407,558,408,554,751,75,8146,2977
1434,1712,803,909,136,265,335,271,312,393,19,7135,1731
1435,936,575,361,84,201,170,158,150,173,0,3009,936
1436,1680,957,723,141,280,198,213,353,495,29,4926,1709
1437,1050,568,482,82,171,97,98,177,425,18,3256,1068
1438,1683,1222,461,184,255,327,183,323,411,0,4953,1683
1439,1694,964,730,83,145,219,181,402,664,19,5639,1713
1440,966,559,407,53,76,85,70,230,452,0,3069,966
1441,1376,741,635,76,118,197,160,258,567,10,4448,1386
1442,1559,885,674,135,291,206,157,323,447,22,4508,1581
1443,2055,1397,658,172,400,319,274,413,477,7,5339,2062
1444,1284,844,440,79,122,214,148,190,531,66,3749,1350
1445,1299,822,477,72,144,141,113,246,583,91,3693,1390
1446,2326,1300,1026,157,291,170,175,476,1057,34,7046,2360
1447,1375,950,425,124,218,219,179,268,367,10,3374,1385
1448,1840,1109,731,117,201,173,170,326,853,0,5467,1840
1449,595,349,246,45,78,79,82,143,168,13,2307,608
1450,273,160,113,21,36,36,38,66,76,1,932,274
1451,461,270,191,35,60,62,64,111,129,0,1770,461
1452,406,249,157,36,87,74,68,65,76,10,1364,416
1453,1601,618,983,258,379,265,293,258,148,11,6555,1612
1454,1196,654,542,77,143,161,154,261,400,0,4267,1196
1455,323,193,130,22,53,60,45,74,69,13,1357,336
1456,1462,873,589,101,241,270,203,336,311,0,3998,1462
1457,1853,948,905,34,78,154,166,351,1070,24,6249,1877
1458,326,195,131,23,33,53,41,67,109,7,1066,333
1459,464,322,142,25,45,62,51,128,153,0,830,464
1460,599,416,183,32,58,81,65,165,198,27,1961,626
1461,1487,846,641,73,127,192,159,353,583,21,4112,1508
1462,619,430,189,33,60,83,68,171,204,7,1896,626
1463,769,459,310,53,127,142,107,177,163,52,2340,821
1464,612,287,325,49,95,120,97,111,140,10,2532,622
1465,584,359,225,52,125,106,99,93,109,0,1457,584
1466,614,314,300,37,73,72,90,148,194,18,2261,632
1467,601,308,293,37,71,70,88,145,190,20,1804,621
1468,309,158,151,19,36,36,45,75,98,24,982,333
1469,1388,897,491,166,165,168,168,268,453,2,4003,1390
1470,2248,1139,1109,303,446,308,265,459,467,114,8118,2362
1471,616,390,226,59,65,84,91,116,201,41,1967,657
1472,1500,1012,488,92,150,129,177,243,709,2,4559,1502
1473,1624,1184,440,123,122,163,172,222,822,0,4238,1624
1474,2559,1396,1163,124,189,196,253,472,1325,59,8361,2618
1475,308,169,139,28,39,36,39,58,108,9,1015,317
1476,2827,1450,1377,135,169,258,331,582,1352,0,9170,2827
1477,1284,560,724,190,291,196,174,284,149,369,4821,1653
1478,3086,1862,1224,377,401,480,371,607,850,29,8943,3115
1479,473,304,169,44,66,75,69,86,133,0,1494,473
1480,1726,1048,678,92,159,288,249,320,618,0,5169,1726
1481,803,479,324,46,84,123,103,169,278,16,2826,819
1482,618,364,254,83,158,81,55,136,105,6,1810,624
1483,306,220,86,35,48,31,35,64,93,12,710,318
1484,931,550,381,141,140,115,108,183,244,0,2652,931
1485,697,409,288,101,108,116,86,139,147,0,2115,697
1486,879,519,360,134,132,108,102,172,231,37,2712,916
1487,230,136,94,35,35,28,27,45,60,9,842,239
1488,280,164,116,41,43,46,35,56,59,6,896,286
1489,771,453,318,112,120,128,95,154,162,0,2519,771
1490,422,248,174,61,65,70,52,84,90,17,1146,439
1491,600,358,242,34,62,92,77,126,209,137,2105,737
1492,1819,1074,745,276,273,224,211,357,478,0,5120,1819
1493,145,45,100,26,42,25,19,20,13,50,448,195
1494,638,385,253,78,83,99,77,125,176,5,2165,643
1495,495,153,342,89,143,87,65,70,41,11,2142,506
1496,218,67,151,39,63,38,29,31,18,0,669,218
1497,675,209,466,122,195,118,89,95,56,10,2936,685
1498,299,192,107,28,41,47,44,54,85,2,1048,301
1499,1157,637,520,104,145,135,148,217,408,7,4225,1164
1500,995,643,352,119,119,120,121,192,324,0,2683,995
1501,329,193,136,48,51,55,41,66,68,17,1169,346
1502,422,131,291,76,122,74,56,59,35,19,1753,441
1503,565,333,232,76,145,74,51,124,95,11,2007,576
1504,889,522,367,129,138,147,110,177,188,67,2504,956
1505,723,315,408,107,164,111,98,160,83,118,2599,841
1506,876,516,360,117,224,115,79,193,148,23,2848,899
1507,372,115,257,67,108,65,49,52,31,6,1439,378
1508,626,369,257,84,160,82,56,138,106,0,1711,626
1509,444,339,105,39,63,88,74,75,105,12,1199,456
1510,981,749,232,86,139,193,163,165,235,0,2001,981
1511,618,472,146,54,88,122,102,104,148,0,1557,618
1512,1195,905,290,135,202,174,143,154,387,0,3057,1195
1513,447,288,159,31,44,63,63,86,160,0,1186,447
1514,340,219,121,24,34,48,48,65,121,0,950,340
1515,408,263,145,28,40,58,57,79,146,0,973,408
1516,0,0,0,0,0,0,0,0,0,0,0,0
1517,103,74,29,11,10,11,9,24,38,0,171,103
1518,66,13,53,15,18,11,5,8,9,1,135,67
1519,813,677,136,161,99,90,86,109,268,1,1833,814
1520,90,66,24,10,24,17,18,10,11,2,246,92
1521,903,823,80,54,60,141,98,163,387,134,2215,1037
1522,13,10,3,2,4,2,3,1,1,4,52,17
1523,251,202,49,34,27,42,37,39,72,2,496,253
1524,5,4,1,1,1,1,1,1,0,0,20,5
1525,0,0,0,0,0,0,0,0,0,0,0,0
1526,685,550,135,94,74,113,102,106,196,0,1245,685
1527,183,131,52,17,23,23,21,34,65,0,641,183
1528,251,180,71,24,32,32,28,47,88,0,441,251
1529,68,43,25,5,5,6,7,15,30,0,309,68
1530,469,416,53,140,123,62,46,36,62,1,639,470
1531,2559,1809,750,138,205,246,352,730,888,0,6252,2559
1532,590,375,215,63,94,58,90,162,123,6,1596,596
1533,305,174,131,18,28,19,30,70,140,0,913,305
1534,920,525,395,54,85,58,91,212,420,12,2853,932
1535,1873,1140,733,70,141,176,204,362,920,60,5433,1933
1536,1186,709,477,23,35,54,88,225,761,13,3787,1199
1537,5,3,2,0,0,0,0,1,4,0,12,5
1538,338,177,161,11,19,28,32,34,214,0,953,338
1539,1007,528,479,32,58,84,95,101,637,0,3301,1007
1540,2093,1264,829,176,248,177,178,292,1022,0,6172,2093
1541,6355,3357,2998,315,446,341,459,1138,3656,0,19489,6355
1542,3253,1659,1594,167,272,334,393,784,1303,11,9609,3264
1543,1854,1229,625,135,202,154,202,278,883,0,4988,1854
1544,1401,868,533,34,55,83,111,232,886,12,4134,1413
1545,1303,873,430,61,90,122,163,375,492,14,3789,1317
1546,1035,566,469,126,179,164,181,207,178,24,2982,1059
1547,1075,680,395,87,137,125,131,189,406,0,3301,1075
1548,418,240,178,40,65,42,50,84,137,7,1119,425
1549,1725,1338,387,180,250,292,270,243,490,8,4391,1733
1550,3125,1878,1247,168,290,418,428,557,1264,0,9161,3125
1551,0,0,0,0,0,0,0,0,0,0,0,0
1552,336,207,129,20,31,35,42,92,116,3,1071,339
1553,1346,855,491,63,118,115,150,301,599,0,4031,1346
1554,438,305,133,19,30,38,51,94,206,0,1028,438
1555,1942,1068,874,104,156,160,201,364,957,6,6358,1948
1556,672,413,259,64,75,63,61,120,289,4,1614,676
1557,347,219,128,17,27,31,39,58,175,0,1079,347
1558,855,541,314,43,66,77,96,143,430,0,2711,855
1559,2660,1570,1090,260,468,303,406,557,666,14,7214,2674
1560,1340,839,501,97,144,137,171,312,479,8,3806,1348
1561,1116,639,477,85,114,122,128,243,424,141,3146,1257
1562,955,522,433,116,165,151,167,191,165,5,2802,960
1563,429,269,160,31,46,44,55,100,153,0,1353,429
1564,915,636,279,40,63,79,107,196,430,0,2665,915
1565,1326,907,419,101,172,108,121,224,600,12,3723,1338
1566,741,407,334,40,60,61,77,139,364,0,1657,741
1567,633,379,254,53,92,46,55,118,269,0,1626,633
1568,355,218,137,34,40,33,32,64,152,12,1053,367
1569,684,485,199,57,83,96,115,120,213,29,1589,713
1570,429,273,156,46,68,42,65,118,90,14,1253,443
1571,614,348,266,41,69,68,85,134,217,0,1838,614
1572,676,462,214,51,87,55,61,114,308,11,1551,687
1573,510,396,114,53,74,86,80,72,145,0,949,510
1574,1780,1124,656,75,110,147,204,364,880,0,4933,1780
1575,753,451,302,64,110,55,65,141,318,10,2155,763
1576,401,269,132,19,28,38,50,116,150,0,972,401
1577,25,16,9,1,2,2,3,4,13,0,57,25
1578,756,478,278,38,58,68,85,127,380,0,2340,756
1579,886,530,356,17,26,40,65,168,570,0,2401,886
1580,638,495,143,67,93,108,100,90,180,0,1361,638
1581,449,245,204,55,78,71,79,90,76,0,1587,449
1582,874,496,378,58,98,97,121,190,310,0,2704,874
1583,1195,627,568,37,69,100,113,120,756,0,3580,1195
1584,1548,1068,480,185,326,147,159,244,487,0,3331,1548
1585,290,167,123,28,45,29,34,58,96,0,778,290
1586,0,0,0,0,0,0,0,0,0,0,0,0
1587,807,444,363,43,65,66,83,151,399,0,2262,807
1588,991,703,288,83,121,139,166,174,308,0,2791,991
1589,709,448,261,57,91,82,87,124,268,27,1569,736
1590,770,531,239,92,162,73,79,122,242,118,2075,888
1591,1474,931,543,62,91,122,169,301,729,0,4360,1474
1592,361,189,172,11,21,30,34,36,229,0,901,361
1593,1115,673,442,94,132,94,95,156,544,60,2601,1175
1594,348,210,138,29,41,29,30,49,170,0,956,348
1595,452,286,166,23,35,41,51,76,226,3,1257,455
1596,577,361,216,42,62,59,74,135,205,0,1612,577
1597,738,462,276,53,80,75,94,172,264,0,2158,738
1598,776,493,283,36,68,67,86,173,346,0,1972,776
1599,759,482,277,35,67,65,84,170,338,8,2042,767
1600,879,448,431,45,74,90,106,212,352,0,2802,879
1601,0,0,0,0,0,0,0,0,0,0,0,0
1602,339,185,154,41,59,54,59,68,58,0,925,339
1603,250,144,106,24,39,25,30,50,82,4,741,254
1604,477,272,205,28,44,30,47,110,218,13,1505,490
1605,460,283,177,44,51,43,41,82,199,0,1242,460
1606,1051,647,404,63,97,110,132,287,362,28,2894,1079
1607,927,526,401,62,103,103,128,202,329,0,2771,927
1608,581,348,233,49,85,42,50,108,247,0,1422,581
1609,735,521,214,61,89,103,123,129,230,66,1863,801
1610,989,629,360,106,157,97,150,272,207,24,2996,1013
1611,1087,625,462,104,170,110,129,217,357,10,3222,1097
1612,86,45,41,4,6,5,6,15,50,0,175,86
1613,22,14,8,1,1,2,3,4,11,0,102,22
1614,0,0,0,0,0,0,0,0,0,0,0,0
1615,466,287,179,28,43,49,59,127,160,8,1367,474
1616,283,180,103,13,25,24,31,63,127,0,828,283
1617,3570,1590,1980,167,276,234,347,804,1742,0,11347,3570
1618,611,380,231,21,95,67,78,122,228,44,2512,655
1619,517,295,222,28,48,85,65,98,193,0,1374,517
1620,1066,636,430,99,145,96,118,217,391,12,3344,1078
1621,1008,584,424,30,102,110,117,194,455,25,3666,1033
1622,419,213,206,28,75,50,49,73,144,9,1485,428
1623,2578,1535,1043,343,244,369,407,599,616,0,7512,2578
1624,563,372,191,47,57,60,74,136,189,6,1841,569
1625,738,394,344,70,85,90,81,119,293,24,2238,762
1626,893,564,329,96,104,113,109,245,226,19,2899,912
1627,1197,589,608,92,117,210,213,276,289,11,4130,1208
1628,1244,577,667,29,67,107,144,290,607,0,4163,1244
1629,2065,1082,983,91,161,214,256,526,817,7,6624,2072
1630,1528,960,568,105,363,286,201,312,261,13,5103,1541
1631,65,34,31,7,8,7,8,14,21,0,228,65
1632,1051,614,437,45,71,87,96,163,589,12,3310,1063
1633,710,350,360,27,49,36,52,133,413,0,2278,710
1634,656,308,348,35,57,46,62,102,354,0,2151,656
1635,2210,1333,877,183,246,356,347,499,579,17,7504,2227
1636,1038,628,410,71,97,140,130,216,384,8,3013,1046
1637,2250,1211,1039,219,223,328,319,506,655,14,7605,2264
1638,2403,1285,1118,149,234,179,189,396,1256,68,7476,2471
1639,1228,749,479,31,57,75,69,106,890,76,3905,1304
1640,1213,757,456,43,82,57,62,114,855,0,3967,1213
1641,551,379,172,41,94,54,62,90,210,0,1896,551
1642,1227,607,620,103,184,198,175,273,294,32,4365,1259
1643,1988,871,1117,188,275,337,331,432,425,46,7009,2034
1644,3100,2044,1056,129,415,411,459,899,787,12,9887,3112
1645,1857,1207,650,106,412,288,260,327,464,46,6293,1903
1646,992,719,273,163,280,117,147,138,147,55,2807,1047
1647,1616,1161,455,202,245,158,185,216,610,2,4194,1618
1648,2411,1235,1176,206,280,215,292,633,785,23,8081,2434
1649,1656,855,801,60,110,168,181,383,754,17,5385,1673
1650,1793,928,865,88,217,184,175,319,810,10,6260,1803
1651,1447,783,664,121,172,189,215,294,456,20,5012,1467
1652,359,189,170,5,20,15,28,69,222,0,1461,359
1653,230,143,87,8,36,25,30,46,85,15,898,245
1654,1106,936,170,114,281,140,152,170,249,0,2641,1106
1655,1020,494,526,82,33,66,99,230,510,0,2528,1020
1656,1205,838,367,202,146,173,179,270,235,0,3012,1205
1657,290,155,135,7,16,16,21,44,186,0,909,290
1658,229,119,110,25,30,24,27,50,73,0,624,229
1659,774,381,393,59,76,136,137,179,187,11,2859,785
1660,624,311,313,29,99,88,98,153,157,0,2361,624
1661,828,480,348,59,71,127,139,235,197,8,2803,836
1662,917,542,375,67,86,102,116,230,316,2,2469,919
1663,411,205,206,19,65,58,64,101,104,5,1574,416
1664,385,208,177,36,44,35,47,86,137,0,1268,385
1665,808,517,291,42,52,66,97,274,277,7,2334,815
1666,651,432,219,62,155,71,72,110,181,20,2029,671
1667,1027,533,494,111,134,108,121,224,329,40,3221,1067
1668,743,386,357,80,97,78,87,162,239,99,1721,842
1669,546,287,259,7,30,24,43,105,337,0,2151,546
1670,159,99,60,7,22,19,18,38,55,1,715,160
1671,702,435,267,29,99,82,78,167,247,29,2719,731
1672,754,467,287,31,106,88,83,179,267,33,2895,787
1673,1005,632,373,44,104,170,143,178,366,0,3914,1005
1674,1091,686,405,48,113,185,155,193,397,0,3053,1091
1675,348,186,162,8,19,19,25,52,225,0,1090,348
1676,397,254,143,21,26,33,48,135,134,8,1591,405
1677,806,402,404,37,128,114,126,197,204,13,3008,819
1678,884,504,380,48,82,145,112,168,329,34,3018,918
1679,437,234,203,11,24,24,31,66,281,4,1389,441
1680,1364,938,426,102,233,133,154,223,519,11,4355,1375
1681,571,290,281,39,102,69,67,99,195,4,2093,575
1682,634,342,292,59,73,58,78,142,224,22,1930,656
1683,387,240,147,16,55,45,43,92,136,0,1457,387
1684,7,3,4,0,1,0,1,2,3,28,22,35
1685,824,440,384,78,95,100,91,133,327,0,2546,824
1686,337,182,155,31,39,31,41,76,119,0,1189,337
1687,600,401,199,51,49,53,67,153,227,0,1754,600
1688,225,150,75,19,18,20,25,57,86,0,563,225
1689,1373,917,456,116,113,121,154,349,520,0,3886,1373
1690,735,491,244,62,60,65,83,187,278,0,1984,735
1691,456,303,153,43,109,50,51,77,126,12,1558,468
1692,328,162,166,29,66,43,53,77,60,0,1107,328
1693,375,181,194,24,73,57,53,73,95,0,1485,375
1694,421,251,170,39,57,38,47,86,154,13,1197,434
1695,1273,850,423,108,104,112,143,324,482,0,3761,1273
1696,1390,928,462,118,114,123,156,353,526,0,2961,1390
1697,497,313,184,22,51,84,71,88,181,0,1422,497
1698,508,320,188,22,53,86,72,90,185,26,1634,534
1699,370,136,234,37,52,110,74,69,28,16,1556,386
1700,637,379,258,85,60,91,101,148,152,2,1496,639
1701,907,447,460,35,63,47,66,170,526,0,2924,907
1702,399,237,162,55,64,54,56,84,86,98,1129,497
1703,942,559,383,130,152,127,132,199,202,9,2507,951
1704,575,341,234,79,93,78,81,122,122,0,1594,575
1705,416,289,127,70,50,60,62,93,81,0,899,416
1706,614,288,326,33,53,43,58,95,332,0,1992,614
1707,394,211,183,24,38,29,31,65,207,0,1232,394
1708,541,262,279,35,105,82,76,106,137,4,2102,545
1709,477,317,160,45,114,52,53,81,132,11,1345,488
1710,332,169,163,22,59,40,39,58,114,8,1157,340
1711,331,122,209,33,47,99,66,62,24,0,1308,331
1712,318,143,175,15,71,50,54,67,61,19,1253,337
1713,558,331,227,77,90,75,78,118,120,0,1559,558
1714,870,465,405,82,100,106,96,141,345,118,2696,988
1715,656,389,267,90,106,88,92,139,141,6,2123,662
1716,621,368,253,85,100,84,87,131,134,8,1994,629
1717,464,248,216,44,53,57,51,75,184,0,1477,464
1718,827,442,385,51,81,61,65,136,433,0,2477,827
1719,589,405,184,44,100,57,67,96,225,5,1484,594
1720,480,237,243,40,72,78,68,107,115,0,1639,480
1721,598,296,302,50,90,97,85,133,143,8,2042,606
1722,393,260,133,33,40,42,52,95,131,0,1322,393
1723,605,439,166,100,170,71,90,84,90,3,1549,608
1724,207,135,72,12,46,32,29,36,52,11,658,218
1725,386,230,156,36,53,35,43,79,140,6,1352,392
1726,356,184,172,41,34,45,44,62,130,0,1338,356
1727,737,513,224,124,89,106,110,165,143,2,2264,739
1728,1037,591,446,57,96,170,131,197,386,1,2484,1038
1729,546,270,276,48,110,72,87,127,102,0,2027,546
1730,385,200,185,41,50,41,45,84,124,0,1387,385
1731,118,53,65,6,9,8,11,27,57,0,410,118
1732,498,329,169,42,51,53,66,120,166,0,1579,498
1733,505,334,171,43,52,54,67,122,167,0,1750,505
1734,527,247,280,28,45,37,50,82,285,0,1676,527
1735,590,266,324,28,132,94,100,125,111,12,2404,602
1736,1031,598,433,31,105,113,119,198,465,25,3875,1056
1737,476,316,160,45,114,52,53,81,131,0,1501,476
1738,376,139,237,37,53,112,75,70,29,9,1495,385
1739,384,142,242,38,54,114,77,72,29,0,1533,384
1740,717,371,346,82,69,91,88,125,262,19,2347,736
1741,216,112,104,25,21,27,26,38,79,13,747,229
1742,1012,523,489,116,97,129,124,176,370,0,3607,1012
1743,448,217,231,29,87,68,63,88,113,14,1760,462
1744,417,223,194,10,23,23,30,63,268,5,1385,422
1745,1007,543,464,93,116,92,124,226,356,3,3330,1010
1746,0,0,0,0,0,0,0,0,0,0,0,0
1747,284,126,158,13,22,19,28,64,138,0,875,284
1748,0,0,0,0,0,0,0,0,0,0,0,0
1749,450,283,167,20,47,76,64,80,163,19,1436,469
1750,232,146,86,10,24,39,33,41,85,12,790,244
1751,0,0,0,0,0,0,0,0,0,4,0,4
1752,369,192,177,40,48,39,43,80,119,0,997,369
1753,30,14,16,2,3,2,3,6,14,0,135,30
1754,12,5,7,1,1,1,1,3,5,0,20,12
1755,0,0,0,0,0,0,0,0,0,0,0,0
1756,129,59,70,7,11,8,12,28,63,5,295,134
1757,0,0,0,0,0,0,0,0,0,0,0,0
1758,971,703,268,136,188,146,125,180,196,3,2678,974
1759,1102,825,277,109,161,143,125,261,303,0,3518,1102
1760,520,259,261,72,107,91,88,99,63,2,1816,522
1761,1456,943,513,97,230,217,212,383,317,61,4426,1517
1762,2968,1965,1003,121,312,367,358,609,1201,19,8757,2987
1763,2470,1732,738,120,234,318,332,501,965,34,6524,2504
1764,733,530,203,33,63,111,91,119,316,0,2150,733
1765,1039,668,371,160,223,164,135,156,201,0,2812,1039
1766,1507,1041,466,107,194,171,184,311,540,14,4210,1521
1767,1810,1218,592,129,298,251,220,311,601,2,5396,1812
1768,1719,927,792,323,377,356,244,248,171,212,5435,1931
1769,1666,963,703,137,212,312,277,337,391,18,5589,1684
1770,1431,852,579,106,211,283,253,327,251,26,4451,1457
1771,1846,1182,664,154,270,363,320,404,335,4,6139,1850
1772,1247,844,403,144,249,217,173,190,274,27,3343,1274
1773,1019,776,243,54,104,107,142,200,412,14,2655,1033
1774,1662,1032,630,332,493,287,178,274,98,8,5074,1670
1775,923,549,374,138,180,167,110,181,147,13,3197,936
1776,811,502,309,69,113,164,104,168,193,5,2437,816
1777,929,543,386,75,124,241,138,237,114,6,3324,935
1778,313,129,184,49,81,69,50,42,22,0,1136,313
1779,1213,844,369,116,159,250,158,282,248,31,4221,1244
1780,1208,712,496,147,232,272,175,266,116,10,4985,1218
1781,703,482,221,61,109,161,107,148,117,7,2404,710
1782,723,450,273,32,69,140,143,177,162,0,2163,723
1783,1442,1041,401,132,207,187,136,270,510,7,3609,1449
1784,1167,827,340,130,210,152,120,209,346,2,3097,1169
1785,1484,1026,458,141,209,200,145,278,511,10,4087,1494
1786,1256,934,322,255,362,227,168,158,86,0,2773,1256
1787,1455,792,663,225,317,193,160,237,323,5,4997,1460
1788,1431,915,516,189,212,223,198,278,331,10,4577,1441
1789,1178,837,341,232,283,188,146,200,129,0,3330,1178
1790,815,416,399,178,241,167,108,65,56,8,2343,823
1791,2524,1618,906,220,428,275,270,434,897,13,8177,2537
1792,1575,907,668,94,141,252,229,366,493,1086,4572,2661
1793,439,313,126,46,89,90,67,81,66,0,1199,439
1794,1077,629,448,110,168,186,179,275,159,13,3581,1090
1795,1619,1030,589,157,234,238,235,385,370,6,5440,1625
1796,1132,738,394,154,302,226,149,202,99,0,3546,1132
1797,564,325,239,63,119,112,74,97,99,0,2224,564
1798,731,507,224,96,138,112,111,145,129,21,2102,752
1799,659,445,214,68,124,134,71,95,167,23,2312,682
1800,1163,479,684,138,325,251,199,192,58,31,4445,1194
1801,927,598,329,112,182,178,112,192,151,3,3620,930
1802,1455,865,590,97,143,283,208,356,368,28,5242,1483
1803,887,544,343,103,158,214,117,152,143,42,3922,929
1804,451,265,186,60,111,101,74,66,39,0,1268,451
1805,766,411,355,167,243,161,110,62,23,10,2348,776
1806,404,288,116,54,84,68,55,43,100,7,1132,411
1807,515,344,171,84,107,55,63,108,98,0,1465,515
1808,366,265,101,61,86,77,62,57,23,0,974,366
1809,336,224,112,55,70,36,41,71,63,0,768,336
1810,559,366,193,131,173,65,54,71,65,0,1671,559
1811,796,495,301,76,118,176,137,224,65,6,2340,802
1812,390,199,191,85,115,80,52,31,27,0,1300,390
1813,456,342,114,45,67,59,52,108,125,4,1263,460
1814,584,424,160,98,138,123,100,92,33,4,1312,588
1815,546,297,249,84,119,73,60,89,121,0,1864,546
1816,461,343,118,94,133,83,62,58,31,3,905,464
1817,317,258,59,32,63,56,48,68,50,0,785,317
1818,991,808,183,99,198,174,149,212,159,4,2162,995
1819,602,394,208,141,187,70,58,77,69,50,2008,652
1820,808,539,269,132,168,86,98,170,154,0,2362,808
1821,707,478,229,82,141,123,98,108,155,9,1832,716
1822,826,574,252,117,162,174,136,116,121,37,2120,863
1823,1068,614,454,175,241,201,171,183,97,13,3547,1081
1824,515,383,132,105,149,93,69,65,34,0,1194,515
1825,385,286,99,78,111,69,52,48,27,0,821,385
1826,917,682,235,186,265,165,123,115,63,0,2021,917
1827,304,166,138,47,66,40,33,49,69,18,1062,322
1828,665,426,239,58,113,72,71,114,237,0,1408,665
1829,290,196,94,34,58,50,40,44,64,4,890,294
1830,1029,637,392,87,144,208,132,213,245,0,3412,1029
1831,479,297,182,41,67,97,61,99,114,0,1782,479
1832,784,530,254,81,148,159,84,113,199,30,2426,814
1833,226,130,96,37,51,43,36,39,20,0,694,226
1834,254,146,108,42,57,48,41,44,22,0,908,254
1835,853,491,362,140,193,161,136,146,77,0,2772,853
1836,425,245,180,70,96,80,68,73,38,0,1286,425
1837,1009,660,349,236,313,117,97,129,117,16,2425,1025
1838,360,250,110,51,71,76,59,51,52,5,924,365
1839,529,329,200,51,79,117,91,149,42,6,1820,535
1840,702,510,192,62,127,110,115,139,149,17,1641,719
1841,461,329,132,48,94,94,70,85,70,19,1285,480
1842,782,569,213,69,141,123,128,154,167,5,1937,787
1843,398,243,155,50,98,93,73,58,26,0,1004,398
1844,676,420,256,29,64,130,134,166,153,36,1920,712
1845,180,74,106,28,46,39,29,24,14,32,697,212
1846,643,265,378,102,165,141,104,86,45,0,2725,643
1847,734,549,185,89,137,160,89,136,123,52,2401,786
1848,620,464,156,75,116,135,75,115,104,22,1935,642
1849,691,452,239,161,214,80,67,88,81,0,1385,691
1850,1085,696,389,95,184,118,116,187,385,0,3068,1085
1851,311,199,112,27,53,34,33,53,111,5,882,316
1852,1017,548,469,191,223,211,144,147,101,51,3507,1068
1853,353,219,134,30,49,71,45,73,85,17,1395,370
1854,403,216,187,88,128,85,58,33,11,0,1303,403
1855,791,424,367,172,251,166,114,64,24,7,2542,798
1856,476,357,119,47,70,62,54,113,130,0,1255,476
1857,1006,820,186,100,201,177,151,215,162,8,2171,1014
1858,190,118,72,16,27,38,24,39,46,0,777,190
1859,289,179,110,25,40,58,37,60,69,5,1077,294
1860,637,263,374,101,164,140,103,85,44,0,2317,637
1861,582,314,268,109,128,121,83,84,57,0,1748,582
1862,798,427,371,107,219,187,130,105,50,6,2704,804
1863,510,382,128,62,96,111,62,95,84,7,1648,517
1864,354,180,174,30,72,91,54,54,53,0,1246,354
1865,659,336,323,56,134,169,101,101,98,4,2298,663
1866,416,171,245,66,107,91,67,55,30,0,1674,416
1867,445,238,207,59,122,104,72,59,29,8,1228,453
1868,467,313,154,48,90,81,68,108,72,0,1377,467
1869,525,349,176,93,141,82,65,74,70,10,1407,535
1870,494,334,160,51,93,100,53,71,126,8,1664,502
1871,693,519,174,84,130,151,84,128,116,13,2315,706
1872,239,179,60,29,45,52,29,44,40,0,662,239
1873,344,233,111,36,65,70,37,50,86,0,1289,344
1874,593,398,195,61,115,103,87,138,89,24,1971,617
1875,1160,841,319,194,274,244,198,182,68,0,2922,1160
1876,460,334,126,77,109,97,78,72,27,42,839,502
1877,423,307,116,71,100,89,72,66,25,59,932,482
1878,263,166,97,30,56,54,37,64,22,0,1087,263
1879,273,175,98,20,28,60,49,67,49,0,1029,273
1880,390,245,145,44,84,80,54,96,32,0,1367,390
1881,1032,643,389,113,191,241,143,180,164,5,2721,1037
1882,765,476,289,84,142,179,106,133,121,40,2518,805
1883,557,347,210,61,103,130,77,97,89,59,2029,616
1884,1107,710,397,81,115,242,198,274,197,39,3630,1146
1885,225,169,56,22,33,29,25,53,63,0,415,225
1886,256,128,128,35,53,45,43,49,31,75,903,331
1887,607,310,297,133,179,125,80,49,41,0,1638,607
1888,344,248,96,81,78,49,42,51,43,6,877,350
1889,423,285,138,30,70,59,51,73,140,0,1197,423
1890,715,436,279,90,176,168,130,104,47,0,1807,715
1891,629,321,308,54,128,161,96,96,94,0,2488,629
1892,396,231,165,40,62,68,66,101,59,0,1389,396
1893,882,508,374,99,185,175,116,151,156,11,3013,893
1894,257,128,129,36,53,45,43,49,31,1,884,258
1895,486,289,197,33,48,95,70,119,121,0,1886,486
1896,938,603,335,144,202,148,122,140,182,31,2514,969
1897,802,471,331,107,197,180,132,117,69,77,2096,879
1898,376,273,103,33,68,59,61,74,81,0,1012,376
1899,327,238,89,29,59,51,53,65,70,0,833,327
1900,665,382,283,125,120,131,123,98,68,0,2366,665
1901,713,508,205,74,145,146,108,131,109,20,1857,733
1902,424,244,180,48,89,84,56,73,74,5,1647,429
1903,760,436,324,143,137,150,141,112,77,0,2398,760
1904,487,261,226,106,155,102,70,40,14,3,1319,490
1905,428,305,123,57,89,72,59,46,105,7,1065,435
1906,331,206,125,36,61,77,46,58,53,0,1002,331
1907,607,396,211,83,162,121,80,108,53,0,1556,607
1908,554,399,155,130,126,78,68,82,70,15,1506,569
1909,701,474,227,81,140,122,97,107,154,8,1470,709
1910,199,101,98,17,41,51,30,31,29,0,704,199
1911,521,361,160,68,99,80,79,103,92,14,1345,535
1912,628,313,315,113,125,108,104,102,76,0,2070,628
1913,770,384,386,138,153,132,128,126,93,5,2598,775
1914,483,241,242,87,96,83,80,79,58,0,1822,483
1915,534,346,188,66,106,82,80,142,58,11,1772,545
1916,677,438,239,84,135,104,101,180,73,0,1950,677
1917,311,225,86,43,60,47,40,58,63,0,864,311
1918,1022,727,295,201,245,164,127,174,111,0,2427,1022
1919,1034,737,297,137,216,174,142,111,254,8,2384,1042
1920,820,546,274,146,220,127,102,116,109,78,1824,898
1921,388,258,130,69,104,60,48,55,52,22,1037,410
1922,589,424,165,138,134,83,72,87,75,16,1599,605
1923,867,498,369,163,156,171,161,128,88,0,2525,867
1924,313,180,133,59,56,62,58,46,32,0,915,313
1925,195,112,83,32,44,37,31,33,18,0,619,195
1926,60,39,21,7,12,9,9,16,7,0,208,60
1927,0,0,0,0,0,0,0,0,0,0,0,0
1928,5,3,2,1,1,1,1,1,0,0,22,5
1929,613,360,253,82,151,138,101,89,52,0,1597,613
1930,278,227,51,28,55,49,42,59,45,0,590,278
1931,88,61,27,12,17,19,14,12,14,0,238,88
1932,168,117,51,24,33,35,28,24,24,0,405,168
1933,211,131,80,18,29,43,27,44,50,0,836,211
1934,0,0,0,0,0,0,0,0,0,0,0,0
1935,408,205,203,93,123,51,65,51,25,37,1461,445
1936,475,419,56,68,53,72,66,99,117,0,920,475
1937,2370,1730,640,116,130,226,204,437,1257,0,5548,2370
1938,766,562,204,37,34,62,47,146,440,1,1986,767
1939,291,221,70,42,46,38,35,58,72,0,665,291
1940,1412,1050,362,124,116,216,200,261,495,16,3433,1428
1941,105,62,43,6,8,12,8,14,57,0,150,105
1942,1067,634,433,65,84,124,86,146,562,8,2998,1075
1943,703,431,272,32,29,49,54,91,448,0,1892,703
1944,2352,1702,650,75,121,290,242,415,1209,6,5406,2358
1945,1828,1385,443,81,96,134,126,371,1020,0,4704,1828
1946,525,340,185,121,122,90,60,81,51,32,1717,557
1947,998,712,286,60,56,110,98,170,504,348,2328,1346
1948,1380,1130,250,86,88,210,224,278,494,0,3326,1380
1949,294,173,121,56,48,56,38,67,29,10,802,304
1950,1217,867,350,85,117,185,136,410,284,0,3613,1217
1951,45,30,15,11,10,9,6,6,3,0,146,45
1952,1570,916,654,71,76,100,79,201,1043,3,4491,1573
1953,304,204,100,28,43,49,37,51,96,0,852,304
1954,1746,992,754,380,420,270,259,252,165,0,5328,1746
1955,802,621,181,70,116,137,131,194,154,0,1537,802
1956,1414,1094,320,123,205,242,231,342,271,9,3423,1423
1957,616,440,176,72,94,85,73,101,191,0,1592,616
1958,2513,1614,899,123,239,314,316,583,938,0,7012,2513
1959,2603,1743,860,167,242,267,266,565,1096,2,7445,2605
1960,93,60,33,8,8,9,7,14,47,0,217,93
1961,781,584,197,88,114,116,117,154,192,0,1863,781
1962,328,272,56,30,47,60,58,66,67,0,564,328
1963,236,168,68,32,36,28,25,48,67,0,658,236
1964,440,251,189,71,71,64,40,112,82,683,1130,1123
1965,556,384,172,68,76,119,75,105,113,0,1379,556
1966,426,254,172,133,113,63,52,41,24,31,1425,457
1967,295,176,119,92,78,44,36,28,17,6,1012,301
1968,438,320,118,54,55,84,57,96,92,0,1131,438
1969,501,374,127,56,73,74,75,99,124,0,1338,501
1970,466,370,96,104,104,68,65,74,51,0,1197,466
1971,218,92,126,54,59,37,37,24,7,0,792,218
1972,478,357,121,54,70,71,72,94,117,0,1267,478
1973,331,263,68,74,74,49,46,52,36,9,788,340
1974,529,420,109,118,118,78,74,83,58,0,1198,529
1975,2249,2081,168,543,500,378,291,243,294,0,3668,2249
1976,254,131,123,113,86,26,11,9,9,0,621,254
1977,68,53,15,12,16,7,8,11,14,4,160,72
1978,461,421,40,190,147,20,29,41,34,0,632,461
1979,0,0,0,0,0,0,0,0,0,85,0,85
1980,904,719,185,191,147,90,128,188,160,15,1940,919
1981,405,301,104,57,91,62,54,52,89,0,994,405
1982,763,677,86,228,200,101,75,58,101,0,2044,763
1983,1447,1073,374,172,246,199,154,213,463,0,3567,1447
1984,396,294,102,56,89,61,53,51,86,0,920,396
1985,473,234,239,128,169,68,56,30,22,46,1462,519
1986,447,360,87,41,56,78,63,103,106,0,1061,447
1987,443,316,127,52,68,61,53,73,136,0,1162,443
1988,383,261,122,83,80,82,35,65,38,0,987,383
1989,399,202,197,85,94,74,65,60,21,0,1525,399
1990,539,321,218,169,143,80,66,52,29,33,1575,572
1991,532,366,166,94,100,101,85,116,36,5,1677,537
1992,308,156,152,66,72,57,50,47,16,0,1218,308
1993,604,402,202,150,134,120,79,76,45,10,1804,614
1994,1097,968,129,156,124,166,152,229,270,4,2007,1101
1995,631,550,81,145,142,92,78,84,90,0,1292,631
1996,683,510,173,172,190,144,103,54,20,0,1979,683
1997,225,197,28,27,21,37,45,25,70,4,525,229
1998,987,860,127,227,222,144,122,131,141,0,1757,987
1999,858,747,111,198,193,125,106,114,122,0,1446,858
2000,713,533,180,179,199,151,107,57,20,0,1648,713
2001,589,440,149,148,164,125,88,47,17,0,1483,589
2002,424,317,107,107,118,90,64,34,11,7,1102,431
2003,274,160,114,12,13,17,14,35,183,0,782,274
2004,706,645,61,197,199,86,88,47,89,14,1489,720
2005,514,470,44,143,145,62,64,34,66,114,1046,628
2006,367,304,63,90,85,44,54,54,40,411,945,778
2007,521,416,105,79,63,79,62,103,135,0,1219,521
2008,653,519,134,145,146,96,91,103,72,23,1532,676
2009,609,433,176,212,190,73,64,41,29,417,1442,1026
2010,1034,706,328,78,120,126,121,154,435,0,2659,1034
2011,394,274,120,67,75,68,43,62,79,0,1014,394
2012,542,378,164,92,103,93,59,85,110,5,1440,547
2013,415,219,196,100,106,73,57,62,17,15,1163,430
2014,433,281,152,100,101,75,49,67,41,0,1331,433
2015,365,251,114,65,69,69,58,79,25,0,1173,365
2016,301,200,101,75,67,60,39,38,22,0,839,301
2017,423,213,210,110,132,62,63,34,22,8,1630,431
2018,485,244,241,126,152,71,72,39,25,5,1804,490
2019,342,122,220,100,117,46,45,30,4,13,1461,355
2020,156,90,66,60,48,20,13,9,6,8,371,164
2021,0,0,0,0,0,0,0,0,0,0,0,0
2022,353,271,82,44,68,58,52,62,69,0,765,353
2023,681,564,117,61,98,125,121,137,139,4,1525,685
2024,494,369,125,124,138,104,74,39,15,0,1119,494
2025,372,187,185,97,117,54,55,30,19,12,1468,384
2026,287,144,143,75,90,42,43,23,14,9,1099,296
2027,725,452,273,196,214,104,106,72,33,0,2178,725
2028,440,275,165,119,130,63,64,43,21,75,1374,515
2029,322,205,117,74,82,61,40,42,23,9,1136,331
2030,546,347,199,126,138,104,68,71,39,0,1690,546
2031,593,377,216,137,150,112,74,77,43,0,1647,593
2032,335,213,122,77,85,64,42,43,24,0,896,335
2033,424,270,154,98,107,80,53,55,31,33,1230,457
2034,424,270,154,98,107,80,53,55,31,0,1378,424
2035,379,245,134,13,15,29,32,49,241,0,1066,379
2036,448,392,56,61,63,92,60,95,77,37,979,485
2037,422,337,85,64,51,64,50,84,109,0,842,422
2038,423,301,122,147,132,51,44,28,21,8,1036,431
2039,292,233,59,44,35,45,35,58,75,0,535,292
2040,819,733,86,109,91,180,145,177,117,0,1524,819
2041,421,369,52,57,59,87,56,89,73,109,900,530
2042,710,383,327,280,229,75,68,38,20,0,2468,710
2043,681,357,324,158,174,110,115,118,6,59,2458,740
2044,538,281,257,133,134,102,90,57,22,32,1876,570
2045,411,266,145,95,96,71,47,64,38,0,1096,411
2046,361,190,171,87,92,64,49,54,15,0,1236,361
2047,342,238,104,58,65,59,37,53,70,0,882,342
2048,411,206,205,130,140,63,39,26,13,0,1238,411
2049,532,287,245,210,172,56,51,28,15,0,1653,532
2050,300,138,162,96,86,38,39,24,17,75,1179,375
2051,589,296,293,135,177,74,93,74,36,15,2072,604
2052,0,0,0,0,0,0,0,0,0,203,0,203
2053,555,354,201,113,118,102,94,87,41,0,1984,555
2054,439,280,159,89,93,81,74,69,33,0,1267,439
2055,559,357,202,114,119,103,94,87,42,0,1706,559
2056,247,158,89,50,52,45,42,39,19,0,851,247
2057,246,157,89,50,52,45,42,38,19,0,897,246
2058,280,179,101,57,59,51,47,44,22,0,873,280
2059,276,99,177,81,94,37,36,25,3,4,1147,280
2060,159,90,69,35,38,25,24,23,14,0,492,159
2061,467,320,147,134,126,57,48,56,46,1,1250,468
2062,274,187,87,79,74,34,28,33,26,0,673,274
2063,362,258,104,126,113,44,38,24,17,3881,980,4243
2064,271,115,156,67,74,46,46,30,8,0,933,271
2065,499,282,217,137,180,53,67,48,14,29,1679,528
2066,446,252,194,122,161,47,60,43,13,3,1637,449
2067,663,613,50,217,153,56,51,60,126,279,1013,942
2068,382,304,78,81,62,38,54,80,67,6,773,388
2069,712,484,228,154,149,152,66,120,71,0,1928,712
2070,304,160,144,73,78,54,41,46,12,0,1099,304
2071,364,217,147,114,97,54,45,35,19,0,1073,364
2072,416,192,224,106,110,84,60,35,21,2,1480,418
2073,431,229,202,134,132,54,43,36,32,0,1212,431
2074,278,148,130,86,85,35,28,23,21,0,870,278
2075,243,87,156,59,67,33,31,34,19,0,1055,243
2076,699,615,84,78,82,143,96,128,172,6,1164,705
2077,487,327,160,45,69,78,60,82,153,28,1253,515
2078,625,496,129,176,197,68,73,44,67,11,1662,636
2079,334,237,97,89,84,59,42,26,34,5,831,339
2080,476,338,138,127,119,85,60,38,47,52,1217,528
2081,326,192,134,62,53,62,42,74,33,0,873,326
2082,403,144,259,97,111,55,51,56,33,1,1724,404
2083,596,214,382,144,164,82,76,83,47,5,2471,601
2084,444,159,285,130,152,60,58,40,4,0,1636,444
2085,225,95,130,56,61,39,38,25,6,0,775,225
2086,330,127,203,89,85,60,52,37,7,39,1204,369
2087,306,224,82,38,39,59,40,67,63,13,1007,319
2088,703,546,157,93,125,122,104,102,157,7,1621,710
2089,707,600,107,282,224,65,45,57,34,2,1520,709
2090,323,299,24,78,72,54,42,35,42,14,516,337
2091,0,0,0,0,0,0,0,0,0,76,0,76
2092,522,201,321,141,134,95,83,59,10,0,1909,522
2093,258,227,31,29,30,53,35,47,64,0,671,258
2094,247,125,122,53,58,46,40,37,13,0,939,247
2095,559,358,201,46,50,53,40,83,287,0,1646,559
2096,350,162,188,89,93,71,50,29,18,0,1241,350
2097,314,229,85,39,40,60,41,69,65,0,908,314
2098,457,258,199,117,124,45,56,59,56,31,1652,488
2099,245,158,87,8,10,19,21,32,155,0,619,245
2100,723,633,90,98,102,149,97,153,124,0,1330,723
2101,359,314,45,49,50,74,48,76,62,0,750,359
2102,1281,1170,111,528,408,57,79,115,94,78,2453,1359
2103,854,761,93,127,100,160,122,176,169,5,1504,859
2104,450,325,125,93,108,89,58,59,43,0,1216,450
2105,239,120,119,76,81,37,23,15,7,0,819,239
2106,650,594,56,181,183,79,81,43,83,8,1150,658
2107,360,257,103,42,55,50,43,59,111,0,803,360
2108,766,568,198,91,130,105,82,113,245,0,1704,766
2109,563,402,161,66,86,78,67,92,174,0,1296,563
2110,317,211,106,79,70,63,41,40,24,0,906,317
2111,416,254,162,111,111,66,52,36,40,0,1259,416
2112,242,148,94,64,64,38,30,21,25,11,823,253
2113,373,281,92,46,45,29,39,52,162,0,865,373
2114,390,275,115,29,27,43,28,43,220,0,1095,390
2115,0,0,0,0,0,0,0,0,0,0,0,0
2116,426,256,170,62,106,52,30,31,145,0,1129,426
2117,581,432,149,82,130,89,78,74,128,0,1572,581
2118,407,278,129,31,47,50,48,61,170,0,981,407
2119,614,511,103,146,116,84,77,98,93,1,1766,615
2120,98,88,10,27,24,9,9,18,11,132,111,230
2121,331,274,57,82,76,40,49,49,35,0,830,331
2122,325,270,55,80,75,39,48,48,35,0,823,325
2123,436,308,128,32,30,48,31,48,247,0,1147,436
2124,654,493,161,117,127,117,93,90,110,0,1261,654
2125,22,16,6,3,2,1,1,5,10,17,40,39
2126,188,171,17,13,12,8,19,28,108,38,247,226
2127,503,405,98,46,63,88,71,116,119,0,1257,503
2128,313,252,61,28,39,55,44,72,75,0,684,313
2129,1096,902,194,169,234,211,185,193,104,0,2200,1096
2130,608,472,136,80,108,106,90,88,136,0,1320,608
2131,550,427,123,73,98,95,82,79,123,0,1266,550
2132,505,339,166,47,71,81,62,85,159,0,1418,505
2133,571,443,128,115,124,105,89,89,49,0,1222,571
2134,283,210,73,40,64,43,38,36,62,27,726,310
2135,1133,869,264,142,217,187,168,197,222,5,2411,1138
2136,278,208,70,31,41,41,42,55,68,0,783,278
2137,554,417,137,68,67,42,58,77,242,0,1347,554
2138,460,325,135,34,32,50,33,51,260,0,1104,460
2139,234,132,102,60,63,23,29,30,29,0,522,234
2140,1018,912,106,136,113,224,180,220,145,0,1790,1018
2141,898,800,98,133,105,169,128,185,178,12,1622,910
2142,391,344,47,44,46,80,54,72,95,10,645,401
2143,620,529,91,94,91,109,99,110,117,0,1292,620
2144,373,289,84,75,81,69,58,58,32,14,1065,387
2145,353,274,79,71,77,65,55,55,30,0,959,353
2146,280,168,112,76,80,34,35,33,22,0,973,280
2147,386,249,137,13,16,30,33,50,244,0,1071,386
2148,260,190,70,57,40,41,36,33,53,0,755,260
2149,404,243,161,109,115,49,50,48,33,0,1406,404
2150,330,195,135,70,86,73,57,28,16,23,891,353
2151,509,404,105,144,161,55,60,36,53,0,1129,509
2152,342,145,197,85,93,59,58,38,9,0,1212,342
2153,1936,1790,146,635,446,163,150,174,368,31,3327,1967
2154,996,895,101,276,215,145,106,115,139,26,1634,1022
2155,611,415,196,106,95,100,64,70,176,2,1306,613
2156,545,414,131,78,86,71,65,108,137,10,1318,555
2157,338,257,81,49,54,44,40,67,84,0,773,338
2158,372,265,107,50,57,44,40,75,106,0,937,372
2159,257,195,62,37,41,34,31,51,63,0,576,257
2160,401,319,82,89,90,59,56,63,44,0,1012,401
2161,392,311,81,87,88,57,55,62,43,0,994,392
2162,1098,987,111,304,237,160,117,126,154,18,1982,1116
2163,381,342,39,106,82,56,40,44,53,0,739,381
2164,468,420,48,130,101,68,50,54,65,0,752,468
2165,615,553,62,170,132,90,65,71,87,24,1092,639
2166,2061,1769,292,314,384,410,307,378,268,46,3912,2107
2167,566,526,40,98,83,104,99,109,73,18,948,584
2168,937,871,66,162,138,173,163,180,121,0,1525,937
2169,386,359,27,67,57,71,67,74,50,0,753,386
2170,786,730,56,136,116,145,137,151,101,0,1289,786
2171,1093,965,128,156,123,165,151,228,270,0,1567,1093
2172,385,340,45,55,43,58,53,80,96,0,567,385
2173,436,309,127,105,92,60,64,95,20,2,1431,438
2174,396,183,213,127,113,50,51,32,23,0,1652,396
2175,299,218,81,37,38,57,39,65,63,6,914,305
2176,767,530,237,93,105,165,104,144,156,8,2003,775
2177,438,320,118,54,55,84,57,96,92,0,1206,438
2178,701,533,168,101,111,92,83,139,175,0,1615,701
2179,486,315,171,112,113,84,55,75,47,0,1208,486
2180,730,550,180,90,88,56,76,101,319,2,1668,732
2181,413,248,165,112,117,50,51,49,34,0,1296,413
2182,689,591,98,105,128,137,103,126,90,0,1425,689
2183,240,144,96,65,68,29,30,28,20,0,809,240
2184,513,447,66,118,115,75,64,68,73,1,924,514
2185,466,235,231,121,146,68,69,37,25,0,1645,466
2186,489,242,247,132,175,71,58,31,22,0,1805,489
2187,249,135,114,67,64,35,36,33,14,9,975,258
2188,556,347,209,150,164,80,81,55,26,0,1780,556
2189,0,0,0,0,0,0,0,0,0,0,0,0
2190,359,175,184,83,84,56,66,57,13,4,1518,363
2191,258,184,74,34,40,30,28,52,74,0,680,258
2192,322,218,104,29,29,38,36,81,109,25,829,347
2193,404,288,116,54,62,48,43,82,115,0,1076,404
2194,315,218,97,38,43,68,43,59,64,0,844,315
2195,448,303,145,41,40,53,50,112,152,0,1151,448
2196,283,192,91,26,25,33,31,71,97,4,775,287
2197,254,209,45,39,54,49,43,45,24,0,551,254
2198,330,188,142,53,53,48,30,84,62,0,807,330
2199,343,179,164,85,85,65,57,36,15,9,1344,352
2200,331,231,100,56,63,57,36,52,67,0,834,331
2201,318,226,92,77,67,44,46,69,15,2,1020,320
2202,432,244,188,119,156,46,58,42,11,14,1631,446
2203,251,131,120,62,63,47,42,27,10,9,923,260
2204,455,240,215,110,116,80,62,68,19,0,1718,455
2205,97,52,45,38,31,10,9,5,4,0,238,97
2206,653,328,325,207,222,100,62,42,20,0,2244,653
2207,669,455,214,145,140,143,62,113,66,0,1686,669
2208,1355,1109,246,85,86,207,220,273,484,0,3186,1355
2209,460,212,248,147,131,58,59,37,28,0,1546,460
2210,401,206,195,178,137,41,17,15,13,2,1052,403
2211,357,137,220,96,91,65,56,41,8,0,1085,357
2212,249,115,134,63,66,50,36,21,13,0,865,249
2213,390,343,47,44,46,80,53,71,96,0,647,390
2214,250,116,134,64,66,50,36,21,13,0,958,250
2215,340,131,209,92,87,62,54,39,6,0,1133,340
2216,1593,1325,268,379,302,217,199,253,243,46,2977,1639
2217,638,294,344,204,182,80,82,52,38,0,2157,638
2218,394,210,184,122,121,49,40,33,29,0,1231,394
2219,391,181,210,99,104,79,56,33,20,0,1364,391
2220,421,290,131,74,79,80,67,92,29,0,1176,421
2221,568,290,278,202,181,74,58,46,7,116,1872,684
2222,352,186,166,85,90,62,48,53,14,0,1185,352
2223,418,220,198,101,107,74,57,63,16,0,1292,418
2224,435,371,64,66,64,77,70,77,81,12,982,447
2225,472,403,69,72,69,83,75,84,89,0,1094,472
2226,98,93,5,35,29,14,8,7,5,0,284,98
2227,570,411,159,118,136,113,74,75,54,10,1544,580
2228,660,564,96,100,96,117,105,117,125,0,1191,660
2229,311,201,110,10,13,24,26,40,198,0,861,311
2230,466,346,120,55,79,64,50,69,149,0,1237,466
2231,388,226,162,17,19,25,19,50,258,0,1124,388
2232,454,232,222,162,145,59,46,37,5,5,1436,459
2233,420,374,46,62,49,79,60,87,83,17,798,437
2234,247,128,119,66,69,44,33,21,14,0,753,247
2235,457,358,99,82,108,48,55,76,88,0,1190,457
2236,484,357,127,75,64,56,51,90,148,0,990,484
2237,579,282,297,134,136,90,107,91,21,0,2087,579
2238,265,171,94,9,11,21,22,34,168,0,710,265
2239,421,311,110,65,56,48,44,78,130,0,870,421
2240,293,124,169,73,80,50,50,33,7,8,948,301
2241,531,440,91,48,77,97,94,107,108,4,1090,535
2242,406,327,79,37,51,71,57,94,96,0,1012,406
2243,443,357,86,40,56,78,62,102,105,79,956,522
2244,606,357,249,115,99,116,78,138,60,126,1655,732
2245,281,212,69,50,55,50,40,39,47,0,730,281
2246,503,362,141,125,113,102,85,47,31,0,1473,503
2247,277,215,62,56,60,51,43,43,24,0,865,277
2248,320,180,140,82,87,31,39,41,40,7,1101,327
2249,429,324,105,77,83,76,61,59,73,0,1163,429
2250,466,335,131,115,104,94,79,43,31,15,1105,481
2251,384,276,108,95,86,77,65,36,25,0,1160,384
2252,386,285,101,60,51,44,41,72,118,0,865,386
2253,565,417,148,87,75,65,60,105,173,0,1195,565
2254,487,355,132,106,76,76,68,63,98,37,1318,524
2255,365,189,176,98,102,65,49,31,20,0,1263,365
2256,410,263,147,34,37,39,29,61,210,0,1115,410
2257,703,451,252,58,63,67,50,104,361,0,2140,703
2258,321,181,140,82,87,31,39,42,40,4,1004,325
2259,615,417,198,107,95,101,64,71,177,0,1417,615
2260,476,247,229,128,134,85,64,41,24,0,1347,476
2261,294,153,141,79,83,52,39,25,16,0,1023,294
2262,320,158,162,86,115,46,38,20,15,0,1084,320
2263,295,160,135,79,76,42,42,39,17,38,1091,333
2264,356,193,163,96,92,50,51,46,21,0,999,356
2265,405,240,165,85,105,89,71,35,20,0,1120,405
2266,287,155,132,77,74,41,41,37,17,0,1008,287
2267,260,162,98,70,77,37,38,26,12,0,884,260
2268,450,266,184,95,117,99,78,39,22,0,1381,450
2269,406,263,143,94,95,70,46,63,38,17,1165,423
2270,473,280,193,100,123,104,82,41,23,0,1525,473
2271,317,187,130,67,82,70,55,27,16,4,929,321
2272,696,375,321,274,225,73,67,37,20,0,1986,696
2273,462,261,201,127,167,49,62,45,12,0,1864,462
2274,132,78,54,8,10,15,11,18,70,149,207,281
2275,101,60,41,6,8,12,8,14,53,0,243,101
2276,684,616,68,186,165,64,66,124,79,52,1374,736
2277,1054,1002,52,375,309,145,89,75,61,41,1310,1095
2278,51,47,4,12,11,9,7,6,6,47,79,98
2279,228,135,93,87,70,32,16,13,10,36,643,264
2280,543,320,223,206,168,76,38,30,25,5,1191,548
2281,57,39,18,5,5,7,6,14,20,6,163,63
2282,119,67,52,30,32,12,15,15,15,3,333,122
2283,821,640,181,60,56,57,48,108,492,0,1905,821
2284,839,630,209,57,45,67,63,99,508,0,2042,839
2285,1243,924,319,82,79,107,101,209,665,0,3006,1243
2286,590,402,188,38,33,59,56,105,299,0,1552,590
2287,1632,1193,439,110,124,133,133,261,871,23,3891,1655
2288,954,752,202,82,74,116,93,127,462,0,2207,954
2289,491,318,173,87,87,64,57,75,121,0,1100,491
2290,705,585,120,99,119,111,88,87,201,36,1630,741
2291,145,94,51,50,37,8,10,6,34,1185,375,1330
2292,263,190,73,59,54,45,29,33,43,1105,625,1368
2293,514,274,240,190,149,58,27,61,29,1083,1341,1597
2294,250,133,117,92,73,28,13,30,14,629,803,879
2295,524,366,158,183,179,63,37,20,42,112,1279,636
2296,261,196,65,47,35,34,26,40,79,6,616,267
2297,701,456,245,75,90,130,96,96,214,20,1684,721
2298,191,130,61,28,39,32,21,24,47,0,396,191
2299,421,294,127,147,144,51,29,16,34,2,946,423
2300,15,13,2,2,2,2,2,3,4,0,17,15
2301,281,253,28,46,39,39,35,47,75,0,423,281
2302,236,212,24,39,33,33,29,40,62,0,316,236
2303,110,99,11,18,15,15,14,18,30,0,170,110
2304,571,308,263,78,91,77,75,88,162,0,1500,571
2305,371,241,130,65,65,49,43,56,93,0,942,371
2306,609,502,107,89,93,106,86,77,158,0,1421,609
2307,399,306,93,70,70,67,52,40,100,0,916,399
2308,358,232,126,63,63,47,42,54,89,7,1036,365
2309,385,271,114,77,76,54,41,42,95,0,1046,385
2310,206,162,44,28,30,37,32,34,45,8,406,214
2311,629,408,221,111,111,82,73,96,156,94,1761,723
2312,366,286,80,53,46,48,52,84,83,0,965,366
2313,319,249,70,47,41,42,45,74,70,0,741,319
2314,331,297,34,54,46,46,41,56,88,0,497,331
2315,977,878,99,161,136,135,120,164,261,0,2002,977
2316,1636,1470,166,269,227,226,201,275,438,2,2993,1638
2317,1998,1796,202,329,278,277,246,336,532,0,3660,1998
2318,802,711,91,298,243,59,38,62,102,1,1986,803
2319,512,409,103,88,75,73,48,67,161,0,1186,512
2320,221,166,55,12,16,24,25,41,103,0,531,221
2321,887,708,179,152,130,127,82,117,279,38,1729,925
2322,934,729,205,136,119,122,133,215,209,124,2176,1058
2323,345,297,48,41,44,45,58,45,112,12,711,357
2324,330,285,45,40,42,43,55,43,107,0,695,330
2325,462,360,102,28,33,55,39,41,266,0,1118,462
2326,534,414,120,74,64,66,56,94,180,13,1199,547
2327,478,362,116,90,91,83,73,64,77,2,1042,480
2328,732,658,74,120,102,101,90,123,196,60,1153,792
2329,267,206,61,61,63,31,36,41,35,0,659,267
2330,456,351,105,104,107,53,61,70,61,159,1227,615
2331,409,321,88,75,76,73,57,52,76,0,969,409
2332,335,270,65,70,56,53,44,46,66,134,810,469
2333,325,250,75,74,76,38,44,50,43,14,841,339
2334,408,208,200,22,30,52,40,65,199,4,1076,412
2335,545,420,125,124,128,63,73,83,74,0,1410,545
2336,382,288,94,69,51,49,38,59,116,0,903,382
2337,688,581,107,98,89,100,92,108,201,3,1633,691
2338,701,621,80,260,213,52,34,54,88,68,1677,769
2339,1071,864,207,223,180,169,140,147,212,0,2376,1071
2340,474,297,177,97,148,60,39,44,86,69,1369,543
2341,61,41,20,9,13,10,7,8,14,0,165,61
2342,404,301,103,92,59,30,53,39,131,590,952,994
2343,588,546,42,124,116,104,67,52,125,0,1315,588
2344,298,277,21,63,59,53,34,26,63,0,581,298
2345,0,0,0,0,0,0,0,0,0,3,0,3
2346,571,443,128,79,69,70,60,100,193,0,1303,571
2347,679,602,77,252,206,50,33,52,86,3,1473,682
2348,310,244,66,27,24,38,30,41,150,8,642,318
2349,514,434,80,73,67,75,69,81,149,12,1152,526
2350,372,277,95,85,54,27,49,36,121,32,945,404
2351,748,580,168,104,90,92,79,131,252,0,1629,748
2352,398,299,99,21,28,43,44,74,188,70,944,468
2353,580,452,128,35,42,69,49,52,333,0,1271,580
2354,199,142,57,75,63,28,10,13,10,3909,453,4108
2355,1134,768,366,205,185,126,115,162,341,0,2856,1134
2356,250,164,86,45,49,33,29,36,58,0,755,250
2357,486,346,140,31,42,65,51,71,226,0,1178,486
2358,332,169,163,18,25,43,32,53,161,0,924,332
2359,340,222,118,62,66,45,40,49,78,38,974,378
2360,295,167,128,39,47,41,33,38,97,0,751,295
2361,251,138,113,15,22,36,32,49,97,0,688,251
2362,423,300,123,48,55,61,51,73,135,2,968,425
2363,430,305,125,49,56,62,52,74,137,0,1073,430
2364,391,222,169,52,63,55,44,51,126,0,993,391
2365,346,187,159,47,55,46,45,53,100,0,936,346
2366,468,239,229,26,35,60,45,74,228,5,1330,473
2367,430,320,110,28,27,37,35,72,231,0,993,430
2368,457,259,198,61,73,64,52,60,147,5,1193,462
2369,662,471,191,42,57,88,70,97,308,0,1617,662
2370,536,445,91,75,91,84,67,66,153,1,1173,537
2371,293,212,81,37,30,24,25,43,134,0,735,293
2372,462,380,82,89,95,64,56,44,114,0,1072,462
2373,619,447,172,140,127,106,69,77,100,21,1350,640
2374,724,596,128,139,149,100,88,69,179,2,1689,726
2375,911,846,65,192,179,161,104,81,194,5,1654,916
2376,253,180,73,29,33,36,31,44,80,0,587,253
2377,540,445,95,76,87,66,83,101,127,0,1106,540
2378,815,625,190,143,142,137,106,81,206,4,1523,819
2379,329,252,77,58,57,55,43,33,83,25,855,354
2380,423,324,99,74,74,71,55,42,107,0,984,423
2381,270,144,126,100,78,31,14,32,15,207,686,477
2382,507,343,164,92,82,57,52,72,152,0,1204,507
2383,620,388,232,126,193,79,50,57,115,0,1686,620
2384,372,309,63,52,63,58,47,46,106,11,764,383
2385,739,610,129,108,113,128,105,94,191,15,1660,754
2386,393,279,114,45,51,56,48,68,125,0,903,393
2387,251,196,55,15,18,30,21,23,144,0,618,251
2388,523,431,92,74,85,64,80,98,122,59,1171,582
2389,364,286,78,49,52,65,56,61,81,97,834,461
2390,235,189,46,49,39,37,31,32,47,18,644,253
2391,292,191,101,53,57,38,34,42,68,0,848,292
2392,167,148,19,41,42,25,18,9,32,12,381,179
2393,216,192,24,53,54,32,23,12,42,29,552,245
2394,379,287,92,71,72,66,58,51,61,0,929,379
2395,660,545,115,96,101,114,93,84,172,122,1434,782
2396,292,212,80,37,30,24,24,43,134,0,683,292
2397,551,454,97,106,114,76,67,53,135,0,1119,551
2398,533,397,136,122,78,39,70,51,173,0,1393,533
2399,147,105,42,56,46,21,7,10,7,1370,265,1517
2400,287,158,129,17,26,41,37,57,109,0,831,287
2401,771,549,222,291,243,109,38,51,39,462,1840,1233
2402,836,604,232,189,172,143,93,104,135,581,1591,1417
2403,538,444,94,76,87,66,82,101,126,6,1262,544
2404,272,242,30,67,68,40,29,15,53,1,550,273
2405,458,323,135,91,91,64,49,51,112,0,1163,458
2406,386,252,134,70,75,51,45,55,90,81,1063,467
2407,828,539,289,88,107,154,114,113,252,0,2086,828
2408,300,237,63,26,23,37,29,40,145,0,685,300
2409,484,345,139,31,42,64,51,71,225,0,1226,484
2410,416,229,187,25,37,60,54,82,158,0,1154,416
2411,450,293,157,48,58,84,62,61,137,1,1185,451
2412,717,564,153,132,133,127,99,91,135,0,1648,717
2413,12,8,4,2,2,2,1,1,4,0,20,12
2414,451,351,100,33,31,31,27,60,269,2,1115,453
2415,0,0,0,0,0,0,0,0,0,0,0,0
2416,138,100,38,17,14,11,12,20,64,0,332,138
2417,184,133,51,23,19,15,15,27,85,0,460,184
2418,220,156,64,25,28,32,27,38,70,3,475,223
2419,268,182,86,40,55,45,29,33,66,0,517,268
2420,270,183,87,40,55,45,30,34,66,0,528,270
2421,0,0,0,0,0,0,0,0,0,7,0,7
2422,252,226,26,41,35,35,31,42,68,0,312,252
2423,415,290,125,145,142,50,29,16,33,0,1028,415
2424,187,131,56,65,64,23,13,7,15,2,483,189
2425,404,282,122,141,138,49,28,15,33,128,1164,532
2426,268,191,77,101,85,38,13,18,13,0,664,268
2427,196,174,22,48,49,29,21,11,38,58,429,254
2428,225,200,25,55,56,33,24,13,44,0,495,225
2429,63,56,7,15,16,9,7,4,12,0,140,63
2430,141,125,16,35,35,21,15,8,27,0,227,141
2431,152,135,17,37,38,22,16,8,31,0,335,152
2432,165,107,58,29,29,22,19,25,41,21,435,186
2433,105,69,36,19,21,14,12,15,24,0,296,105
2434,198,156,42,27,29,35,31,33,43,0,458,198
2435,94,74,20,13,14,17,15,16,19,0,199,94
2436,45,29,16,8,9,6,5,6,11,11,100,56
2437,88,68,20,20,21,10,12,13,12,0,262,88
2438,109,84,25,25,26,13,15,17,13,0,277,109
2439,73,56,17,17,17,8,10,11,10,0,212,73
2440,97,75,22,22,23,11,13,15,13,0,250,97
2441,220,165,55,12,16,24,25,41,102,0,490,220
2442,199,159,40,34,29,28,18,26,64,0,458,199
2443,673,537,136,115,99,96,63,89,211,0,1415,673
2444,189,151,38,32,28,27,18,25,59,107,379,296
2445,0,0,0,0,0,0,0,0,0,0,0,0
2446,0,0,0,0,0,0,0,0,0,0,0,0
2447,0,0,0,0,0,0,0,0,0,0,0,0
2448,654,393,261,96,163,80,45,48,222,0,2041,654
2449,0,0,0,0,0,0,0,0,0,0,0,0
2450,128,86,42,12,18,21,16,22,39,0,472,128
2451,259,174,85,24,37,42,32,44,80,0,756,259
2452,118,79,39,11,17,19,14,20,37,0,285,118
2453,0,0,0,0,0,0,0,0,0,0,0,0
2454,13,9,4,1,1,1,1,3,6,0,26,13
2455,41,37,4,3,3,2,4,6,23,4,170,45
2456,0,0,0,0,0,0,0,0,0,0,0,0
2457,141,125,16,42,37,19,14,11,18,5,428,146
2458,0,0,0,0,0,0,0,0,0,2,0,2
2459,6,5,1,2,2,1,1,0,0,0,11,6
2460,0,0,0,0,0,0,0,0,0,0,0,0
2461,90,82,8,6,6,4,9,14,51,3,123,93
2462,25,17,8,4,5,4,3,3,6,294,87,319
2463,29,20,9,4,6,5,3,4,7,0,122,29
2464,13,9,4,2,3,2,1,2,3,1,21,14
2465,1155,604,551,334,329,197,149,87,59,36,3247,1191
2466,511,379,132,50,79,87,76,114,105,0,1348,511
2467,1280,854,426,193,354,238,212,225,58,0,4076,1280
2468,639,337,302,184,249,88,48,62,8,0,1757,639
2469,1086,783,303,95,106,86,90,153,556,0,2580,1086
2470,849,607,242,36,59,111,103,163,377,0,2336,849
2471,1138,701,437,241,274,150,152,187,134,7,3244,1145
2472,1460,973,487,128,184,222,214,325,387,5,3657,1465
2473,1732,1139,593,211,270,304,279,275,393,15,5164,1747
2474,1494,1120,374,178,235,280,246,339,216,0,3201,1494
2475,3653,2612,1041,342,464,561,597,803,886,41,10233,3694
2476,1523,1075,448,211,282,256,240,300,234,24,4213,1547
2477,1244,918,326,148,197,267,244,297,91,7,3240,1251
2478,3107,2187,920,289,427,413,422,644,912,44,8883,3151
2479,1766,1166,600,249,285,294,265,265,408,5,5040,1771
2480,1191,896,295,103,168,237,206,271,206,0,3143,1191
2481,866,487,379,102,189,142,167,130,136,6,2642,872
2482,564,370,194,151,209,76,51,43,34,14,1486,578
2483,1029,724,305,157,268,189,157,148,110,3,2689,1032
2484,1549,1015,534,233,289,329,207,267,224,3,4873,1552
2485,1006,900,106,116,123,157,131,179,300,2,1777,1008
2486,1652,1359,293,212,286,291,212,329,322,0,2920,1652
2487,540,378,162,30,39,62,56,86,267,0,1352,540
2488,333,246,87,26,39,40,31,47,150,0,814,333
2489,399,277,122,24,36,42,51,93,153,0,1432,399
2490,539,284,255,156,210,74,41,53,5,193,1897,732
2491,626,303,323,167,219,105,64,47,24,14,2325,640
2492,1570,1046,524,138,198,239,230,349,416,0,4650,1570
2493,419,279,140,37,53,64,61,93,111,0,1163,419
2494,429,297,132,26,38,46,55,100,164,0,1545,429
2495,616,413,203,42,59,104,113,171,127,0,1687,616
2496,403,270,133,27,38,68,74,112,84,0,1204,403
2497,434,254,180,72,104,106,69,51,32,0,1508,434
2498,512,300,212,85,123,125,81,60,38,6,1888,518
2499,336,197,139,56,80,82,53,39,26,0,1092,336
2500,843,462,381,127,210,196,143,128,39,0,3210,843
2501,363,215,148,101,117,54,35,44,12,5,1045,368
2502,1218,723,495,338,393,181,117,147,42,0,3465,1218
2503,649,526,123,80,91,153,92,116,117,0,1555,649
2504,778,631,147,96,109,184,110,140,139,5,1863,783
2505,423,305,118,47,63,51,45,106,111,0,1120,423
2506,454,327,127,50,68,55,48,114,119,0,1092,454
2507,443,249,194,52,97,73,85,67,69,6,1803,449
2508,907,604,303,80,115,138,133,202,239,0,1957,907
2509,463,183,280,94,149,86,58,61,15,124,1937,587
2510,323,214,109,20,25,33,34,64,147,0,882,323
2511,988,658,330,87,125,150,145,220,261,0,3578,988
2512,329,235,94,37,33,44,39,51,125,0,768,329
2513,323,233,90,36,48,39,34,81,85,2,753,325
2514,489,352,137,54,73,59,52,123,128,0,1201,489
2515,957,670,287,54,70,110,99,152,472,0,2538,957
2516,246,174,72,47,60,33,31,36,39,0,775,246
2517,221,172,49,25,36,20,17,36,87,0,543,221
2518,569,404,165,56,74,97,75,121,146,0,1417,569
2519,444,365,79,57,77,78,57,88,87,2,1374,446
2520,718,530,188,85,114,154,141,171,53,10,1957,728
2521,1136,744,392,304,421,154,103,87,67,6,3306,1142
2522,714,639,75,83,88,111,93,127,212,1,1315,715
2523,641,339,302,180,217,103,68,53,20,0,2317,641
2524,279,218,61,32,46,26,21,46,108,0,614,279
2525,393,278,115,75,96,53,50,57,62,0,981,393
2526,514,363,151,98,126,70,66,74,80,5,1088,519
2527,257,182,75,49,63,35,33,37,40,0,603,257
2528,347,200,147,44,69,51,45,66,72,6,987,353
2529,263,151,112,34,52,38,34,50,55,9,763,272
2530,475,274,201,61,95,69,61,90,99,0,1188,475
2531,534,379,155,53,70,91,70,113,137,12,1292,546
2532,349,229,120,93,129,47,32,27,21,0,771,349
2533,125,89,36,5,9,16,15,24,56,0,303,125
2534,1695,1159,536,248,311,302,221,315,298,16,6078,1711
2535,582,406,176,131,131,123,78,72,47,0,1068,582
2536,236,161,75,35,43,42,31,44,41,0,409,236
2537,1395,954,441,204,256,248,181,260,246,0,3331,1395
2538,223,150,73,15,21,38,41,62,46,0,726,223
2539,674,452,222,46,64,113,123,188,140,0,2102,674
2540,281,195,86,17,25,30,36,65,108,8,972,289
2541,653,483,170,50,76,78,61,92,296,0,1566,653
2542,2136,1238,898,372,398,307,326,403,330,18,6560,2154
2543,748,511,237,110,137,133,97,139,132,0,2177,748
2544,317,221,96,71,71,67,42,39,27,4,911,321
2545,386,269,117,87,87,82,52,48,30,14,1058,400
2546,618,334,284,121,195,117,88,75,22,0,2159,618
2547,211,114,97,41,66,40,30,26,8,0,780,211
2548,449,243,206,88,141,85,64,55,16,43,1511,492
2549,486,263,223,95,153,92,70,59,17,0,1831,486
2550,362,237,125,55,68,77,48,62,52,0,1140,362
2551,256,171,85,39,71,48,42,45,11,3,962,259
2552,376,251,125,57,104,70,62,66,17,0,1330,376
2553,311,207,104,47,86,58,52,55,13,22,1077,333
2554,373,171,202,60,93,100,58,47,15,0,1455,373
2555,289,132,157,47,72,77,45,37,11,0,1139,289
2556,426,195,231,69,106,114,66,54,17,0,1684,426
2557,477,343,134,125,114,98,67,51,22,0,1420,477
2558,397,285,112,104,95,81,56,43,18,0,993,397
2559,348,250,98,91,83,71,49,37,17,5,854,353
2560,518,372,146,135,124,106,73,56,24,17,1372,535
2561,270,118,152,50,66,59,38,37,20,0,1127,270
2562,439,192,247,81,108,97,62,60,31,6,1883,445
2563,446,195,251,83,109,98,63,61,32,0,1767,446
2564,397,210,187,112,134,64,42,33,12,0,1374,397
2565,339,179,160,95,115,54,36,28,11,0,1139,339
2566,313,166,147,88,106,50,33,26,10,7,841,320
2567,396,209,187,114,154,54,30,39,5,0,1354,396
2568,296,156,140,85,115,41,22,29,4,0,988,296
2569,278,147,131,80,108,38,21,27,4,6,953,284
2570,351,170,181,94,123,59,36,26,13,0,1220,351
2571,396,192,204,106,139,67,40,29,15,6,1303,402
2572,457,222,235,122,160,77,47,34,17,0,1558,457
2573,290,238,52,37,50,51,37,58,57,1,804,291
2574,580,333,247,126,185,130,72,49,18,176,1903,756
2575,453,260,193,98,145,102,56,38,14,22,1519,475
2576,551,316,235,119,176,123,69,46,18,8,1768,559
2577,402,231,171,87,128,90,50,34,13,3,1285,405
2578,982,583,399,273,317,146,94,118,34,11,3088,993
2579,650,386,264,180,210,96,62,78,24,22,1765,672
2580,552,448,104,68,78,130,78,99,99,0,1236,552
2581,830,483,347,69,96,137,176,178,174,32,2936,862
2582,447,275,172,95,108,59,60,74,51,0,1196,447
2583,558,344,214,118,134,74,74,92,66,7,1757,565
2584,847,464,383,127,211,197,143,129,40,0,3014,847
2585,464,357,107,46,54,91,73,105,95,0,1066,464
2586,379,292,87,38,44,74,60,86,77,1,904,380
2587,293,220,73,50,67,51,35,49,41,0,746,293
2588,389,291,98,67,89,68,47,66,52,2,951,391
2589,308,167,141,60,97,58,44,38,11,0,1182,308
2590,318,172,146,62,100,60,46,39,11,0,1178,318
2591,381,250,131,102,141,52,35,29,22,3,1410,384
2592,421,245,176,35,48,69,89,90,90,0,1391,421
2593,239,160,79,16,23,40,44,66,50,0,779,239
2594,493,195,298,100,158,91,62,65,17,0,1838,493
2595,498,197,301,101,160,92,62,66,17,0,1963,498
2596,659,460,199,148,148,140,88,82,53,0,1994,659
2597,286,189,97,17,23,29,30,57,130,2,746,288
2598,293,194,99,18,23,30,31,58,133,0,790,293
2599,420,301,119,47,42,56,49,66,160,12,956,432
2600,581,370,211,117,155,87,69,91,62,0,2125,581
2601,916,584,332,184,244,137,109,144,98,2,2717,918
2602,290,185,105,58,77,43,34,46,32,0,1069,290
2603,703,519,184,84,112,151,138,168,50,6,1729,709
2604,273,202,71,27,42,46,41,61,56,0,695,273
2605,285,211,74,28,44,49,42,63,59,9,731,294
2606,760,418,342,77,121,142,130,157,133,0,2363,760
2607,591,414,177,91,71,141,102,115,71,17,1456,608
2608,1719,1051,668,136,160,301,216,407,499,11,4691,1730
2609,1320,931,389,100,142,129,122,263,564,11,3488,1331
2610,3047,2115,932,253,474,537,480,754,549,12,8714,3059
2611,1352,848,504,69,100,188,168,297,530,0,4021,1352
2612,365,265,100,39,25,41,43,101,116,0,875,365
2613,2067,1566,501,203,481,417,338,358,270,8,5559,2075
2614,1963,1330,633,266,312,336,249,440,360,3,5165,1966
2615,239,164,75,26,32,47,36,53,45,31,604,270
2616,1160,821,339,83,106,122,108,291,450,5,2944,1165
2617,870,620,250,40,61,134,119,224,292,0,2064,870
2618,2534,1792,742,261,288,360,273,508,844,11,6442,2545
2619,1757,1410,347,223,230,279,224,382,419,2,4081,1759
2620,1680,1139,541,195,205,238,202,382,458,89,4380,1769
2621,1598,1040,558,265,341,348,249,283,112,18,4799,1616
2622,567,426,141,81,131,100,84,90,81,0,1380,567
2623,239,180,59,34,55,42,35,38,35,2,604,241
2624,2890,2017,873,214,409,413,400,806,648,0,8337,2890
2625,2160,1415,745,202,247,383,313,592,423,45,5730,2205
2626,1507,1017,490,182,295,208,198,427,197,4,4125,1511
2627,3145,2338,807,442,617,512,466,669,439,13,7843,3158
2628,2943,1300,1643,619,836,594,352,366,176,8,10188,2951
2629,586,453,133,21,59,123,102,140,141,7,1718,593
2630,974,598,376,136,176,131,116,237,178,0,2763,974
2631,314,170,144,32,38,32,17,65,130,0,904,314
2632,3170,2152,1018,233,294,350,291,631,1371,11,8634,3181
2633,1430,956,474,75,118,147,131,195,764,11,3759,1441
2634,2909,1888,1021,177,257,413,322,503,1237,9,8269,2918
2635,1470,995,475,78,122,162,169,277,662,0,4202,1470
2636,1023,653,370,114,137,125,117,266,264,0,2841,1023
2637,106,69,37,18,23,23,17,19,6,76,543,182
2638,548,302,246,55,87,103,94,113,96,0,1880,548
2639,479,368,111,168,123,57,36,47,48,59,864,538
2640,478,346,132,72,90,109,65,68,74,145,978,623
2641,972,780,192,124,127,154,124,211,232,8,2182,980
2642,571,419,152,57,108,118,79,137,72,2,1551,573
2643,809,548,261,109,128,139,103,181,149,0,2212,809
2644,379,268,111,44,49,86,60,80,60,0,891,379
2645,601,435,166,90,114,138,81,86,92,1,1348,602
2646,612,433,179,70,79,140,97,129,97,0,1521,612
2647,706,505,201,70,84,108,82,185,177,0,1780,706
2648,518,371,147,51,62,79,60,136,130,1,1275,519
2649,512,366,146,51,61,78,60,134,128,0,1474,512
2650,782,499,283,88,105,95,89,203,202,0,1624,782
2651,750,459,291,153,282,141,96,75,3,0,1827,750
2652,0,0,0,0,0,0,0,0,0,0,0,0
2653,1370,1100,270,174,179,218,174,298,327,0,2420,1370
2654,1532,1230,302,195,200,243,195,333,366,8,2656,1540
2655,867,480,387,132,292,147,115,118,63,0,3020,867
2656,356,201,155,17,43,55,45,66,130,0,1324,356
2657,2706,1529,1177,132,326,415,341,498,994,0,9849,2706
2658,798,547,251,88,108,156,119,177,150,0,1928,798
2659,1085,760,325,167,131,258,187,211,131,28,2503,1113
2660,457,280,177,93,172,86,59,46,1,0,1278,457
2661,546,349,197,61,73,67,62,142,141,0,1390,546
2662,824,551,273,43,68,85,75,113,440,5,2213,829
2663,717,513,204,71,85,110,84,188,179,19,1921,736
2664,775,548,227,55,71,81,72,194,302,0,2000,775
2665,245,175,70,11,17,38,33,63,83,0,625,245
2666,605,424,181,93,73,144,104,118,73,0,1566,605
2667,1129,735,394,187,241,246,176,200,79,0,2426,1129
2668,1070,969,101,295,354,132,101,106,82,1,2152,1071
2669,477,432,45,131,158,59,45,47,37,36,801,513
2670,560,418,142,58,100,90,88,148,76,30,1469,590
2671,457,341,116,47,82,73,72,121,62,5,1258,462
2672,584,439,145,84,135,103,87,93,82,9,1559,593
2673,594,446,148,85,138,105,88,95,83,20,1393,614
2674,378,284,94,54,88,67,56,60,53,6,1012,384
2675,504,342,162,59,61,71,61,115,137,0,1178,504
2676,685,419,266,140,258,129,88,68,2,0,2186,685
2677,519,287,232,79,175,88,69,71,37,0,1687,519
2678,790,483,307,161,297,149,101,79,3,0,2165,790
2679,327,232,95,28,51,68,61,66,53,19,932,346
2680,413,294,119,36,64,86,77,83,67,0,1137,413
2681,558,394,164,64,72,127,88,118,89,2,1407,560
2682,331,203,128,46,60,45,39,80,61,83,895,414
2683,736,504,232,81,100,144,110,163,138,1,2105,737
2684,675,462,213,74,92,132,101,149,127,0,1929,675
2685,467,332,135,40,73,97,87,94,76,11,1274,478
2686,520,402,118,19,52,109,91,124,125,9,1460,529
2687,133,101,32,13,31,27,22,23,17,0,296,133
2688,89,67,22,9,21,18,15,15,11,14,220,103
2689,1011,766,245,99,235,204,166,175,132,50,2372,1061
2690,384,263,121,42,52,75,57,85,73,0,904,384
2691,295,202,93,33,40,58,44,65,55,2,742,297
2692,1197,764,433,134,160,146,137,311,309,73,3207,1270
2693,570,403,167,41,52,60,53,143,221,5,1616,575
2694,655,467,188,30,46,101,89,169,220,9,1653,664
2695,450,305,145,61,71,77,57,101,83,18,1071,468
2696,556,415,141,58,100,89,87,147,75,10,1692,566
2697,578,431,147,60,104,92,91,153,78,2,1698,580
2698,364,267,97,36,69,75,50,87,47,3,1137,367
2699,567,416,151,57,107,117,78,136,72,13,1782,580
2700,355,260,95,36,67,73,49,85,45,2,1042,357
2701,458,344,114,66,106,81,68,73,64,0,1014,458
2702,896,711,185,99,186,175,141,171,124,0,1633,896
2703,2321,1605,716,168,257,274,190,216,1216,30,5951,2351
2704,2303,1566,737,134,225,293,271,637,743,10,5970,2313
2705,1106,737,369,114,140,129,78,159,486,6,2883,1112
2706,2104,1135,969,105,163,208,199,272,1157,27,6080,2131
2707,1501,1084,417,89,162,150,139,248,713,19,3432,1520
2708,1412,896,516,88,146,175,193,357,453,11,3675,1423
2709,576,403,173,66,87,75,68,108,172,2,1526,578
2710,1452,993,459,63,110,115,131,321,712,7,3864,1459
2711,5669,5665,4,1087,1478,1286,700,614,504,0,7358,5669
2712,800,551,249,49,60,50,71,100,470,1075,2079,1875
2713,597,378,219,31,69,90,68,94,245,0,1799,597
2714,187,118,69,10,22,28,21,29,77,0,615,187
2715,769,368,401,53,61,42,42,97,474,0,2252,769
2716,1727,1081,646,90,139,87,105,217,1089,632,4896,2359
2717,2320,1447,873,207,313,315,249,419,817,0,5934,2320
2718,1140,787,353,69,129,174,128,184,456,0,2827,1140
2719,492,289,203,19,38,42,36,73,284,0,1435,492
2720,1273,886,387,93,115,45,55,127,838,0,3578,1273
2721,1212,700,512,43,84,94,77,157,757,7,3480,1219
2722,276,167,109,14,21,29,20,21,171,0,768,276
2723,738,445,293,26,46,71,48,126,421,0,2113,738
2724,728,550,178,56,103,123,107,138,201,0,1777,728
2725,1840,1245,595,143,275,286,220,230,686,30,4653,1870
2726,866,508,358,34,67,75,63,129,498,0,2532,866
2727,998,792,206,110,207,194,157,190,140,27,1863,1025
2728,863,664,199,99,178,157,115,132,182,7,1718,870
2729,1400,1077,323,160,289,254,187,214,296,0,3041,1400
2730,655,518,137,58,96,103,85,104,209,0,1313,655
2731,422,334,88,37,62,66,55,67,135,0,1119,422
2732,998,789,209,88,147,157,129,159,318,1,2014,999
2733,759,584,175,87,157,138,101,116,160,31,1318,790
2734,1202,908,294,92,169,203,177,228,333,0,2752,1202
2735,1037,702,335,171,206,134,138,125,263,3,2488,1040
2736,572,413,159,34,62,57,53,95,271,0,1561,572
2737,415,328,87,37,61,65,54,66,132,1,847,416
2738,485,373,112,55,100,88,65,74,103,0,1020,485
2739,962,485,477,28,52,74,73,137,598,2,2752,964
2740,286,173,113,14,22,30,21,22,177,0,810,286
2741,441,267,174,22,34,46,32,34,273,0,1273,441
2742,273,185,88,45,54,35,36,33,70,0,767,273
2743,533,361,172,88,106,69,71,64,135,0,1404,533
2744,633,429,204,105,126,82,84,76,160,12,1620,645
2745,1019,713,306,116,154,133,120,191,305,2,2113,1021
2746,765,519,246,40,84,128,96,136,281,25,2032,790
2747,635,431,204,33,69,106,79,113,235,7,1698,642
2748,968,731,237,74,136,163,142,184,269,0,1849,968
2749,272,196,76,16,29,27,25,45,130,10,743,282
2750,606,438,168,36,65,61,56,100,288,0,1635,606
2751,736,467,269,46,76,91,101,186,236,7,1631,743
2752,358,248,110,26,40,42,29,33,188,6,1134,364
2753,438,306,132,50,66,57,52,82,131,0,1079,438
2754,639,382,257,66,112,63,56,89,253,0,1834,639
2755,780,494,286,41,90,118,89,123,319,0,1962,780
2756,742,374,368,21,40,57,56,105,463,16,2161,758
2757,523,313,210,54,91,52,46,73,207,7,1257,530
2758,945,565,380,98,165,94,83,131,374,0,2502,945
2759,927,587,340,49,107,140,106,146,379,0,1914,927
2760,452,216,236,31,36,25,25,57,278,0,1355,452
2761,905,432,473,62,72,50,50,114,557,0,2614,905
2762,563,341,222,28,44,59,41,43,348,3,1651,566
2763,854,594,260,63,77,30,37,85,562,7,1803,861
2764,603,420,183,44,55,21,26,60,397,0,1681,603
2765,441,204,237,17,27,43,27,23,304,0,1239,441
2766,1837,1102,735,107,163,147,176,490,754,19,5968,1856
2767,2235,1195,1040,136,175,254,250,461,959,32,6738,2267
2768,351,159,192,19,24,38,46,81,143,0,1122,351
2769,1718,1100,618,133,164,172,157,326,766,18,4886,1736
2770,1319,856,463,77,133,90,114,167,738,0,3457,1319
2771,13850,6166,7684,824,899,954,1036,1936,8201,137,44542,13987
2772,3906,2439,1467,188,245,330,373,644,2126,7,10654,3913
2773,2240,1516,724,124,150,233,265,579,889,0,5141,2240
2774,2311,1219,1092,159,180,266,268,457,981,0,7225,2311
2775,4058,2444,1614,263,323,463,361,601,2047,17,10985,4075
2776,1158,700,458,74,89,116,130,273,476,0,2762,1158
2777,1881,979,902,58,79,132,123,197,1292,21,5532,1902
2778,2874,2086,788,120,174,346,310,426,1498,4,7473,2878
2779,3975,2170,1805,150,195,344,340,656,2290,6,11296,3981
2780,1286,704,582,50,66,90,97,224,759,0,4249,1286
2781,1118,676,442,72,86,112,126,264,458,0,3231,1118
2782,229,121,108,16,18,26,27,45,97,0,738,229
2783,519,284,235,20,27,36,39,90,307,0,1532,519
2784,395,216,179,15,20,28,30,69,233,7,1256,402
2785,635,384,251,41,49,64,71,150,260,0,1272,635
2786,547,299,248,21,28,38,41,95,324,3,1583,550
2787,333,151,182,18,22,36,44,77,136,1,1057,334
2788,502,228,274,27,34,54,66,116,205,4,1615,506
2789,917,620,297,51,61,95,109,237,364,0,2436,917
2790,1118,590,528,77,87,129,130,221,474,0,2673,1118
2791,469,247,222,32,36,54,54,93,200,0,1416,469
2792,1446,906,540,122,176,169,171,295,513,24,4499,1470
2793,1425,892,533,174,271,292,227,273,188,4,4484,1429
2794,1092,673,419,199,366,233,125,93,76,65,3455,1157
2795,1471,756,715,492,479,259,148,70,23,1,4129,1472
2796,461,269,192,83,113,63,67,91,44,0,1465,461
2797,1506,1109,397,199,348,317,233,198,211,17,4028,1523
2798,355,199,156,43,106,73,56,52,25,3,1275,358
2799,1106,769,337,211,280,102,127,219,167,15,2542,1121
2800,1309,595,714,99,152,125,188,383,362,11,4864,1320
2801,1769,919,850,202,297,221,240,346,463,0,6368,1769
2802,1371,784,587,133,197,183,183,322,353,0,4877,1371
2803,1440,809,631,286,514,295,208,100,37,0,4671,1440
2804,1253,664,589,180,277,296,227,212,61,6,4221,1259
2805,2534,1343,1191,364,560,599,459,429,123,9,7029,2543
2806,632,424,208,145,194,107,80,79,27,8,2007,640
2807,2693,1690,1003,265,440,445,407,588,548,28,8475,2721
2808,909,565,344,95,167,180,152,188,127,15,2745,924
2809,187,116,71,20,34,37,31,39,26,0,639,187
2810,1688,809,879,295,631,300,229,120,113,4,6665,1692
2811,5023,2779,2244,420,688,745,669,1341,1160,66,17287,5089
2812,2137,1149,988,198,322,264,322,469,562,0,7332,2137
2813,1479,795,684,137,223,183,223,324,389,3,4752,1482
2814,5777,3620,2157,486,704,674,684,1179,2050,80,16908,5857
2815,230,144,86,19,28,27,27,47,82,0,668,230
2816,423,244,179,30,76,103,72,84,58,2,1665,425
2817,696,313,383,90,119,98,114,151,124,3,2304,699
2818,225,140,85,24,41,45,38,46,31,0,814,225
2819,999,559,440,121,299,206,158,147,68,0,3412,999
2820,452,226,226,86,97,47,78,98,46,43,1511,495
2821,129,80,49,13,24,26,22,27,17,0,417,129
2822,523,272,251,60,88,65,71,102,137,0,1675,523
2823,1381,621,760,178,236,194,226,299,248,0,5228,1381
2824,536,268,268,103,114,55,92,116,56,7,1205,543
2825,881,440,441,169,188,91,152,190,91,1,2903,882
2826,576,288,288,110,123,59,99,124,61,3,1870,579
2827,1045,475,570,79,121,100,150,306,289,1,3630,1046
2828,918,417,501,70,107,88,132,269,252,0,3125,918
2829,659,329,330,126,141,68,114,142,68,13,1998,672
2830,640,429,211,147,197,108,81,80,27,0,1847,640
2831,762,410,352,71,115,94,115,167,200,6,2500,768
2832,656,383,273,117,161,89,96,130,63,10,2147,666
2833,527,331,196,123,154,108,70,64,8,39,1345,566
2834,981,692,289,168,232,165,107,151,158,29,2633,1010
2835,893,402,491,115,153,125,146,194,160,0,3260,893
2836,451,225,226,86,96,46,78,97,48,0,1457,451
2837,792,471,321,66,106,94,142,240,144,0,2551,792
2838,567,337,230,48,76,67,101,172,103,3,1774,570
2839,1061,571,490,98,160,131,160,233,279,0,3954,1061
2840,506,315,191,53,93,100,85,104,71,29,1723,535
2841,236,114,122,63,77,40,27,16,13,0,765,236
2842,555,268,287,149,182,93,63,38,30,2,1966,557
2843,656,308,348,148,205,109,70,45,79,0,2405,656
2844,292,183,109,68,85,60,39,35,5,9,779,301
2845,423,266,157,98,123,87,56,51,8,97,1118,520
2846,379,238,141,88,110,78,51,46,6,27,1112,406
2847,579,323,256,92,145,108,110,88,36,16,1677,595
2848,500,279,221,79,126,93,95,76,31,4,1472,504
2849,738,412,326,117,185,138,141,112,45,41,2314,779
2850,587,328,259,93,147,110,112,89,36,0,1901,587
2851,362,239,123,37,66,55,72,82,50,0,1046,362
2852,234,131,103,46,84,48,34,16,6,0,727,234
2853,528,309,219,95,130,72,77,104,50,0,1643,528
2854,847,495,352,152,208,115,124,168,80,0,2493,847
2855,300,128,172,59,78,54,49,39,21,0,1031,300
2856,401,171,230,79,105,72,65,52,28,0,1339,401
2857,539,241,298,92,167,99,72,60,49,29,1873,568
2858,640,286,354,109,198,118,86,71,58,0,2518,640
2859,315,141,174,54,98,58,42,35,28,0,1014,315
2860,768,478,290,201,284,109,63,58,53,0,2168,768
2861,413,277,136,95,127,70,52,52,17,1,1068,414
2862,903,606,297,207,277,153,114,113,39,0,2164,903
2863,490,282,208,34,88,119,83,98,68,3,1738,493
2864,692,331,361,120,208,148,101,74,41,0,2665,692
2865,647,402,245,68,119,128,108,134,90,0,2180,647
2866,402,225,177,49,120,83,63,59,28,0,1332,402
2867,635,399,236,148,185,130,85,77,10,0,1911,635
2868,1292,581,711,167,221,182,212,280,230,1,4355,1293
2869,424,199,225,95,133,70,45,29,52,11,1604,435
2870,577,271,306,130,180,95,61,39,72,0,1958,577
2871,449,217,232,121,147,75,51,31,24,0,1558,449
2872,1333,644,689,358,436,223,150,91,75,4,4105,1337
2873,474,265,209,75,119,89,90,72,29,0,1455,474
2874,628,415,213,63,115,96,124,142,88,1,2128,629
2875,313,221,92,54,74,53,34,48,50,0,889,313
2876,1020,436,584,200,267,184,166,133,70,0,4116,1020
2877,37,23,14,4,7,7,6,8,5,0,111,37
2878,530,305,225,37,96,129,90,106,72,0,1891,530
2879,12,6,6,1,2,2,2,2,3,32,35,44
2880,1112,577,535,127,187,139,151,217,291,0,3780,1112
2881,865,449,416,99,145,108,117,169,227,3,2810,868
2882,1101,572,529,126,185,138,149,215,288,85,3200,1186
2883,879,456,423,100,148,110,119,172,230,2,2789,881
2884,870,497,373,84,125,116,116,204,225,7,2983,877
2885,477,273,204,46,69,64,64,112,122,0,1652,477
2886,680,389,291,66,98,91,91,160,174,0,2191,680
2887,284,162,122,28,41,38,38,67,72,0,893,284
2888,411,235,176,40,59,55,55,97,105,2,1159,413
2889,362,207,155,35,52,48,48,85,94,3,1047,365
2890,1459,834,625,142,210,194,195,343,375,11,4970,1470
2891,2111,1207,904,205,304,281,282,496,543,0,4171,2111
2892,855,489,366,83,123,114,114,201,220,2,2984,857
2893,3054,1746,1308,297,439,407,409,717,785,12,9581,3066
2894,846,484,362,82,122,113,113,199,217,27,3014,873
2895,816,467,349,79,117,109,109,192,210,5,3006,821
2896,2088,949,1139,159,242,200,300,611,576,8,7722,2096
2897,64,40,24,5,8,7,8,13,23,0,194,64
2898,698,485,213,133,177,65,80,138,105,0,2242,698
2899,3218,2247,971,343,451,413,415,675,921,17,10201,3235
2900,1084,622,462,198,240,263,200,136,47,10,3199,1094
2901,1058,706,352,230,230,215,156,131,96,7,2715,1065
2902,1069,698,371,141,215,185,178,155,195,20,3455,1089
2903,1482,767,715,218,245,263,241,301,214,12,5134,1494
2904,2946,2125,821,250,285,537,518,642,714,12,8072,2958
2905,1239,939,300,262,310,136,237,152,142,300,2936,1539
2906,220,97,123,23,17,23,26,52,79,0,680,220
2907,698,477,221,120,121,130,103,112,112,0,1930,698
2908,2399,1644,755,430,437,335,326,427,444,23,7045,2422
2909,1399,892,507,325,377,233,200,197,67,6,3750,1405
2910,772,478,294,128,151,140,127,131,95,22,2223,794
2911,626,405,221,149,190,90,117,54,26,8,1910,634
2912,880,585,295,144,161,193,145,117,120,0,2448,880
2913,283,143,140,35,50,44,37,63,54,11,1066,294
2914,1641,969,672,191,331,320,258,375,166,15,5598,1656
2915,1294,863,431,112,109,226,174,224,449,0,3342,1294
2916,1290,892,398,105,112,235,213,230,395,0,3266,1290
2917,288,204,84,76,81,43,32,50,6,47,608,335
2918,2202,1818,384,320,315,375,321,404,467,4,4412,2206
2919,1524,961,563,226,254,236,254,353,201,12,3936,1536
2920,1746,1255,491,286,290,252,270,364,284,12,4706,1758
2921,1943,1138,805,126,176,193,242,361,845,7,5855,1950
2922,1982,1307,675,197,237,329,286,429,504,0,5166,1982
2923,1357,950,407,168,212,242,206,222,307,5,3187,1362
2924,802,490,312,218,222,148,120,79,15,10,2221,812
2925,837,578,259,198,205,138,134,119,43,0,2014,837
2926,306,155,151,38,54,48,40,68,58,7,1120,313
2927,469,232,237,66,79,98,88,93,45,0,1704,469
2928,485,314,171,116,148,69,90,41,21,1,1466,486
2929,493,312,181,204,165,50,32,24,18,3,971,496
2930,834,527,307,344,278,84,55,41,32,108,1665,942
2931,328,215,113,75,79,68,52,41,13,0,840,328
2932,396,318,78,57,72,64,69,84,50,0,896,396
2933,366,240,126,83,88,76,58,46,15,0,897,366
2934,351,230,121,80,84,73,55,44,15,0,960,351
2935,331,202,129,90,91,61,50,32,7,0,828,331
2936,356,233,123,85,93,60,47,54,17,4,919,360
2937,351,230,121,84,92,60,46,53,16,8,999,359
2938,548,359,189,131,144,93,72,83,25,0,1562,548
2939,430,346,84,62,78,70,75,91,54,0,997,430
2940,309,248,61,45,56,50,54,66,38,0,733,309
2941,579,396,183,100,100,108,85,93,93,0,1593,579
2942,325,139,186,96,97,46,30,42,14,0,1024,325
2943,516,220,296,152,154,74,48,66,22,2,1606,518
2944,793,597,196,263,260,97,109,43,21,0,1799,793
2945,305,230,75,101,100,37,42,16,9,7,767,312
2946,560,386,174,133,137,92,90,80,28,36,1538,596
2947,363,180,183,51,61,76,68,72,35,16,1366,379
2948,409,203,206,57,69,85,77,81,40,16,1594,425
2949,852,604,248,224,239,126,94,147,22,39,2229,891
2950,671,475,196,176,188,99,74,116,18,15,1583,686
2951,314,173,141,66,90,57,30,54,17,5,990,319
2952,564,310,254,118,161,103,55,97,30,0,1964,564
2953,251,138,113,53,72,46,24,43,13,5,969,256
2954,615,339,276,129,176,112,60,106,32,12,2260,627
2955,612,261,351,180,182,87,56,79,28,0,1830,612
2956,1231,900,331,496,421,109,94,107,4,31,2580,1262
2957,281,142,139,35,50,44,37,63,52,13,1022,294
2958,279,138,141,39,47,58,53,55,27,3,862,282
2959,834,570,264,143,145,156,123,134,133,2,2130,836
2960,13,8,5,2,2,2,2,3,2,0,16,13
2961,400,201,199,37,66,91,76,70,60,0,1237,400
2962,1820,973,847,214,272,309,280,432,313,2,6093,1822
2963,841,343,498,145,166,194,157,145,34,733,2773,1574
2964,4830,2666,2164,312,540,698,784,1356,1140,0,15156,4830
2965,1307,709,598,114,238,258,279,303,115,0,4178,1307
2966,0,0,0,0,0,0,0,0,0,0,0,0
2967,793,546,247,139,238,113,134,113,56,0,2525,793
2968,1250,827,423,158,227,176,200,238,251,0,3503,1250
2969,1836,1242,594,151,251,272,263,387,512,0,4725,1836
2970,4619,3903,716,755,1194,667,634,941,428,2,9950,4621
2971,1275,841,434,181,206,205,169,282,232,0,3357,1275
2972,3558,2492,1066,491,538,499,594,870,566,34,9764,3592
2973,439,208,231,85,100,81,65,63,45,0,1337,439
2974,1085,646,439,264,315,133,144,135,94,15,3237,1100
2975,554,341,213,35,54,66,71,103,225,0,1360,554
2976,756,411,345,37,57,111,117,202,232,0,2481,756
2977,1656,1105,551,77,121,271,325,490,372,4,4911,1660
2978,4058,2910,1148,321,452,535,636,930,1184,25,10881,4083
2979,3459,1866,1593,218,309,545,602,998,787,5,11171,3464
2980,1909,991,918,521,528,341,302,160,57,67,5989,1976
2981,1616,663,953,391,469,266,189,226,75,20,5545,1636
2982,1329,555,774,273,386,282,192,158,38,5,4311,1334
2983,2152,1120,1032,383,444,452,362,306,205,16,6651,2168
2984,1740,1096,644,280,341,336,341,309,133,6,5329,1746
2985,1218,725,493,95,145,234,232,265,247,0,3791,1218
2986,1753,916,837,375,388,265,250,330,145,0,5707,1753
2987,2617,2068,549,405,552,394,333,488,445,0,5224,2617
2988,1590,1235,355,146,276,171,159,264,574,6,4133,1596
2989,2376,1696,680,186,336,410,371,511,562,13,6294,2389
2990,1029,627,402,56,104,189,188,277,215,0,3024,1029
2991,2070,1281,789,211,307,301,306,435,510,6,6098,2076
2992,498,335,163,56,118,97,82,84,61,2,1230,500
2993,2370,1379,991,436,666,457,367,354,90,0,6136,2370
2994,1675,977,698,224,343,272,234,336,266,3,5023,1678
2995,4450,2502,1948,472,868,700,678,683,1049,4,13815,4454
2996,1530,975,555,230,378,232,270,263,157,0,4076,1530
2997,705,463,242,47,92,113,129,130,194,13,2264,718
2998,934,443,491,180,213,171,138,133,99,6,3127,940
2999,367,184,183,34,60,84,70,64,55,0,1260,367
3000,521,268,253,55,98,88,90,115,75,0,1646,521
3001,1036,532,504,109,194,174,179,229,151,1,3366,1037
3002,427,219,208,45,80,72,74,94,62,0,1147,427
3003,648,333,315,79,180,93,101,110,85,0,2032,648
3004,703,361,342,74,132,118,122,156,101,0,2420,703
3005,0,0,0,0,0,0,0,0,0,0,0,0
3006,1882,1015,867,118,168,297,328,543,428,0,6814,1882
3007,559,287,272,59,105,94,97,124,80,0,1675,559
3008,622,319,303,76,173,89,97,106,81,0,2246,622
3009,573,294,279,70,159,82,90,97,75,0,2107,573
3010,480,246,234,50,90,81,83,106,70,0,1675,480
3011,419,215,204,51,116,60,66,71,55,0,1366,419
3012,269,167,102,50,48,38,38,54,41,4,861,273
3013,35,22,13,6,6,5,5,7,6,0,80,35
3014,228,142,86,42,40,33,32,46,35,0,633,228
3015,911,494,417,197,215,158,140,130,71,4,2848,915
3016,561,282,279,53,92,128,107,98,83,0,1743,561
3017,615,382,233,114,109,88,87,124,93,0,1440,615
3018,530,189,341,141,177,62,57,83,10,5,1956,535
3019,168,110,58,11,22,27,31,31,46,0,483,168
3020,414,224,190,90,98,72,64,59,31,1,1164,415
3021,286,185,101,85,96,39,37,22,7,18,808,304
3022,687,443,244,168,191,120,97,90,21,17,1899,704
3023,248,160,88,60,69,43,35,33,8,8,724,256
3024,341,220,121,102,115,47,44,26,7,1,879,342
3025,610,217,393,162,203,72,66,95,12,6,2244,616
3026,430,233,197,93,102,74,66,61,34,0,1315,430
3027,1211,746,465,76,117,144,156,226,492,3,3964,1214
3028,1265,779,486,79,123,150,163,236,514,0,3864,1265
3029,2089,1136,953,102,158,307,323,558,641,0,6770,2089
3030,864,470,394,42,65,127,134,231,265,3,2766,867
3031,193,130,63,22,46,38,32,33,22,7,596,200
3032,298,201,97,34,70,58,49,50,37,0,811,298
3033,1023,689,334,115,242,200,169,173,124,5,2612,1028
3034,479,330,149,84,144,69,81,68,33,0,1154,479
3035,347,239,108,61,104,50,58,49,25,0,656,347
3036,315,217,98,55,95,45,53,45,22,0,829,315
3037,512,353,159,90,154,73,86,73,36,0,886,512
3038,675,533,142,104,142,102,86,126,115,0,2122,675
3039,719,568,151,111,152,108,91,134,123,0,1930,719
3040,527,416,111,82,111,79,67,98,90,0,1209,527
3041,15,10,5,1,2,2,3,3,4,0,55,15
3042,1,1,0,0,0,0,0,0,1,0,2,1
3043,0,0,0,0,0,0,0,0,0,0,0,0
3044,0,0,0,0,0,0,0,0,0,0,0,0
3045,5,3,2,0,1,1,1,1,1,0,15,5
3046,1190,739,451,220,211,170,169,239,181,6,3744,1196
3047,310,149,161,43,73,47,72,55,20,0,1009,310
3048,3325,2084,1241,444,600,317,501,721,742,41,9616,3366
3049,2461,1330,1131,225,560,388,440,457,391,22,7669,2483
3050,1657,1228,429,99,173,198,171,361,655,66,4189,1723
3051,2671,1595,1076,381,505,328,489,590,378,5,8295,2676
3052,2443,1789,654,282,365,346,313,535,602,22,6175,2465
3053,1068,797,271,70,113,137,124,257,367,2,2771,1070
3054,2288,1543,745,275,399,451,319,424,420,52,5443,2340
3055,61,60,1,23,18,2,3,2,13,73,69,134
3056,1526,715,811,79,238,163,326,425,295,55,5756,1581
3057,1820,844,976,190,372,132,266,323,537,0,6139,1820
3058,355,218,137,44,75,62,59,68,47,0,989,355
3059,1138,654,484,159,245,122,152,253,207,0,3631,1138
3060,848,517,331,114,210,145,157,98,124,1,2399,849
3061,359,262,97,35,46,54,53,80,91,7,999,366
3062,594,433,161,57,77,89,88,132,151,0,1560,594
3063,640,425,215,146,167,97,94,57,79,0,1774,640
3064,248,165,83,56,65,38,36,22,31,165,519,413
3065,451,276,175,56,96,79,76,87,57,0,1099,451
3066,465,285,180,58,99,81,78,89,60,18,1121,483
3067,996,598,398,119,166,163,189,216,143,13,2812,1009
3068,269,191,78,39,68,46,44,42,30,8,723,277
3069,309,205,104,70,81,47,45,27,39,154,563,463
3070,442,213,229,62,104,67,103,78,28,0,1572,442
3071,906,436,470,126,213,138,211,161,57,0,2692,906
3072,806,484,322,96,135,132,153,174,116,0,2651,806
3073,368,261,107,54,93,63,60,57,41,0,772,368
3074,880,505,375,123,190,94,118,195,160,0,2667,880
3075,618,355,263,86,133,66,83,137,113,51,1739,669
3076,573,417,156,55,74,86,85,128,145,0,1489,573
3077,431,259,172,51,72,71,82,93,62,0,1237,431
3078,389,233,156,46,65,64,74,84,56,88,961,477
3079,413,248,165,49,69,68,78,89,60,0,1319,413
3080,462,216,246,24,72,49,99,129,89,0,1843,462
3081,580,272,308,30,90,62,124,161,113,0,2306,580
3082,572,265,307,60,117,41,84,102,168,6,2290,578
3083,868,403,465,91,178,63,127,154,255,0,3042,868
3084,1346,1224,122,228,308,159,197,167,287,71,2427,1417
3085,2516,1854,662,384,535,262,280,430,625,115,5969,2631
3086,747,545,202,85,143,156,132,127,104,12,1722,759
3087,2177,1430,747,414,589,271,265,303,335,24,5207,2201
3088,1956,1448,508,338,453,241,298,277,349,13,4930,1969
3089,2146,1644,502,141,235,196,222,333,1019,42,5340,2188
3090,799,591,208,95,139,94,96,128,247,18,2090,817
3091,1660,1087,573,148,282,242,256,317,415,1177,4543,2837
3092,581,485,96,62,91,84,82,120,142,75,1284,656
3093,4,2,2,0,1,0,1,1,1,0,13,4
3094,1,0,1,0,0,0,0,0,1,0,5,1
3095,0,0,0,0,0,0,0,0,0,0,0,0
3096,0,0,0,0,0,0,0,0,0,0,0,0
3097,0,0,0,0,0,0,0,0,0,0,0,0
3098,0,0,0,0,0,0,0,0,0,0,0,0
3099,1,0,1,0,0,0,0,0,1,0,5,1
3100,0,0,0,0,0,0,0,0,0,0,0,0
3101,236,181,55,15,26,22,24,37,112,18,673,254
3102,245,188,57,16,27,22,25,38,117,0,727,245
3103,149,114,35,10,16,14,15,23,71,9,379,158
3104,923,707,216,86,130,127,123,143,314,2,2288,925
3105,2324,1990,334,372,435,292,317,284,624,10,4624,2334
3106,2470,1512,958,299,357,368,344,621,481,23,6749,2493
3107,2120,1698,422,305,481,218,220,303,593,60,4687,2180
3108,3183,2149,1034,279,396,549,386,560,1013,0,8760,3183
3109,1525,1061,464,127,264,299,206,363,266,0,4172,1525
3110,2704,2048,656,356,451,491,316,411,679,29,6982,2733
3111,5088,3070,2018,606,795,786,509,990,1402,33,14115,5121
3112,442,332,110,62,97,79,58,86,60,0,1292,442
3113,1299,938,361,172,253,307,159,161,247,2,3209,1301
3114,533,350,183,73,122,146,88,70,34,5,1398,538
3115,1577,1179,398,253,409,358,178,218,161,0,3526,1577
3116,231,172,59,30,48,50,34,38,31,1728,793,1959
3117,723,521,202,79,136,152,108,161,87,0,2174,723
3118,1206,930,276,186,233,191,123,210,263,208,2877,1414
3119,1421,978,443,101,159,266,165,210,520,0,3831,1421
3120,786,561,225,98,152,112,76,111,237,0,2195,786
3121,482,343,139,70,81,66,55,100,110,1,943,483
3122,1085,771,314,157,182,149,125,225,247,0,2563,1085
3123,1534,1162,372,187,311,271,184,260,321,8,3938,1542
3124,1918,1247,671,197,262,366,285,297,511,335,5509,2253
3125,2236,1615,621,296,436,528,274,277,425,59,5599,2295
3126,2408,1690,718,568,697,555,236,129,223,0,6164,2408
3127,394,272,122,28,61,86,46,81,92,0,1117,394
3128,1867,1350,517,389,383,396,230,302,167,9,4535,1876
3129,2016,1455,561,202,297,432,266,528,291,0,5302,2016
3130,3831,2973,858,600,813,642,511,531,734,0,8559,3831
3131,2052,1673,379,270,385,269,246,252,630,21,4134,2073
3132,3583,2203,1380,829,722,689,475,501,367,12,10332,3595
3133,1388,605,783,149,235,316,166,341,181,9,4570,1397
3134,1325,917,408,93,130,277,208,330,287,46,3382,1371
3135,3586,3459,127,552,725,721,539,446,603,0,6008,3586
3136,2083,1653,430,354,355,426,307,289,352,9,4845,2092
3137,4342,3420,922,257,341,698,481,773,1792,26,10177,4368
3138,1480,1064,416,304,298,276,205,227,170,5,3575,1485
3139,3078,2019,1059,281,363,415,373,605,1041,27,8079,3105
3140,474,319,155,93,113,91,47,50,80,6,1464,480
3141,793,535,258,122,158,152,120,135,106,0,1998,793
3142,1403,1122,281,396,384,207,129,193,94,164,3168,1567
3143,1730,1419,311,314,384,365,244,282,141,36,3728,1766
3144,1794,1150,644,197,351,393,316,311,226,12,4559,1806
3145,1892,1252,640,195,244,354,324,509,266,25,5240,1917
3146,1307,912,395,343,293,322,195,133,21,12,3708,1319
3147,1388,675,713,275,341,238,198,211,125,15,4879,1403
3148,509,285,224,69,94,122,81,91,52,5,1953,514
3149,1589,832,757,348,387,304,237,242,71,20,4929,1609
3150,657,344,313,144,160,126,98,100,29,8,2021,665
3151,2777,2008,769,392,626,428,377,462,492,0,6467,2777
3152,3660,2323,1337,411,598,661,570,842,578,12,10183,3672
3153,2117,1450,667,226,301,457,397,449,287,7,5981,2124
3154,1282,808,474,299,321,249,173,170,70,6,3979,1288
3155,1064,613,451,186,226,256,181,166,49,11,3093,1075
3156,2441,1622,819,415,400,393,242,382,609,17,7233,2458
3157,2694,1794,900,430,508,603,441,324,388,15,7517,2709
3158,1323,670,653,188,292,309,234,212,88,109,4991,1432
3159,2613,1610,1003,491,489,590,377,532,134,31,7990,2644
3160,841,484,357,129,145,190,111,184,82,26,2626,867
3161,1728,1303,425,249,401,280,234,243,321,15,3983,1743
3162,1804,1369,435,263,341,233,223,245,499,5,4389,1809
3163,1959,1557,402,179,272,281,395,396,436,9,4797,1968
3164,1734,1334,400,224,337,249,273,313,338,0,4294,1734
3165,2400,1916,484,453,540,271,303,337,496,73,5866,2473
3166,2458,1371,1087,476,452,431,308,475,316,21,7791,2479
3167,3450,2087,1363,883,937,614,400,341,275,23,9821,3473
3168,2864,2179,685,433,523,612,383,483,430,12,6692,2876
3169,2623,1988,635,357,475,517,418,450,406,53,6113,2676
3170,1296,1007,289,60,87,142,131,323,553,17,3225,1313
3171,562,477,85,149,146,112,76,57,22,201,1059,763
3172,600,494,106,140,126,123,84,85,42,34,1393,634
3173,2860,2065,795,523,694,555,377,390,321,44,6566,2904
3174,1764,1490,274,369,466,262,202,272,193,0,3484,1764
3175,1753,1361,392,211,233,275,194,321,519,52,4069,1805
3176,1707,1482,225,423,429,210,250,220,175,40,3280,1747
3177,1785,1474,311,423,450,239,270,199,204,770,3814,2555
3178,1767,1431,336,342,456,279,224,205,261,28,3994,1795
3179,603,356,247,87,120,96,80,98,122,9,1687,612
3180,1626,1147,479,161,238,260,247,350,370,0,4029,1626
3181,1098,895,203,128,203,164,197,112,294,68,2746,1166
3182,1372,997,375,229,220,136,204,173,410,84,3741,1456
3183,3653,2299,1354,658,786,579,487,587,556,37,9748,3690
3184,1756,1532,224,271,371,306,264,221,323,92,3561,1848
3185,1611,1396,215,236,334,225,197,186,433,0,3241,1611
3186,2002,1692,310,243,389,390,334,264,382,3,4432,2005
3187,318,153,165,34,33,60,43,76,72,33,953,351
3188,852,548,304,79,113,119,126,197,218,16,2404,868
3189,1922,1552,370,254,321,267,265,356,459,135,4169,2057
3190,1674,1102,572,244,382,274,238,205,331,1,4338,1675
3191,226,167,59,40,46,29,24,30,57,0,479,226
3192,93,63,30,14,18,18,14,16,13,12,253,105
3193,1199,828,371,86,185,261,141,246,280,0,3391,1199
3194,254,205,49,34,42,35,35,47,61,0,610,254
3195,723,348,375,77,75,136,97,174,164,0,2507,723
3196,341,164,177,36,36,64,46,82,77,4,1261,345
3197,1201,772,429,111,159,168,178,277,308,0,3336,1201
3198,691,408,283,100,137,110,91,112,141,0,2164,691
3199,1937,932,1005,206,202,365,260,466,438,4,6604,1941
3200,395,233,162,57,78,63,52,64,81,0,767,395
3201,328,194,134,47,65,52,43,53,68,3,1043,331
3202,662,391,271,95,131,106,88,108,134,0,2090,662
3203,186,110,76,27,37,30,25,30,37,3,478,189
3204,339,218,121,31,45,47,50,78,88,0,969,339
3205,517,332,185,48,69,72,77,119,132,0,1189,517
3206,312,201,111,29,41,44,46,72,80,0,846,312
3207,384,247,137,36,51,54,57,89,97,0,1113,384
3208,345,255,90,61,70,44,36,46,88,19,977,364
3209,779,576,203,139,159,99,81,104,197,0,2046,779
3210,776,574,202,138,158,99,81,103,197,0,1893,776
3211,208,140,68,32,41,40,31,35,29,2,587,210
3212,468,316,152,72,93,90,71,80,62,5,1254,473
3213,561,379,182,86,112,108,85,96,74,5,1370,566
3214,456,318,138,120,102,112,68,47,7,67,1371,523
3215,1018,710,308,267,228,251,152,104,16,0,1977,1018
3216,743,469,274,173,186,144,100,98,42,0,1607,743
3217,579,365,214,135,145,112,78,77,32,0,1696,579
3218,484,271,213,65,90,116,77,87,49,24,1688,508
3219,357,200,157,48,66,86,57,64,36,1,1127,358
3220,291,163,128,39,54,70,46,52,30,0,909,291
3221,271,152,119,37,50,65,43,49,27,177,732,448
3222,394,335,59,104,102,79,54,40,15,13,657,407
3223,394,227,167,69,84,95,67,62,17,4,1253,398
3224,735,423,312,129,156,177,125,115,33,6,2255,741
3225,381,314,67,89,80,78,53,54,27,4,832,385
3226,262,137,125,57,64,50,39,40,12,13,780,275
3227,349,183,166,77,85,67,52,53,15,40,1154,389
3228,648,426,222,88,148,178,107,85,42,0,1928,648
3229,422,291,131,30,65,92,50,87,98,0,1156,422
3230,498,371,127,65,104,107,74,82,66,0,1390,498
3231,469,349,120,62,98,101,69,77,62,0,1270,469
3232,269,200,69,35,56,58,40,44,36,4,713,273
3233,114,86,28,16,25,20,15,22,16,0,272,114
3234,530,398,132,74,116,95,70,104,71,7,1201,537
3235,401,301,100,56,88,72,53,78,54,0,1070,401
3236,412,309,103,58,90,74,54,80,56,0,923,412
3237,346,250,96,38,65,73,52,77,41,0,1178,346
3238,465,335,130,51,88,98,70,103,55,0,1231,465
3239,771,556,215,84,145,162,115,171,94,0,2056,771
3240,641,415,226,101,113,128,94,103,102,6,1650,647
3241,489,317,172,77,86,97,71,79,79,0,1475,489
3242,402,260,142,64,71,80,59,65,63,1,911,403
3243,361,278,83,56,70,57,37,63,78,0,1040,361
3244,371,286,85,57,72,59,38,65,80,1,747,372
3245,314,223,91,45,53,43,36,65,72,0,709,314
3246,459,328,131,57,89,65,44,65,139,0,1136,459
3247,412,294,118,52,80,59,40,58,123,0,992,412
3248,375,268,107,47,72,53,36,53,114,0,978,375
3249,414,285,129,29,46,78,48,61,152,2,970,416
3250,427,280,147,58,98,117,71,56,27,135,1331,562
3251,2971,1710,1261,456,514,671,390,649,291,164,10456,3135
3252,147,95,52,14,20,21,22,34,36,0,314,147
3253,898,758,140,124,173,126,94,150,231,205,1890,1103
3254,3038,2028,1010,465,574,407,365,545,682,89,8470,3127
3255,2876,1952,924,438,479,327,446,262,924,187,6813,3063
3256,683,564,119,76,89,108,93,117,200,3,1634,686
3257,765,560,205,66,79,131,92,102,295,0,1856,765
3258,2912,1937,975,270,281,328,399,346,1288,29,7753,2941
3259,3083,2040,1043,365,497,546,433,425,817,31,7875,3114
3260,2183,1310,873,398,365,278,660,86,396,13,5602,2196
3261,1641,1297,344,135,244,321,171,341,429,7,3489,1648
3262,1554,939,615,268,319,192,166,105,504,0,4154,1554
3263,1104,855,249,87,100,133,193,151,440,0,2689,1104
3264,414,248,166,55,68,48,69,53,121,0,1094,414
3265,2456,1486,970,236,249,274,399,415,883,57,7046,2513
3266,1104,919,185,129,176,282,130,159,228,12,1816,1116
3267,1851,1409,442,204,280,230,317,288,532,69,4732,1920
3268,2754,1901,853,223,306,372,251,468,1134,42,6814,2796
3269,678,471,207,119,107,99,80,74,199,21,1674,699
3270,1376,1010,366,223,245,149,146,220,393,6,3129,1382
3271,2806,1763,1043,166,197,270,257,508,1408,66,7203,2872
3272,163,76,87,14,13,33,17,30,56,0,457,163
3273,777,655,122,139,155,142,121,75,145,6,1553,783
3274,1426,991,435,235,296,205,197,192,301,28,3287,1454
3275,1626,1267,359,177,209,275,242,309,414,17,3783,1643
3276,2294,1774,520,181,349,315,244,537,668,7,5294,2301
3277,1064,657,407,121,118,111,88,212,414,0,2720,1064
3278,2221,1415,806,213,283,273,256,430,766,41,4804,2262
3279,815,515,300,46,50,60,77,96,486,55,2275,870
3280,2207,1630,577,257,403,219,191,389,748,0,5420,2207
3281,541,363,178,84,80,50,45,91,191,254,1156,795
3282,2141,1595,546,106,120,189,234,281,1211,0,4896,2141
3283,2056,1398,658,315,384,275,200,461,421,56,4478,2112
3284,872,604,268,129,207,104,68,134,230,7,2280,879
3285,2725,692,2033,759,593,420,306,322,325,67,11406,2792
3286,2023,1476,547,240,243,243,197,336,764,34,4181,2057
3287,2043,1326,717,214,252,150,153,400,874,0,4917,2043
3288,2076,1426,650,240,287,267,250,381,651,255,4353,2331
3289,1015,491,524,315,315,114,85,76,110,0,2571,1015
3290,246,203,43,17,27,26,19,69,88,80,495,326
3291,1957,1148,809,164,147,154,121,277,1094,14,5136,1971
3292,2486,1822,664,329,334,249,259,451,864,11,5414,2497
3293,857,582,275,121,143,83,60,143,307,0,1622,857
3294,958,704,254,83,66,53,71,69,616,0,2160,958
3295,2209,1437,772,115,157,190,243,413,1091,0,5516,2209
3296,0,0,0,0,0,0,0,0,0,0,0,0
3297,2522,1628,894,175,197,202,188,440,1320,6,5851,2528
3298,2382,1188,1194,129,154,180,160,315,1444,0,6314,2382
3299,1993,1340,653,242,287,315,214,287,648,0,4398,1993
3300,2062,1550,512,100,127,194,191,395,1055,5,4404,2067
3301,2812,1892,920,261,302,245,217,356,1431,14,6570,2826
3302,1852,1101,751,147,131,120,103,382,969,0,4716,1852
3303,4282,3909,373,378,474,508,430,773,1719,14,7504,4296
3304,244,178,66,21,25,42,29,33,94,0,517,244
3305,17,11,6,3,3,2,2,3,4,0,56,17
3306,536,358,178,82,101,72,64,96,121,0,1210,536
3307,813,543,270,124,154,109,98,146,182,11,2219,824
3308,711,427,284,95,118,82,118,91,207,1,1992,712
3309,1130,683,447,195,232,140,120,76,367,103,2316,1233
3310,883,698,185,72,131,173,92,183,232,0,2235,883
3311,1122,934,188,131,179,286,133,161,232,0,2243,1122
3312,0,0,0,0,0,0,0,0,0,0,0,0
3313,772,536,236,135,122,112,91,84,228,35,1489,807
3314,1037,721,316,181,164,151,122,113,306,6,2195,1043
3315,190,132,58,33,30,28,22,21,56,0,524,190
3316,138,96,42,24,22,20,16,15,41,31,311,169
3317,356,271,85,39,54,44,61,55,103,8,899,364
3318,658,486,172,77,120,65,57,116,223,0,1599,658
3319,696,514,182,81,127,69,60,123,236,22,1509,718
3320,1720,1153,567,267,253,158,144,289,609,475,3936,2195
3321,180,46,134,50,39,28,20,21,22,41,781,221
3322,443,307,136,65,105,53,34,68,118,2,1304,445
3323,638,466,172,76,76,77,62,106,241,0,1774,638
3324,425,310,115,50,51,51,41,71,161,0,808,425
3325,176,129,47,23,24,18,18,32,61,0,379,176
3326,265,194,71,35,36,27,28,48,91,0,688,265
3327,54,35,19,6,7,4,4,11,22,0,108,54
3328,1537,1043,494,217,256,148,108,257,551,0,4130,1537
3329,78,53,25,11,13,8,5,13,28,0,175,78
3330,400,272,128,61,75,54,39,90,81,302,662,702
3331,314,214,100,48,59,42,31,70,64,3,514,317
3332,522,362,160,77,124,63,41,80,137,0,1237,522
