TAZ,HHLESSGQ,HHCHILDNO,HHCHILDYES,HHINC1,HHINC2,HHINC3,HHINC4,HHINC5,HHINC6,HHGQYES,HHGQNO,HHBASE
1,798,715,83,83,88,81,74,156,316,4,1451,802
2,452,139,313,80,20,72,23,85,172,22,1508,474
3,3236,2940,296,1120,526,287,342,508,453,20,6233,3256
4,2438,2115,323,874,371,322,239,286,346,0,5009,2438
5,3398,3223,175,1230,649,346,310,433,430,7,5973,3405
6,1346,1176,170,439,219,192,115,191,190,20,2658,1366
7,542,454,88,182,99,69,50,65,77,0,1179,542
8,717,679,38,263,137,99,46,86,86,0,1274,717
9,10723,6907,3816,915,1685,791,1158,2130,4044,0,38544,10723
10,4345,4077,268,1070,1167,520,391,552,645,107,7664,4452
11,872,730,142,293,160,110,80,104,125,0,1898,872
12,630,596,34,229,124,77,53,72,75,0,1029,630
13,676,640,36,246,133,83,57,78,79,0,1104,676
14,1050,973,77,429,187,127,66,120,121,342,1664,1392
15,517,479,38,211,92,62,32,59,61,0,819,517
16,1271,1177,94,519,226,154,79,145,148,281,2014,1552
17,1440,1334,106,588,256,174,90,164,168,0,2282,1440
18,1060,926,134,486,133,137,51,131,122,353,1877,1413
19,1105,966,139,507,139,143,53,136,127,202,1955,1307
20,819,731,88,317,132,96,77,101,96,118,1511,937
21,1908,1786,122,525,354,220,230,247,332,191,3365,2099
22,1381,1292,89,380,256,159,167,179,240,55,2435,1436
23,5486,5148,338,1351,1474,657,494,697,813,64,9678,5550
24,905,856,49,330,178,111,77,104,105,461,1478,1366
25,1454,1376,78,529,286,178,123,167,171,0,2374,1454
26,1778,1512,266,645,366,205,146,210,206,77,3229,1855
27,1114,947,167,404,230,129,92,132,127,0,2023,1114
28,1770,1505,265,642,365,204,145,209,205,664,3213,2434
29,1222,1074,148,453,223,155,101,142,148,15,2242,1237
30,1628,1431,197,603,297,207,135,189,197,126,2987,1754
31,586,515,71,217,107,74,49,68,71,531,1075,1117
32,677,592,85,221,110,96,58,96,96,0,1337,677
33,1213,1060,153,396,198,173,104,172,170,0,2397,1213
34,1242,1177,65,390,265,148,120,147,172,8,2122,1250
35,716,599,117,245,112,94,70,88,107,0,1494,716
36,832,695,137,285,130,110,81,102,124,1,1737,833
37,901,753,148,308,141,119,88,110,135,0,1880,901
38,578,484,94,194,106,73,53,69,83,0,1257,578
39,1041,871,170,350,191,132,96,124,148,0,2264,1041
40,2347,2063,284,870,428,298,195,273,283,181,4307,2528
41,1188,1044,144,440,217,151,99,138,143,44,2181,1232
42,1951,1705,246,895,245,253,94,240,224,2413,3452,4364
43,1261,1102,159,578,158,163,61,155,146,134,2232,1395
44,1150,972,178,440,168,134,111,151,146,0,2434,1150
45,903,763,140,346,132,105,87,118,115,0,1911,903
46,867,733,134,332,127,101,83,114,110,0,1835,867
47,1142,1082,60,418,218,157,73,137,139,0,2029,1142
48,1194,1131,63,437,228,164,76,143,146,0,2120,1194
49,642,567,75,242,107,63,64,81,85,0,1349,642
50,1172,1035,137,443,195,115,118,148,153,3,2465,1175
51,1257,1110,147,475,210,124,126,159,163,11,2645,1268
52,1331,1210,121,475,254,155,113,168,166,28,2407,1359
53,1517,1379,138,541,289,177,128,191,191,0,2743,1517
54,837,761,76,299,160,97,71,105,105,4,1514,841
55,1012,915,97,355,184,133,80,121,139,0,1934,1012
56,449,406,43,158,82,59,35,54,61,3,858,452
57,838,758,80,294,153,110,66,100,115,0,1600,838
58,733,601,132,229,153,94,48,108,101,0,1630,733
59,986,808,178,309,206,126,65,145,135,0,2192,986
60,1415,1351,64,470,259,151,152,175,208,25,2420,1440
61,888,854,34,286,208,99,83,104,108,348,1407,1236
62,268,245,23,88,59,43,10,30,38,35,458,303
63,394,342,52,128,76,54,24,54,58,18,667,412
64,810,654,156,276,152,108,59,103,112,18,1873,828
65,615,573,42,236,86,95,44,61,93,472,1100,1087
66,1197,1115,82,459,167,186,86,119,180,0,2141,1197
67,2197,2047,150,842,306,341,158,218,332,72,3930,2269
68,1986,1859,127,484,468,200,216,274,344,80,3551,2066
69,2206,2064,142,606,409,254,266,286,385,306,3889,2512
70,1555,1416,139,562,356,166,123,169,179,51,2478,1606
71,1435,1307,128,518,329,154,113,156,165,62,2285,1497
72,1541,1482,59,497,361,172,144,180,187,515,2442,2056
73,746,675,71,244,133,97,76,87,109,10,1288,756
74,1077,823,254,344,215,113,106,137,162,8,2538,1085
75,616,471,145,197,123,64,61,78,93,0,1452,616
76,4075,3604,471,1432,662,519,347,487,628,95,7525,4170
77,2161,1911,250,760,351,275,184,258,333,41,3989,2202
78,1295,1156,139,501,208,151,122,159,154,90,2391,1385
79,1535,1371,164,593,247,179,145,189,182,11,2833,1546
80,2022,1890,132,411,491,267,168,309,376,27,3575,2049
81,845,790,55,155,195,93,96,124,182,253,1490,1098
82,312,306,6,103,65,33,41,30,40,63,506,375
83,56,52,4,15,8,9,4,9,11,11,97,67
84,561,548,13,168,126,63,68,62,74,2,908,563
85,447,391,56,158,75,62,31,67,54,64,766,511
86,111,102,9,39,20,17,6,15,14,22,189,133
87,105,103,2,27,28,12,11,14,13,1,170,106
88,1770,1657,113,431,418,178,192,244,307,377,3164,2147
89,413,386,27,84,100,55,34,63,77,455,729,868
90,1403,1313,90,258,323,155,159,206,302,25,2476,1428
91,1603,1500,103,295,369,177,182,235,345,15,2828,1618
92,2299,2112,187,553,258,279,250,370,589,14,4125,2313
93,4277,4087,190,1484,661,500,343,599,690,113,7545,4390
94,3624,3469,155,988,525,353,377,592,789,22,6351,3646
95,2761,2419,342,740,356,313,278,442,632,4,5182,2765
96,731,688,43,269,109,64,81,102,106,0,1326,731
97,4970,3968,1002,556,562,515,536,858,1943,99,12716,5069
98,1646,1297,349,186,198,155,174,275,658,19,4308,1665
99,1812,1436,376,190,217,182,175,322,726,0,4592,1812
100,68,57,11,7,8,10,6,4,33,0,153,68
101,299,207,92,33,39,30,31,47,119,0,821,299
102,903,719,184,99,109,80,96,167,352,0,2261,903
103,880,710,170,125,107,86,98,147,317,0,2044,880
104,387,312,75,55,47,38,43,65,139,0,900,387
105,405,327,78,58,49,39,45,68,146,115,940,520
106,561,453,108,80,68,55,63,94,201,0,1303,561
107,759,610,149,97,89,75,80,128,290,0,1801,759
108,783,629,154,100,92,77,83,132,299,23,1858,806
109,686,551,135,88,80,68,73,115,262,13,1628,699
110,902,725,177,115,105,89,95,152,346,0,2141,902
111,1043,833,210,119,124,104,109,175,412,14,2538,1057
112,1090,870,220,124,129,108,114,183,432,28,2653,1118
113,989,790,199,112,117,98,104,166,392,0,2407,989
114,233,161,72,26,30,23,24,36,94,0,640,233
115,479,332,147,53,62,48,50,75,191,0,1318,479
116,669,526,143,88,98,69,70,115,229,0,1678,669
117,705,554,151,93,103,73,74,121,241,7,1766,712
118,1026,807,219,136,151,106,108,176,349,7,2572,1033
119,592,462,130,77,79,55,65,96,220,3,1512,595
120,904,706,198,117,120,84,99,147,337,0,2309,904
121,476,372,104,62,63,44,52,78,177,0,1216,476
122,496,387,109,64,66,46,54,81,185,0,1267,496
123,785,613,172,102,104,73,86,128,292,11,2003,796
124,949,743,206,107,117,92,96,169,368,3,2420,952
125,724,567,157,81,90,70,73,129,281,5,1849,729
126,635,497,138,71,79,62,64,113,246,2,1621,637
127,795,623,172,89,98,77,80,141,310,0,2028,795
128,590,466,124,72,58,56,62,109,233,0,1567,590
129,910,724,186,100,110,80,97,168,355,4,2278,914
130,662,527,135,72,80,58,71,123,258,0,1657,662
131,728,575,153,89,71,70,76,134,288,1,1935,729
132,920,734,186,103,104,95,99,159,360,10,2355,930
133,1055,941,114,259,270,114,106,127,179,38,1789,1093
134,874,543,331,93,98,83,88,143,369,6,2746,880
135,664,592,72,163,170,72,67,80,112,5,1126,669
136,1383,1234,149,340,354,149,139,166,235,12,2347,1395
137,511,403,108,62,50,49,54,94,202,0,1359,511
138,1212,1155,57,462,256,128,106,130,130,101,2086,1313
139,1659,1581,78,633,350,175,145,178,178,1,2856,1660
140,1029,981,48,393,217,109,90,110,110,51,1772,1080
141,816,778,38,311,172,86,71,87,89,0,1405,816
142,188,150,38,48,39,20,17,27,37,0,417,188
143,940,750,190,241,195,101,87,134,182,0,2078,940
144,700,559,141,179,145,75,64,100,137,124,1547,824
145,785,626,159,201,163,84,72,112,153,54,1735,839
146,939,749,190,241,195,100,86,134,183,52,2076,991
147,1073,934,139,180,241,125,110,173,244,66,2108,1139
148,794,691,103,134,178,92,82,128,180,0,1559,794
149,1205,1049,156,203,271,140,124,194,273,0,2367,1205
150,1926,1676,250,324,433,224,198,310,437,37,3783,1963
151,769,669,100,129,173,90,79,124,174,137,1510,906
152,867,754,113,146,195,101,89,140,196,86,1703,953
153,642,544,98,79,105,70,59,116,213,0,1399,642
154,566,480,86,70,92,62,52,102,188,123,1234,689
155,811,688,123,100,132,88,74,147,270,3,1767,814
156,391,332,59,48,64,43,36,71,129,0,853,391
157,984,834,150,121,161,107,90,178,327,25,2144,1009
158,624,587,37,230,93,55,69,87,90,0,1132,624
159,660,621,39,243,98,58,73,92,96,0,1197,660
160,950,894,56,350,141,83,105,133,138,0,1723,950
161,697,551,146,117,115,78,78,116,193,0,1589,697
162,736,599,137,265,103,89,67,94,118,36,1455,772
163,376,306,70,135,52,45,34,48,62,3,744,379
164,1520,1236,284,546,212,183,139,195,245,0,3005,1520
165,337,266,71,56,56,37,37,56,95,0,767,337
166,575,454,121,96,95,64,64,96,160,357,1309,932
167,285,225,60,48,47,32,32,47,79,0,650,285
168,562,444,118,94,93,62,62,94,157,0,1279,562
169,897,813,84,265,148,83,103,136,162,0,1741,897
170,904,819,85,267,149,84,104,137,163,0,1754,904
171,547,496,51,161,90,51,63,83,99,0,1062,547
172,1039,970,69,367,187,102,101,130,152,42,1749,1081
173,1326,1238,88,469,238,130,129,167,193,0,2230,1326
174,1780,1741,39,549,503,179,188,163,198,178,2738,1958
175,790,773,17,243,223,80,84,72,88,15,1214,805
176,584,558,26,172,167,53,60,54,78,0,999,584
177,998,954,44,294,286,90,102,92,134,0,1707,998
178,1410,1348,62,416,404,127,145,130,188,0,2411,1410
179,1116,1021,95,235,289,118,127,139,208,0,2387,1116
180,886,811,75,186,230,94,100,111,165,205,1895,1091
181,690,585,105,125,112,73,71,110,199,0,1474,690
182,1031,874,157,187,168,109,105,165,297,0,2203,1031
183,497,421,76,90,81,53,51,79,143,0,1062,497
184,1423,1206,217,258,232,151,146,228,408,0,3040,1423
185,953,807,146,173,155,101,97,152,275,13,2036,966
186,514,490,24,147,129,55,45,53,85,10,887,524
187,1505,1434,71,431,377,161,133,155,248,199,2595,1704
188,1041,992,49,298,261,111,92,107,172,0,1796,1041
189,489,420,69,66,79,45,60,79,160,2,1129,491
190,384,329,55,52,62,35,47,62,126,14,887,398
191,661,567,94,90,107,60,81,106,217,0,1525,661
192,752,706,46,134,134,78,86,119,201,3258,1710,4010
193,961,902,59,172,171,100,110,152,256,3,2186,964
194,1677,1574,103,300,299,175,192,265,446,21,3815,1698
195,1245,1168,77,222,222,130,143,196,332,11,2832,1256
196,1240,1057,183,394,327,112,112,141,154,119,2502,1359
197,1405,1197,208,447,371,127,127,160,173,0,2835,1405
198,2121,2021,100,568,592,254,196,205,306,17,3442,2138
199,1002,806,196,297,247,108,93,112,145,0,2105,1002
200,1338,1077,261,396,330,144,124,150,194,0,2809,1338
201,718,578,140,213,177,77,66,80,105,15,1508,733
202,531,427,104,157,131,57,49,59,78,0,1114,531
203,542,442,100,118,138,60,57,71,98,0,1204,542
204,815,665,150,178,207,90,85,106,149,15,1813,830
205,1664,1358,306,364,422,183,174,216,305,97,3700,1761
206,882,817,65,177,218,80,112,112,183,75,1874,957
207,1305,1209,96,261,322,119,165,166,272,230,2772,1535
208,660,595,65,122,118,80,77,95,168,59,1442,719
209,742,669,73,138,133,90,87,106,188,103,1621,845
210,666,600,66,123,119,81,78,96,169,42,1455,708
211,843,760,83,156,151,102,98,121,215,281,1842,1124
212,750,661,89,101,146,85,75,130,213,10,1635,760
213,500,441,59,67,97,57,50,86,143,58,1090,558
214,615,542,73,83,120,70,61,106,175,10,1340,625
215,905,798,107,122,176,103,90,156,258,21,1971,926
216,770,681,89,100,191,96,77,121,185,26,1667,796
217,1062,940,122,139,263,133,106,166,255,0,2301,1062
218,1205,949,256,135,147,127,126,204,466,5,2919,1210
219,1258,991,267,141,154,132,132,213,486,0,3045,1258
220,666,525,141,74,81,70,70,113,258,3,1613,669
221,619,488,131,69,76,65,65,105,239,1,1499,620
222,706,556,150,79,86,74,74,119,274,1,1710,707
223,626,493,133,71,75,59,66,105,250,8,1638,634
224,813,641,172,92,98,76,86,136,325,0,2129,813
225,578,455,123,65,69,54,61,97,232,80,1514,658
226,584,517,67,76,145,73,58,92,140,94,1265,678
227,405,358,47,53,100,51,41,63,97,2,877,407
228,1982,1820,162,301,356,231,186,341,567,0,3918,1982
229,1212,1113,99,184,217,141,114,208,348,0,2397,1212
230,1726,1626,100,179,324,211,139,327,546,0,3237,1726
231,445,419,26,46,83,54,36,84,142,0,835,445
232,681,642,39,71,128,83,55,129,215,0,1278,681
233,0,0,0,0,0,0,0,0,0,91,0,91
234,77,48,29,8,9,7,8,13,32,7,242,84
235,531,450,81,65,87,58,49,96,176,0,1156,531
236,0,0,0,0,0,0,0,0,0,0,0,0
237,50,49,1,4,10,5,4,9,18,84,69,134
238,843,791,52,151,150,88,97,133,224,85,1917,928
239,1417,1341,76,188,152,157,134,256,530,0,2619,1417
240,1614,1323,291,176,188,162,153,319,616,21,3453,1635
241,896,774,122,101,92,88,73,180,362,0,1833,896
242,1755,1157,598,175,131,201,176,321,751,70,6008,1825
243,1629,1532,97,224,205,190,118,333,559,140,3299,1769
244,1367,1078,289,148,167,163,116,261,512,0,3121,1367
245,1172,699,473,109,89,115,114,227,518,34,4346,1206
246,1343,1054,289,112,137,146,138,254,556,0,3471,1343
247,994,275,719,110,97,108,72,198,409,0,3595,994
248,1067,889,178,158,152,130,103,196,328,6,2208,1073
249,943,739,204,159,131,109,104,164,276,62,2036,1005
250,2271,1893,378,337,323,276,218,418,699,43,4700,2314
251,1784,1621,163,195,305,196,174,367,547,14,3492,1798
252,516,469,47,57,88,57,50,106,158,3,1011,519
253,1053,957,96,115,180,116,103,217,322,18,2061,1071
254,493,450,43,56,65,55,39,100,178,0,966,493
255,506,462,44,57,67,57,40,103,182,6,992,512
256,1071,978,93,121,141,120,85,218,386,4,2100,1075
257,1030,941,89,116,136,116,82,210,370,0,2019,1030
258,637,558,79,59,81,77,64,128,228,3,1298,640
259,1256,1100,156,116,159,151,126,252,452,43,2559,1299
260,1788,1566,222,165,226,215,180,359,643,17,3643,1805
261,1520,1093,427,209,130,149,128,333,571,140,4164,1660
262,1070,769,301,147,92,105,90,234,402,44,2931,1114
263,907,652,255,125,78,89,77,199,339,0,2484,907
264,833,599,234,115,71,82,70,183,312,1,2283,834
265,696,519,177,72,55,78,54,143,294,0,1860,696
266,651,485,166,68,52,73,51,134,273,1,1738,652
267,1033,770,263,107,82,116,80,213,435,1,2759,1034
268,1311,977,334,136,104,148,102,270,551,89,3503,1400
269,482,398,84,54,45,51,45,93,194,191,1045,673
270,1011,804,207,102,124,97,106,195,387,0,2400,1011
271,522,321,201,53,49,61,48,102,209,58,1673,580
272,764,385,379,91,69,82,72,148,302,11,3261,775
273,607,255,352,80,49,83,52,107,236,147,2289,754
274,291,89,202,52,13,46,15,55,110,0,970,291
275,753,622,131,85,70,80,70,145,303,41,1632,794
276,520,430,90,59,48,55,49,100,209,0,1128,520
277,558,461,97,63,52,59,52,107,225,8,1210,566
278,414,337,77,37,51,43,35,82,166,0,925,414
279,530,431,99,47,65,55,44,105,214,0,1185,530
280,687,559,128,61,84,71,58,136,277,0,1536,687
281,573,466,107,51,70,59,48,114,231,1,1281,574
282,516,420,96,42,53,54,46,109,212,1,1123,517
283,798,649,149,65,82,83,71,169,328,0,1737,798
284,650,529,121,53,67,68,58,137,267,0,1416,650
285,637,526,111,58,65,67,56,135,256,0,1418,637
286,443,366,77,40,45,47,39,94,178,0,986,443
287,505,417,88,46,51,53,45,107,203,0,1126,505
288,542,448,94,49,55,57,48,115,218,0,1207,542
289,573,473,100,52,58,61,51,121,230,64,1276,637
290,1205,1040,165,135,123,119,99,242,487,0,2466,1205
291,951,821,130,107,97,94,78,191,384,0,1946,951
292,721,574,147,73,89,69,76,139,275,0,1711,721
293,396,315,81,40,49,38,42,76,151,0,940,396
294,542,430,112,39,57,53,59,105,229,0,1264,542
295,377,299,78,27,40,37,41,73,159,0,878,377
296,627,357,270,58,55,72,60,124,258,57,2484,684
297,631,367,264,60,45,71,64,125,266,27,2478,658
298,242,98,144,27,11,40,12,45,107,172,789,414
299,5890,2409,3481,1201,778,777,603,932,1599,0,19302,5890
300,616,488,128,44,65,60,67,119,261,36,1435,652
301,540,428,112,39,57,53,58,104,229,0,1260,540
302,3245,2871,374,328,392,403,284,628,1210,1,6428,3246
303,2011,1779,232,203,243,250,176,389,750,5,3983,2016
304,2286,1469,817,309,202,274,170,471,860,45,6691,2331
305,1281,823,458,173,113,154,95,264,482,31,3748,1312
306,776,678,98,87,90,85,61,150,303,66,1720,842
307,1613,1037,576,218,143,193,120,332,607,18,4720,1631
308,641,360,281,63,59,66,46,145,262,20,2264,661
309,1072,660,412,108,101,124,99,209,431,19,3436,1091
310,483,297,186,49,45,56,44,94,195,0,1547,483
311,456,256,200,45,42,47,33,103,186,25,1611,481
312,271,203,68,35,28,34,23,54,97,50,801,321
313,566,318,248,55,52,58,41,128,232,0,1998,566
314,443,231,212,49,29,49,29,103,184,71,1520,514
315,402,209,193,45,27,45,26,93,166,24,1381,426
316,795,401,394,95,72,85,75,154,314,38,3392,833
317,552,283,269,63,38,61,38,120,232,11,1784,563
318,567,286,281,68,51,61,53,110,224,0,2421,567
319,1257,894,363,105,140,120,138,231,523,0,3731,1257
320,397,277,120,37,43,35,32,79,171,5,1176,402
321,330,230,100,31,36,29,27,66,141,0,977,330
322,284,90,194,39,26,33,27,46,113,27,1116,311
323,418,132,286,57,38,48,39,67,169,15,1646,433
324,566,431,135,39,54,53,56,117,247,60,1485,626
325,523,398,125,36,50,49,51,108,229,22,1372,545
326,406,179,227,37,44,55,41,74,155,0,1857,406
327,1187,310,877,160,109,124,88,236,470,0,4871,1187
328,623,162,461,84,57,65,46,124,247,0,2555,623
329,367,268,99,25,38,39,29,71,165,23,941,390
330,681,497,184,47,71,73,53,131,306,36,1746,717
331,450,328,122,31,47,48,35,86,203,32,1155,482
332,640,487,153,44,62,59,63,132,280,175,1679,815
333,2490,1770,720,209,277,238,272,458,1036,4,7389,2494
334,2185,1553,632,183,243,208,239,402,910,0,6485,2185
335,677,507,170,57,68,60,73,128,291,0,1840,677
336,713,534,179,60,71,63,77,135,307,0,1938,713
337,590,442,148,50,59,53,63,112,253,0,1604,590
338,454,340,114,38,45,40,49,86,196,3,1235,457
339,250,187,63,21,25,22,27,47,108,0,679,250
340,552,313,239,40,54,48,60,106,244,22,2197,574
341,284,161,123,20,28,24,31,55,126,0,1129,284
342,443,252,191,32,43,38,49,85,196,22,1761,465
343,428,243,185,31,42,37,47,82,189,13,1704,441
344,466,265,201,33,45,40,51,90,207,59,1855,525
345,716,545,171,49,69,66,70,148,314,37,1879,753
346,1005,755,250,78,106,108,80,206,427,43,2599,1048
347,496,372,124,38,52,53,39,102,212,34,1283,530
348,387,291,96,30,41,41,31,79,165,17,1000,404
349,372,279,93,29,39,40,30,76,158,92,963,464
350,385,268,117,36,42,34,31,76,166,5,1141,390
351,785,537,248,61,82,73,63,163,343,0,2512,785
352,722,456,266,58,69,74,62,152,307,5,2073,727
353,880,603,277,68,92,82,70,182,386,22,2816,902
354,353,223,130,28,33,36,30,74,152,0,1011,353
355,600,427,173,50,61,72,47,123,247,581,2126,1181
356,528,345,183,36,59,46,57,110,220,29,1941,557
357,423,276,147,29,47,37,46,88,176,0,1556,423
358,490,320,170,34,55,43,53,102,203,0,1804,490
359,590,385,205,41,66,52,64,123,244,0,2171,590
360,410,268,142,28,46,36,45,86,169,54,1508,464
361,366,239,127,25,41,32,40,76,152,7,1349,373
362,528,316,212,47,46,60,55,105,215,6,2054,534
363,509,305,204,45,44,58,53,101,208,0,1983,509
364,378,226,152,34,33,43,39,75,154,4,1469,382
365,373,223,150,33,33,42,39,74,152,0,1453,373
366,257,153,104,30,19,30,23,49,106,28,942,285
367,382,227,155,44,29,44,33,72,160,0,1399,382
368,1291,851,440,129,97,148,129,236,552,8,4418,1299
369,401,264,137,40,30,46,40,73,172,0,1374,401
370,779,401,378,85,55,91,79,149,320,0,3172,779
371,819,466,353,86,65,84,80,171,333,0,3381,819
372,899,507,392,72,71,106,89,173,388,0,3746,899
373,541,278,263,59,39,63,55,103,222,4,2205,545
374,379,270,109,32,38,45,30,78,156,0,1342,379
375,1019,689,330,82,111,100,99,203,424,7,3988,1026
376,193,131,62,15,21,19,19,38,81,0,757,193
377,361,244,117,29,39,35,35,72,151,0,1414,361
378,224,151,73,18,24,22,22,45,93,0,877,224
379,587,349,238,48,64,43,61,124,247,15,2493,602
380,466,277,189,38,51,34,48,99,196,11,1982,477
381,393,234,159,32,43,29,41,83,165,0,1670,393
382,392,233,159,32,43,29,41,83,164,21,1665,413
383,395,235,160,32,43,29,41,84,166,45,1679,440
384,283,162,121,27,26,32,29,50,119,0,1136,283
385,400,228,172,42,32,41,39,84,162,15,1652,415
386,366,209,157,34,33,41,37,64,157,0,1465,366
387,370,221,149,35,28,36,36,72,163,0,1370,370
388,303,172,131,32,24,31,30,63,123,2,1249,305
389,443,253,190,42,40,50,45,78,188,0,1775,443
390,832,475,357,107,65,106,76,164,314,0,3459,832
391,512,257,255,52,61,57,44,102,196,24,2191,536
392,557,280,277,56,66,61,47,111,216,0,2388,557
393,432,375,57,50,61,48,43,76,154,40,961,472
394,636,551,85,74,90,71,63,111,227,112,1415,748
395,460,399,61,53,65,51,46,80,165,1,1023,461
396,789,684,105,91,112,88,79,138,281,17,1756,806
397,2699,2237,462,316,308,290,269,470,1046,502,5931,3201
398,2244,1860,384,263,256,241,223,390,871,0,4932,2244
399,2333,2152,181,450,385,293,242,367,596,19,4610,2352
400,1939,1661,278,334,254,237,198,342,574,0,3830,1939
401,577,515,62,133,90,83,56,90,125,0,1140,577
402,994,824,170,116,114,107,99,173,385,0,2185,994
403,4536,2549,1987,465,576,425,443,836,1791,0,15358,4536
404,840,472,368,86,107,79,82,155,331,0,2845,840
405,633,552,81,77,59,68,53,120,256,0,1464,633
406,1666,1576,90,221,179,185,157,301,623,0,3080,1666
407,1480,1291,189,179,138,160,124,280,599,1248,3425,2728
408,857,748,109,96,99,93,67,166,336,0,1901,857
409,12,9,3,2,1,2,1,2,4,617,37,629
410,607,311,296,69,42,67,42,132,255,1,1961,608
411,376,193,183,43,26,41,26,82,158,46,1215,422
412,816,422,394,86,70,108,87,145,320,0,3127,816
413,463,240,223,49,39,61,49,83,182,0,1775,463
414,326,206,120,26,31,34,28,68,139,17,936,343
415,602,335,267,61,47,68,50,111,265,0,2428,602
416,742,414,328,75,59,83,61,136,328,0,2997,742
417,989,558,431,80,79,116,98,191,425,8,4122,997
418,843,490,353,81,60,95,85,167,355,72,3310,915
419,706,403,303,90,56,90,64,139,267,73,2937,779
420,424,154,270,45,39,52,45,75,168,8,1945,432
421,313,114,199,33,28,38,33,56,125,0,1432,313
422,482,153,329,66,44,56,45,77,194,115,1896,597
423,712,674,38,94,76,79,67,129,267,0,1315,712
424,539,510,29,71,58,60,51,97,202,0,996,539
425,874,827,47,116,94,97,83,158,326,1,1615,875
426,1236,1082,154,175,110,149,96,246,460,10,2585,1246
427,802,702,100,113,71,96,63,160,299,0,1679,802
428,599,341,258,55,53,69,57,119,246,23,2370,622
429,417,238,179,38,37,48,40,83,171,1,1652,418
430,417,238,179,38,37,48,40,83,171,12,1652,429
431,460,262,198,42,40,53,44,91,190,10,1822,470
432,838,525,313,64,95,79,89,154,357,45,3236,883
433,751,471,280,57,85,71,80,138,320,64,2900,815
434,327,205,122,25,37,31,35,60,139,23,1264,350
435,343,215,128,26,39,32,36,63,147,0,1324,343
436,406,255,151,31,46,38,43,75,173,0,1567,406
437,475,298,177,36,54,45,51,87,202,0,1833,475
438,1154,464,690,156,98,116,112,215,457,95,4399,1249
439,1800,1380,420,259,302,216,180,351,492,13,4840,1813
440,2258,1769,489,381,314,260,249,392,662,186,4873,2444
441,816,639,177,138,114,94,90,142,238,128,1761,944
442,132,101,31,19,22,16,13,26,36,233,355,365
443,893,699,194,151,124,103,98,155,262,21,1928,914
444,2873,2395,478,426,409,350,276,529,883,75,5944,2948
445,2641,1737,904,291,241,335,238,491,1045,2,6535,2643
446,2677,1761,916,295,245,339,241,497,1060,5,6626,2682
447,817,537,280,90,75,104,74,152,322,0,2022,817
448,247,223,24,28,30,22,21,48,98,23,524,270
449,638,364,274,59,56,73,61,127,262,1,2528,639
450,0,0,0,0,0,0,0,0,0,0,0,0
451,2809,2538,271,317,345,251,243,549,1104,18,5967,2827
452,2455,2193,262,566,383,353,237,381,535,103,4850,2558
453,1356,1040,316,195,227,163,136,264,371,104,3647,1460
454,918,704,214,132,154,110,92,179,251,8,2468,926
455,0,0,0,0,0,0,0,0,0,4,0,4
456,204,156,48,29,34,25,20,40,56,25,549,229
457,1641,1406,235,282,215,201,168,289,486,154,3241,1795
458,1986,1774,212,458,310,286,192,308,432,27,3923,2013
459,723,667,56,140,119,91,75,114,184,205,1428,928
460,338,253,85,44,35,43,29,67,120,0,999,338
461,346,259,87,45,36,44,29,69,123,0,1023,346
462,69,61,8,7,8,9,6,13,26,0,137,69
463,6746,5968,778,681,816,838,590,1306,2515,46,13364,6792
464,1464,1295,169,148,177,182,128,283,546,4,2900,1468
465,629,556,73,64,76,78,55,122,234,0,1246,629
466,0,0,0,0,0,0,0,0,0,0,0,0
467,6984,6310,674,788,858,625,603,1365,2745,0,14837,6984
468,0,0,0,0,0,0,0,0,0,32,0,32
469,19,17,2,2,2,2,2,4,7,3,40,22
470,1328,1200,128,150,163,119,115,259,522,3,2822,1331
471,152,137,15,17,19,14,13,30,59,8,323,160
472,0,0,0,0,0,0,0,0,0,0,0,0
473,4175,3772,403,471,513,374,361,816,1640,0,8870,4175
474,465,201,264,60,39,58,37,86,185,0,1428,465
475,803,348,455,103,68,100,65,149,318,8,2465,811
476,1420,436,984,252,64,226,73,267,538,3,4731,1423
477,444,196,248,41,48,60,45,81,169,0,2032,444
478,1061,468,593,97,114,143,107,193,407,0,4851,1061
479,1060,276,784,143,97,110,79,211,420,0,4351,1060
480,988,258,730,133,91,103,74,196,391,0,4053,988
481,354,112,242,49,32,41,33,57,142,1,1392,355
482,60,34,26,6,5,7,6,11,25,0,241,60
483,7761,4362,3399,796,986,727,757,1430,3065,0,26278,7761
484,3642,2047,1595,373,463,341,355,671,1439,10,12332,3652
485,184,124,60,15,20,18,18,37,76,10,719,194
486,301,204,97,24,33,30,29,60,125,0,1180,301
487,287,187,100,20,32,25,31,60,119,0,1056,287
488,704,553,151,59,72,77,72,133,291,0,1821,704
489,678,532,146,56,69,74,69,128,282,0,1753,678
490,365,326,39,84,57,53,35,57,79,998,722,1363
491,612,442,170,50,77,47,66,113,259,0,1693,612
492,1292,975,317,129,146,116,138,236,527,0,3310,1292
493,1112,823,289,95,132,107,116,194,468,93,3120,1205
494,271,201,70,23,32,26,28,47,115,11,761,282
495,332,246,86,28,39,32,35,58,140,0,930,332
496,408,302,106,35,48,39,43,71,172,21,1145,429
497,446,309,137,36,51,40,46,80,193,2,1348,448
498,327,227,100,27,37,29,34,58,142,0,988,327
499,367,255,112,30,42,33,38,66,158,0,1109,367
500,350,243,107,28,40,32,36,63,151,0,1059,350
501,579,402,177,47,66,52,60,103,251,12,1752,591
502,409,284,125,33,47,37,42,73,177,0,1236,409
503,338,235,103,27,39,30,35,60,147,8,1024,346
504,374,276,98,42,46,34,40,76,136,4,1108,378
505,627,462,165,70,77,57,67,127,229,0,1860,627
506,334,246,88,37,41,30,36,68,122,9,990,343
507,502,370,132,56,62,45,53,102,184,0,1488,502
508,308,227,81,34,38,28,33,62,113,0,913,308
509,298,220,78,33,37,27,32,60,109,0,883,298
510,263,194,69,29,32,24,28,53,97,0,782,263
511,477,347,130,41,61,42,44,85,204,0,1468,477
512,534,388,146,45,69,47,49,96,228,0,1644,534
513,655,476,179,56,84,58,61,117,279,30,2016,685
514,422,307,115,36,54,37,39,76,180,0,1299,422
515,583,424,159,50,75,52,54,104,248,65,1795,648
516,451,328,123,38,58,40,42,81,192,11,1390,462
517,562,431,131,51,62,52,57,102,238,18,1665,580
518,311,238,73,28,34,29,32,57,131,0,921,311
519,396,303,93,36,44,36,40,72,168,0,1173,396
520,241,185,56,22,27,22,24,44,102,0,715,241
521,861,681,180,93,105,86,89,165,323,0,2263,861
522,682,539,143,74,83,68,71,130,256,45,1793,727
523,663,488,175,73,68,69,61,128,264,0,2066,663
524,617,454,163,68,64,64,57,119,245,6,1923,623
525,482,355,127,53,50,50,44,93,192,0,1501,482
526,385,283,102,42,40,40,35,74,154,6,1200,391
527,373,274,99,41,38,39,34,72,149,0,1161,373
528,353,260,93,39,36,37,33,68,140,0,1101,353
529,499,367,132,55,51,52,46,96,199,0,1555,499
530,681,538,143,73,83,68,70,130,257,0,1790,681
531,409,300,109,39,46,43,33,85,163,0,1256,409
532,354,260,94,34,40,37,29,74,140,0,1086,354
533,401,294,107,38,45,42,33,83,160,0,1231,401
534,351,257,94,34,40,37,29,73,138,0,1077,351
535,572,407,165,59,66,51,55,110,231,0,1811,572
536,388,276,112,40,44,35,37,74,158,22,1229,410
537,676,482,194,70,77,60,64,130,275,0,2141,676
538,415,296,119,43,48,37,40,80,167,6,1316,421
539,562,400,162,58,64,50,54,108,228,0,1781,562
540,356,254,102,37,41,32,34,68,144,0,1128,356
541,521,379,142,50,52,51,43,107,218,0,1583,521
542,446,325,121,43,44,44,37,92,186,0,1357,446
543,474,345,129,46,47,47,39,97,198,0,1442,474
544,473,344,129,46,47,47,39,97,197,7,1439,480
545,1038,865,173,105,117,108,95,189,424,0,2389,1038
546,589,491,98,60,66,61,54,107,241,4,1357,593
547,961,768,193,109,106,94,85,196,371,0,2457,961
548,684,570,114,69,77,71,62,125,280,0,1574,684
549,923,780,143,105,110,104,91,175,338,0,2051,923
550,994,840,154,113,118,112,98,188,365,26,2208,1020
551,609,487,122,69,67,59,54,124,236,0,1556,609
552,2842,2687,155,286,219,329,236,603,1169,2,7264,2844
553,782,625,157,89,86,76,69,159,303,97,2000,879
554,503,367,136,51,61,47,51,89,204,0,1404,503
555,535,428,107,61,59,52,47,109,207,0,1369,535
556,509,371,138,51,62,48,52,90,206,0,1421,509
557,257,180,77,25,30,23,26,48,105,0,733,257
558,476,333,143,46,56,43,48,89,194,0,1359,476
559,423,296,127,41,50,38,42,79,173,0,1207,423
560,369,258,111,36,44,33,37,69,150,0,1053,369
561,315,228,87,25,39,24,34,58,135,10,871,325
562,899,666,233,77,107,86,94,157,378,11,2522,910
563,752,635,117,85,90,85,74,142,276,17,1671,769
564,486,354,132,49,59,46,49,86,197,0,1356,486
565,394,267,127,35,42,32,42,73,170,15,1303,409
566,614,415,199,55,66,49,65,114,265,10,2031,624
567,459,311,148,41,49,37,49,85,198,0,1519,459
568,557,377,180,50,60,45,59,104,239,0,1844,557
569,540,365,175,48,58,43,58,101,232,0,1788,540
570,539,365,174,48,58,43,57,100,233,0,1785,539
571,942,726,216,111,106,98,94,173,360,8,2603,950
572,859,662,197,102,97,90,85,158,327,0,2375,859
573,688,530,158,81,78,72,68,126,263,8,1903,696
574,822,633,189,97,93,86,82,151,313,29,2272,851
575,617,475,142,73,70,64,61,113,236,0,1706,617
576,465,358,107,55,52,48,46,85,179,11,1285,476
577,598,455,143,61,69,63,51,106,248,0,1827,598
578,734,558,176,75,85,78,62,131,303,198,2243,932
579,447,340,107,46,52,47,38,80,184,0,1365,447
580,534,406,128,55,62,57,45,95,220,0,1632,534
581,617,469,148,63,72,65,52,110,255,0,1885,617
582,467,355,112,48,54,50,39,83,193,0,1426,467
583,458,333,125,47,49,42,44,90,186,0,1450,458
584,495,360,135,51,53,45,47,98,201,0,1567,495
585,564,410,154,58,60,52,54,111,229,0,1785,564
586,729,530,199,75,78,67,70,144,295,19,2308,748
587,455,331,124,47,49,42,44,90,183,0,1440,455
588,493,359,134,51,53,45,47,97,200,19,1561,512
589,518,377,141,53,55,48,50,102,210,0,1640,518
590,1856,1400,456,186,209,167,199,338,757,0,4755,1856
591,410,309,101,41,46,37,44,75,167,0,1052,410
592,1838,1387,451,184,207,165,197,335,750,0,4708,1838
593,1074,810,264,108,121,97,115,196,437,0,2751,1074
594,609,447,162,58,69,64,50,127,241,0,1870,609
595,653,475,178,63,65,64,54,134,273,0,1985,653
596,361,323,38,38,40,37,34,70,142,4,656,365
597,0,0,0,0,0,0,0,0,0,0,0,0
598,335,227,108,30,36,27,36,62,144,0,1107,335
599,1406,1061,345,141,159,126,150,256,574,0,3601,1406
600,63,60,3,6,5,7,5,13,27,3014,160,3077
601,219,162,57,19,26,21,23,38,92,0,613,219
602,577,403,174,56,68,52,58,108,235,0,1647,577
603,648,598,50,125,107,81,67,102,166,0,1281,648
604,73,67,6,14,12,9,8,11,19,0,145,73
605,4644,4284,360,896,767,583,483,730,1185,0,9177,4644
606,30,28,2,6,5,4,3,5,7,0,60,30
607,439,402,37,156,79,68,26,58,52,67,750,506
608,143,131,12,51,26,22,8,19,17,23,244,166
609,128,117,11,46,23,20,7,17,15,13,218,141
610,833,813,20,249,187,94,102,92,109,9,1348,842
611,0,0,0,0,0,0,0,0,0,3,0,3
612,368,359,9,110,83,41,45,41,48,0,595,368
613,130,128,2,37,32,13,17,14,17,0,212,130
614,231,228,3,65,57,22,30,26,31,13,379,244
615,518,509,9,133,137,60,54,68,66,7,843,525
616,2360,1513,847,158,274,231,244,439,1014,0,7139,2360
617,691,517,174,57,59,66,72,121,316,0,1868,691
618,1577,976,601,105,150,127,171,320,704,181,5689,1758
619,1552,910,642,113,133,157,155,297,697,0,5142,1552
620,2460,1489,971,158,237,240,271,427,1127,8,7084,2468
621,11,7,4,1,0,2,1,3,4,0,36,11
622,3462,2671,791,280,327,352,382,630,1491,8,8562,3470
623,1348,854,494,104,125,113,150,262,594,0,4579,1348
624,1303,714,589,96,128,116,129,252,582,22,5075,1325
625,1965,1322,643,165,194,210,200,384,812,10,6493,1975
626,1342,782,560,81,134,129,118,279,601,25,5488,1367
627,590,382,208,40,68,56,56,112,258,0,1962,590
628,1714,981,733,112,188,165,159,360,730,10,6780,1724
629,685,366,319,56,68,70,72,137,282,19,2355,704
630,4557,2601,1956,344,394,444,484,846,2045,4,15065,4561
631,2019,1128,891,115,217,197,231,360,899,31,6654,2050
632,1660,1144,516,97,141,183,179,295,765,97,4253,1757
633,2271,1655,616,153,213,218,238,416,1033,45,5391,2316
634,1249,820,429,72,127,111,140,248,551,0,3573,1249
635,1487,904,583,91,175,135,158,284,644,0,4256,1487
636,2060,1328,732,155,205,217,211,387,885,0,5832,2060
637,1723,1028,695,110,167,142,186,350,768,24,6034,1747
638,1730,1080,650,121,152,154,167,352,784,298,5707,2028
639,332,236,96,21,32,28,38,63,150,0,928,332
640,908,625,283,49,93,69,84,193,420,0,2775,908
641,635,421,214,37,74,55,65,121,283,20,1945,655
642,546,400,146,41,58,56,60,101,230,3,1532,549
643,450,320,130,30,43,45,56,89,187,48,1240,498
644,1983,1060,923,101,218,185,206,374,899,38,7404,2021
645,11628,6485,5143,1884,2521,874,1086,1835,3428,1,43567,11629
646,2324,1289,1035,159,236,222,230,468,1009,149,7843,2473
647,3263,1275,1988,300,305,282,357,642,1377,0,13590,3263
648,982,697,285,74,96,96,107,176,433,0,2681,982
649,421,283,138,32,41,39,47,84,178,0,1258,421
650,380,256,124,29,37,35,43,76,160,1,1137,381
651,415,279,136,31,41,39,47,83,174,0,1240,415
652,1360,1122,238,111,109,130,136,282,592,0,2613,1360
653,930,551,379,78,98,81,89,191,393,106,3193,1036
654,2609,1019,1590,240,244,225,285,513,1102,0,10866,2609
655,1283,712,571,88,130,123,127,258,557,16,4328,1299
656,9733,6709,3024,664,1200,1012,1103,1805,3949,342,26887,10075
657,1085,602,483,74,110,104,107,219,471,16,3661,1101
658,1459,1037,422,97,138,145,183,290,606,382,4020,1841
659,528,313,215,44,55,46,50,108,225,50,1813,578
660,715,423,292,60,75,62,68,147,303,0,2455,715
661,982,624,358,80,95,83,104,194,426,25,3258,1007
662,821,318,503,59,94,77,86,162,343,0,3325,821
663,573,222,351,41,66,54,60,113,239,0,2322,573
664,4885,3683,1202,439,616,502,558,904,1866,22,12556,4907
665,427,329,98,29,53,47,41,82,175,0,1011,427
666,4436,2546,1890,321,570,472,476,839,1758,52,14480,4488
667,762,558,204,57,81,79,84,142,319,39,2139,801
668,449,319,130,30,43,45,56,89,186,0,1236,449
669,717,278,439,52,83,68,75,142,297,32,2904,749
670,3958,2113,1845,325,395,403,415,790,1630,106,13616,4064
671,1052,786,266,86,90,101,110,184,481,24,2843,1076
672,2051,1458,593,137,194,204,257,407,852,60,5653,2111
673,668,475,193,45,63,67,84,133,276,0,1841,668
674,3898,3006,892,265,487,431,370,748,1597,0,9227,3898
675,236,148,88,13,24,21,25,45,108,0,712,236
676,448,282,166,24,46,39,47,86,206,0,1354,448
677,405,255,150,22,41,35,42,78,187,17,1223,422
678,1385,888,497,93,161,136,143,258,594,0,4187,1385
679,659,361,298,49,65,59,65,128,293,0,2566,659
680,551,342,209,51,50,63,48,111,228,8,1598,559
681,456,283,173,42,41,52,40,92,189,0,1323,456
682,361,227,134,19,37,31,38,69,167,0,1092,361
683,796,374,422,63,83,73,86,159,332,0,3278,796
684,1365,642,723,109,143,124,147,272,570,0,5624,1365
685,377,206,171,28,37,34,37,73,168,0,1469,377
686,803,411,392,67,79,80,78,156,343,0,3234,803
687,890,455,435,75,87,89,87,172,380,0,3585,890
688,651,334,317,33,77,67,60,132,282,13,2598,664
689,553,284,269,28,65,57,51,112,240,3,2204,556
690,1212,623,589,61,143,124,111,246,527,135,4831,1347
691,576,296,280,29,68,59,53,117,250,9,2298,585
692,6823,4644,2179,623,764,733,799,1188,2716,6,18215,6829
693,1044,752,292,85,116,116,94,203,430,0,3062,1044
694,5486,2965,2521,410,622,584,580,1019,2271,10,19046,5496
695,803,522,281,55,84,77,84,147,356,0,2332,803
696,311,202,109,21,33,30,33,57,137,6,904,317
697,9646,5981,3665,885,867,1102,838,1950,4004,0,27994,9646
698,1457,947,510,100,153,141,153,266,644,12,4232,1469
699,893,668,225,73,76,85,93,156,410,11,2414,904
700,4632,2659,1973,335,595,492,497,876,1837,0,15118,4632
701,4203,2413,1790,304,540,447,451,795,1666,30,13719,4233
702,666,417,249,52,70,71,59,129,285,0,2456,666
703,1171,734,437,92,124,125,104,227,499,27,4317,1198
704,1026,643,383,81,108,110,91,199,437,95,3782,1121
705,11678,8768,2910,1049,1485,1265,1266,2075,4538,0,26924,11678
706,2134,1381,753,146,245,202,202,405,934,18,7103,2152
707,581,413,168,44,57,57,63,104,256,7,1588,588
708,5445,3753,1692,371,671,566,617,1010,2210,0,15042,5445
709,1477,1018,459,101,182,154,167,274,599,0,4079,1477
710,765,543,222,48,74,65,88,145,345,14,2138,779
711,234,166,68,15,23,20,27,44,105,21,654,255
712,345,229,116,20,40,30,35,65,155,0,1057,345
713,552,305,247,35,56,63,55,108,235,16,2071,568
714,442,244,198,28,45,50,44,87,188,5,1656,447
715,851,471,380,53,86,97,84,167,364,0,3189,851
716,738,531,207,60,82,82,66,143,305,0,2165,738
717,442,292,150,32,44,43,48,80,195,0,1266,442
718,1080,714,366,79,108,106,118,196,473,0,3091,1080
719,556,368,188,40,56,55,61,101,243,11,1593,567
720,781,560,221,63,95,84,70,151,318,0,2400,781
721,2300,1320,980,167,296,244,247,435,911,115,7506,2415
722,1030,557,473,77,117,110,109,191,426,17,3577,1047
723,857,463,394,64,97,91,91,159,355,0,2975,857
724,0,0,0,0,0,0,0,0,0,0,0,0
725,0,0,0,0,0,0,0,0,0,106,0,106
726,463,256,207,29,47,53,46,91,197,0,1737,463
727,6844,4907,1937,550,828,734,617,1325,2790,0,21020,6844
728,1172,758,414,91,110,121,119,248,483,63,3820,1235
729,1090,705,385,85,102,112,110,231,450,45,3556,1135
730,1663,1057,606,135,160,140,177,328,723,0,5518,1663
731,501,374,127,41,43,48,52,88,229,24,1355,525
732,237,168,69,18,23,23,26,42,105,16,648,253
733,408,290,118,31,40,40,44,73,180,15,1114,423
734,34299,25861,8438,3083,4322,3523,3920,6345,13106,0,88166,34299
735,2550,2104,446,207,205,244,255,528,1111,0,4902,2550
736,53,44,9,4,4,5,5,11,24,0,102,53
737,10574,5897,4677,1713,2292,795,988,1669,3117,13,39615,10587
738,522,376,146,53,59,46,52,107,205,0,1377,522
739,1280,883,397,94,124,133,114,274,541,10,3501,1290
740,1441,1080,361,141,137,172,108,297,586,0,3657,1441
741,260,181,79,29,27,24,24,53,103,0,734,260
742,813,425,388,74,89,87,99,130,334,157,2824,970
743,342,191,151,24,50,33,30,72,133,40,1138,382
744,1928,1645,283,246,230,223,165,361,703,0,3872,1928
745,1225,851,374,118,138,121,108,258,482,0,3060,1225
746,1292,864,428,104,144,158,106,266,514,0,3600,1292
747,5619,4101,1518,573,640,607,454,1149,2196,0,13620,5619
748,790,406,384,61,99,90,58,159,323,3,2548,793
749,1368,823,545,103,184,135,102,282,562,111,3992,1479
750,2713,1836,877,183,359,287,345,479,1060,0,7815,2713
751,3475,2792,683,277,479,367,475,533,1344,0,8060,3475
752,409,250,159,26,39,44,42,80,178,0,1287,409
753,1461,838,623,103,156,167,130,257,648,0,4666,1461
754,626,409,217,36,88,61,71,108,262,6,1819,632
755,876,457,419,78,105,92,96,182,323,255,2505,1131
756,377,147,230,33,47,26,27,84,160,52,1449,429
757,1556,866,690,112,174,175,121,298,676,8,4497,1564
758,1423,907,516,110,175,190,123,290,535,0,4229,1423
759,1613,1082,531,138,197,159,124,352,643,22,4420,1635
760,2480,1509,971,203,221,264,210,513,1069,20,6979,2500
761,1804,857,947,169,158,169,115,423,770,31,6130,1835
762,2212,1132,1080,107,194,208,244,486,973,168,6485,2380
763,3738,2217,1521,352,412,393,334,754,1493,112,10789,3850
764,4378,2902,1476,374,623,447,584,688,1662,22,11471,4400
765,418,276,142,25,42,43,41,86,181,0,1163,418
766,335,221,114,20,34,34,33,69,145,0,933,335
767,273,180,93,16,27,28,27,56,119,0,761,273
768,1658,1385,273,137,155,164,175,313,714,225,3775,1883
769,957,799,158,79,89,95,101,181,412,23,2178,980
770,544,390,154,41,50,55,58,104,236,46,1396,590
771,2280,1631,649,161,305,210,272,420,912,11,6017,2291
772,1050,751,299,74,141,97,125,193,420,34,2771,1084
773,1042,745,297,74,140,96,125,192,415,0,2749,1042
774,750,626,124,62,70,74,79,142,323,7,1708,757
775,934,722,212,70,98,85,108,185,388,0,2336,934
776,597,315,282,38,70,59,77,107,246,12,2026,609
777,422,222,200,27,50,42,55,76,172,0,1431,422
778,294,155,139,19,34,29,38,53,121,8,995,302
779,471,195,276,40,54,47,69,69,192,0,1841,471
780,719,297,422,61,83,72,105,105,293,130,2812,849
781,710,293,417,60,82,71,104,104,289,35,2777,745
782,619,443,176,44,83,57,74,114,247,566,1634,1185
783,453,187,266,39,52,45,66,66,185,0,1771,453
784,1304,1058,246,137,152,133,144,244,494,230,2947,1534
785,1144,928,216,120,133,117,126,214,434,21,2585,1165
786,680,447,233,74,80,78,56,143,249,0,1896,680
787,1223,992,231,129,143,125,135,229,462,0,2764,1223
788,410,286,124,46,42,38,38,83,163,0,1157,410
789,454,317,137,50,46,42,42,92,182,0,1282,454
790,628,457,171,54,73,58,80,103,260,0,1622,628
791,945,687,258,82,111,88,120,155,389,0,2437,945
792,322,197,125,20,30,34,33,63,142,0,1014,322
793,1520,1175,345,115,160,139,176,301,629,18,3800,1538
794,2053,1289,764,200,224,221,178,419,811,70,5903,2123
795,1073,751,322,114,124,98,83,230,424,111,2706,1184
796,1488,1042,446,159,171,135,115,319,589,0,3751,1488
797,728,466,262,72,82,64,74,145,291,26,2058,754
798,883,633,250,67,80,90,95,168,383,37,2266,920
799,1016,728,288,77,93,103,109,194,440,1,2605,1017
800,433,310,123,33,39,44,47,83,187,8,1111,441
801,784,538,246,58,76,85,81,152,332,0,1984,784
802,383,263,120,28,37,41,39,74,164,0,968,383
803,999,685,314,74,97,108,103,194,423,0,2526,999
804,1726,1184,542,127,168,186,178,335,732,0,4366,1726
805,423,290,133,31,41,46,44,82,179,0,1070,423
806,610,391,219,61,69,53,62,122,243,57,1723,667
807,599,433,166,75,63,57,48,123,233,79,1483,678
808,1318,952,366,164,138,126,105,270,515,131,3259,1449
809,335,242,93,42,35,32,27,69,130,51,828,386
810,6436,4450,1986,728,786,643,583,1219,2477,8,16331,6444
811,2871,2473,398,227,279,335,289,521,1220,1,5620,2872
812,1891,1629,262,150,184,221,190,343,803,12,3702,1903
813,1305,1124,181,103,127,152,131,237,555,0,2554,1305
814,578,323,255,41,84,56,51,121,225,93,1929,671
815,324,169,155,29,36,35,40,52,132,24,1126,348
816,359,140,219,31,45,24,26,80,153,68,1379,427
817,740,485,255,78,93,75,49,167,278,0,2057,740
818,1390,912,478,146,174,141,93,314,522,0,3867,1390
819,661,413,248,51,88,68,59,127,268,23,1947,684
820,588,367,221,45,78,60,52,113,240,28,1731,616
821,323,202,121,25,43,33,29,62,131,38,952,361
822,325,203,122,25,43,33,29,62,133,0,959,325
823,1530,1134,396,156,173,188,134,297,582,0,3633,1530
824,343,210,133,21,32,37,35,67,151,0,1078,343
825,476,273,203,33,51,54,42,84,212,0,1519,476
826,1133,1002,131,110,120,120,132,212,439,0,2215,1133
827,908,555,353,57,86,97,93,177,398,0,2857,908
828,1054,758,296,107,118,93,105,215,416,0,2780,1054
829,746,660,86,73,79,79,87,139,289,0,1460,746
830,638,564,74,62,67,68,75,119,247,5,1247,643
831,857,758,99,83,90,91,100,160,333,54,1677,911
832,250,163,87,15,35,25,28,43,104,0,728,250
833,467,305,162,27,65,46,53,81,195,0,1358,467
834,673,443,230,73,79,77,55,141,248,20,1874,693
835,3912,2574,1338,426,461,447,322,821,1435,0,10898,3912
836,226,176,50,18,30,22,28,40,88,0,509,226
837,2258,1611,647,178,285,190,280,386,939,172,6005,2430
838,1659,1168,491,146,165,169,141,356,682,38,4926,1697
839,380,286,94,35,44,36,46,66,153,0,910,380
840,1585,841,744,138,195,150,149,339,614,22,5999,1607
841,2127,942,1185,198,306,241,166,450,766,129,9133,2256
842,1457,929,528,98,195,135,199,266,564,0,4188,1457
843,660,487,173,47,84,60,72,102,295,0,1799,660
844,1805,1252,553,109,298,160,227,302,709,35,5147,1840
845,2657,1710,947,165,346,246,331,491,1078,0,7167,2657
846,460,162,298,40,59,49,42,92,178,0,1972,460
847,1665,901,764,130,217,137,242,297,642,0,5354,1665
848,1076,709,367,74,142,103,149,191,417,39,3238,1115
849,827,529,298,54,116,89,77,172,319,87,2408,914
850,2232,492,1740,242,263,274,141,527,785,104,12141,2336
851,1795,445,1350,197,180,213,140,440,625,27,9205,1822
852,1896,1179,717,176,184,197,190,391,758,200,4939,2096
853,1097,822,275,101,132,120,102,212,430,0,2899,1097
854,1196,785,411,99,136,115,101,247,498,10,3649,1206
855,2018,1516,502,207,224,209,169,412,797,11,5445,2029
856,9335,8032,1303,1548,1436,964,852,1611,2924,8,22671,9343
857,2751,2043,708,207,261,255,247,603,1178,69,7478,2820
858,1268,900,368,88,111,119,121,263,566,0,3635,1268
859,1262,919,343,105,131,123,101,243,559,0,3605,1262
860,3121,2123,998,292,405,358,391,488,1187,41,8661,3162
861,2349,1581,768,183,326,245,325,398,872,43,6396,2392
862,3962,2824,1138,290,546,392,513,711,1510,105,11146,4067
863,2013,1528,485,197,239,178,170,410,819,27,5289,2040
864,789,538,251,76,91,78,73,151,320,0,2394,789
865,4683,1456,3227,623,887,551,329,966,1327,15,21790,4698
866,6853,2457,4396,620,993,842,508,1455,2435,77,30113,6930
867,3436,1784,1652,281,441,362,355,709,1288,36,10837,3472
868,2591,2256,335,291,350,294,257,472,927,57,5658,2648
869,224,153,71,22,26,22,21,43,90,539,679,763
870,495,338,157,48,57,49,46,95,200,0,1502,495
871,1196,665,531,81,183,117,160,204,451,0,3387,1196
872,447,298,149,28,63,43,60,82,171,0,1323,447
873,301,209,92,26,31,30,25,60,129,0,911,301
874,322,224,98,27,33,32,27,64,139,0,975,322
875,553,384,169,47,57,55,47,110,237,0,1677,553
876,1108,668,440,76,161,106,135,189,441,35,3385,1143
877,1009,630,379,59,126,87,130,182,425,0,2989,1009
878,771,481,290,45,96,66,100,139,325,3,2281,774
879,348,235,113,30,39,35,33,75,136,0,1053,348
880,721,561,160,58,95,71,91,128,278,0,1625,721
881,1989,1547,442,159,263,197,250,353,767,19,4481,2008
882,1507,1172,335,121,199,149,189,268,581,16,3396,1523
883,677,507,170,62,82,74,63,131,265,0,1788,677
884,165,97,68,13,19,15,12,37,69,758,534,923
885,357,210,147,28,40,31,27,81,150,0,1160,357
886,1140,858,282,105,132,109,139,197,458,0,2733,1140
887,401,302,99,37,47,38,49,69,161,25,961,426
888,3879,3378,501,436,524,439,384,706,1390,2,8470,3881
889,463,313,150,39,51,46,45,99,183,3,1397,466
890,1310,1184,126,157,143,140,136,244,490,0,2651,1310
891,1312,1186,126,157,144,141,137,245,488,0,2656,1312
892,1581,1429,152,189,173,169,165,295,590,160,3201,1741
893,1037,449,588,86,185,85,162,180,339,46,3757,1083
894,379,164,215,31,68,31,59,66,124,0,1373,379
895,16092,13380,2712,1926,2852,1777,1672,2840,5025,346,33382,16438
896,1176,855,321,103,157,114,105,252,445,0,3719,1176
897,508,179,329,44,65,54,46,101,198,0,2175,508
898,1554,1209,345,124,205,154,195,276,600,36,3501,1590
899,862,373,489,72,154,71,134,150,281,0,3122,862
900,398,306,92,82,142,49,37,46,42,125,992,523
901,273,210,63,56,97,33,26,31,30,0,678,273
902,567,315,252,38,87,55,76,97,214,13,1605,580
903,1255,884,371,90,152,108,142,229,534,0,3300,1255
904,669,445,224,43,94,65,89,123,255,8,1984,677
905,497,383,114,46,77,49,61,79,185,36,1213,533
906,1309,1009,300,122,202,128,161,208,488,12,3196,1321
907,602,464,138,56,93,59,74,96,224,9,1469,611
908,1011,586,425,71,184,96,142,171,347,0,3070,1011
909,667,235,432,58,85,72,60,133,259,340,2856,1007
910,785,300,485,66,136,81,109,131,262,2,3049,787
911,595,354,241,47,87,57,86,107,211,0,1875,595
912,1105,962,143,124,149,125,109,201,397,0,2412,1105
913,860,777,83,103,94,92,90,160,321,0,1741,860
914,650,248,402,55,112,67,91,108,217,37,2528,687
915,520,310,210,41,76,50,75,93,185,0,1640,520
916,761,453,308,61,112,73,110,136,269,38,2399,799
917,670,399,271,53,98,64,97,120,238,39,2113,709
918,2115,1549,566,172,322,210,223,385,803,0,5498,2115
919,661,484,177,54,101,66,70,120,250,0,1720,661
920,738,538,200,62,98,61,77,127,313,0,2044,738
921,5988,4111,1877,534,762,624,583,1115,2370,144,16595,6132
922,2172,1258,914,155,272,244,184,420,897,209,6723,2381
923,1584,940,644,131,188,162,140,320,643,1,4950,1585
924,2687,2020,667,224,293,305,256,527,1082,0,7083,2687
925,761,491,270,57,123,79,80,140,282,0,2222,761
926,3531,2205,1326,319,493,458,290,713,1258,0,9859,3531
927,570,398,172,52,75,59,50,107,227,0,1529,570
928,1050,637,413,82,125,113,88,206,436,0,3251,1050
929,10,7,3,3,2,1,1,1,2,3539,20,3549
930,2119,1298,821,159,229,202,177,407,945,13,6432,2132
931,648,555,93,74,102,74,59,121,218,24,1410,672
932,1037,750,287,86,141,115,98,215,382,28,2770,1065
933,1298,792,506,87,160,151,116,251,533,13,3933,1311
934,1104,709,395,81,123,131,101,204,464,0,3263,1104
935,1705,1219,486,158,184,176,169,343,675,0,4540,1705
936,1740,1083,657,129,219,191,157,344,700,10,5101,1750
937,1249,753,496,99,170,121,104,253,502,0,3602,1249
938,947,595,352,88,99,110,79,190,381,0,2913,947
939,0,0,0,0,0,0,0,0,0,0,0,0
940,1297,947,350,126,199,128,140,268,436,367,3165,1664
941,3129,2142,987,225,317,326,273,589,1399,304,8843,3433
942,2308,1662,646,220,399,266,203,424,796,10,6112,2318
943,1113,763,350,102,211,107,96,209,388,0,2844,1113
944,1034,693,341,85,173,105,111,188,372,0,2754,1034
945,4812,3863,949,402,813,510,506,911,1670,38,10530,4850
946,2129,1631,498,191,308,220,176,457,777,0,4951,2129
947,711,570,141,71,118,70,76,132,244,0,1541,711
948,4050,2601,1449,398,741,414,357,808,1332,20,10668,4070
949,785,629,156,78,130,78,84,145,270,0,1701,785
950,1607,1032,575,158,294,164,142,320,529,0,4234,1607
951,1172,939,233,117,194,116,125,217,403,0,2539,1172
952,7251,6547,704,761,1062,792,622,1444,2570,296,14253,7547
953,0,0,0,0,0,0,0,0,0,0,0,0
954,0,0,0,0,0,0,0,0,0,0,0,0
955,21966,14746,7220,5656,4587,2306,2388,2976,4053,24,42360,21990
956,1853,1166,687,130,274,209,127,359,754,7,5458,1860
957,3127,2823,304,328,458,341,268,623,1109,26,6148,3153
958,574,359,215,52,80,75,47,116,204,0,1603,574
959,2618,1942,676,251,404,295,198,545,925,0,6391,2618
960,697,613,84,111,137,80,88,130,151,3634,1028,4331
961,641,440,201,58,122,62,56,120,223,0,1639,641
962,1015,664,351,91,126,112,94,208,384,0,2854,1015
963,824,575,249,77,87,87,87,161,325,7,2308,831
964,2137,1577,560,194,347,241,204,389,762,0,5599,2137
965,2528,1865,663,230,411,285,241,460,901,0,6622,2528
966,1513,1116,397,138,246,171,144,275,539,14,3964,1527
967,806,501,305,60,102,89,73,159,323,0,2361,806
968,844,611,233,65,120,81,107,156,315,0,2301,844
969,1711,1099,612,168,313,175,151,341,563,0,4508,1711
970,966,699,267,80,132,107,91,200,356,0,2578,966
971,2381,1744,637,194,363,236,251,433,904,6,6190,2387
972,315,241,74,28,46,33,26,68,114,0,732,315
973,1489,1141,348,134,215,154,123,320,543,0,3462,1489
974,1010,677,333,83,169,103,108,183,364,0,2691,1010
975,385,309,76,32,65,41,40,73,134,0,842,385
976,1652,1061,591,162,302,169,146,329,544,0,4353,1652
977,3208,2149,1059,263,537,326,345,582,1155,36,8546,3244
978,198,170,28,23,31,23,18,37,66,0,431,198
979,935,668,267,87,101,96,93,188,370,83,2490,1018
980,851,729,122,97,133,97,77,159,288,0,1850,851
981,677,580,97,77,106,77,61,127,229,0,1472,677
982,523,362,161,42,88,62,44,108,179,0,1393,523
983,348,241,107,28,58,41,29,72,120,0,925,348
984,3946,3184,762,412,689,418,369,777,1281,0,8670,3946
985,910,631,279,73,152,107,76,187,315,0,2423,910
986,4249,3428,821,444,742,450,397,837,1379,0,9335,4249
987,1847,1338,509,143,262,176,234,342,690,0,5035,1847
988,3053,2463,590,319,533,324,285,601,991,0,6707,3053
989,2031,1639,392,212,355,215,190,400,659,3,4461,2034
990,363,252,111,29,61,43,30,75,125,21,967,384
991,0,0,0,0,0,0,0,0,0,0,0,0
992,846,510,336,67,115,82,70,171,341,4,2439,850
993,1237,917,320,118,191,140,93,258,437,0,3019,1237
994,474,300,174,42,51,51,42,99,189,0,1358,474
995,552,349,203,49,59,60,49,116,219,0,1579,552
996,287,182,105,26,31,31,25,60,114,0,820,287
997,274,173,101,25,29,30,24,57,109,0,785,274
998,1604,1448,156,168,235,175,138,319,569,95,3153,1699
999,824,589,235,77,89,85,82,166,325,0,2194,824
1000,0,0,0,0,0,0,0,0,0,0,0,0
1001,2756,2044,712,264,425,311,208,574,974,0,6725,2756
1002,456,287,169,32,67,51,31,88,187,0,1344,456
1003,452,274,178,35,54,49,38,89,187,0,1399,452
1004,423,256,167,33,50,45,36,83,176,18,1311,441
1005,1647,1062,585,123,267,170,172,303,612,0,4814,1647
1006,889,581,308,80,111,99,82,183,334,0,2499,889
1007,1121,733,388,100,139,124,103,230,425,94,3151,1215
1008,640,447,193,58,84,66,56,121,255,0,1715,640
1009,473,285,188,38,64,46,39,96,190,0,1364,473
1010,16829,11363,5466,1333,3152,1786,1863,3147,5548,34,47655,16863
1011,5086,3414,1672,1310,1062,534,553,689,938,0,9808,5086
1012,0,0,0,0,0,0,0,0,0,0,0,0
1013,5374,3512,1862,476,655,544,645,976,2078,20,15946,5394
1014,1560,996,564,128,171,140,213,254,654,0,4665,1560
1015,2093,1241,852,185,261,196,280,357,814,11,6518,2104
1016,1822,1052,770,161,240,167,228,301,725,0,5680,1822
1017,912,572,340,77,121,60,123,158,373,6,2749,918
1018,417,276,141,40,53,41,50,77,156,0,1184,417
1019,3312,2189,1123,317,423,323,400,609,1240,0,9399,3312
1020,8842,6411,2431,883,1111,912,985,1738,3213,11,23455,8853
1021,17027,13947,3080,1292,2695,1732,1721,3320,6267,3,39212,17030
1022,11148,6159,4989,2404,4102,1305,649,1371,1317,0,28447,11148
1023,10818,8665,2153,1953,2694,1278,1262,1571,2060,0,27277,10818
1024,893,385,508,76,108,59,112,144,394,32,3717,925
1025,2587,1693,894,251,300,242,268,555,971,7,7895,2594
1026,819,576,243,66,114,63,57,210,309,20,2692,839
1027,4900,3672,1228,462,649,454,430,1057,1848,0,13282,4900
1028,5362,4051,1311,571,621,458,467,1192,2053,8,14481,5370
1029,1370,764,606,112,183,117,171,251,536,0,4442,1370
1030,1585,1147,438,159,181,169,172,315,589,22,4102,1607
1031,2929,1883,1046,212,378,253,323,586,1177,0,8141,2929
1032,3250,1875,1375,262,406,323,385,606,1268,39,9450,3289
1033,2966,2022,944,281,368,286,341,533,1157,161,8506,3127
1034,1126,835,291,125,134,118,138,192,419,171,3159,1297
1035,10016,7662,2354,1057,1204,1010,1173,1906,3666,115,25253,10131
1036,1907,1391,516,187,224,195,219,378,704,0,4748,1907
1037,1543,1050,493,146,212,138,172,301,574,0,4219,1543
1038,1660,888,772,159,197,156,213,295,640,0,5702,1660
1039,7,5,2,3,2,1,0,0,1,0,19,7
1040,3001,1882,1119,272,366,285,297,655,1126,0,9126,3001
1041,16397,11502,4895,2840,3309,1987,1515,2894,3852,13,37940,16410
1042,1016,658,358,95,168,84,106,203,360,0,2538,1016
1043,12,12,0,6,4,1,0,0,1,0,0,12
1044,202,201,1,75,93,7,9,12,6,0,0,202
1045,0,0,0,0,0,0,0,0,0,0,0,0
1046,29006,26926,2080,3568,4470,2399,3220,6036,9313,25,62316,29031
1047,15802,11736,4066,3429,2765,1568,1471,2751,3818,0,39925,15802
1048,308,248,60,77,119,22,14,34,42,4,920,312
1049,1191,709,482,82,132,118,123,240,496,11,3844,1202
1050,0,0,0,0,0,0,0,0,0,0,0,0
1051,6976,5090,1886,662,1199,690,610,1335,2480,0,17308,6976
1052,14766,14550,216,5144,7516,30,1277,554,245,0,0,14766
1053,4,4,0,0,0,1,0,0,3,0,9,4
1054,5959,5803,156,2026,1613,228,597,656,839,0,0,5959
1055,1606,1073,533,188,157,156,98,419,588,0,5192,1606
1056,187,65,122,22,57,30,10,31,37,0,798,187
1057,16067,13114,2953,2196,2837,2004,1901,2736,4393,0,40281,16067
1058,3103,1671,1432,251,467,294,245,698,1148,604,12757,3707
1059,213,107,106,16,28,17,24,44,84,0,769,213
1060,2918,1755,1163,251,388,268,276,616,1119,0,8907,2918
1061,1997,1405,592,179,263,194,180,437,744,0,5834,1997
1062,1922,1383,539,169,250,146,195,433,729,17,5565,1939
1063,3698,2808,890,359,475,376,323,852,1313,27,9758,3725
1064,3070,2059,1011,278,374,282,346,591,1199,0,8631,3070
1065,2339,1569,770,211,285,215,264,450,914,0,6577,2339
1066,0,0,0,0,0,0,0,0,0,0,0,0
1067,59,44,15,13,10,6,5,10,15,0,149,59
1068,14411,10703,3708,3127,2522,1430,1342,2509,3481,0,36411,14411
1069,4228,2817,1411,387,623,418,479,820,1501,0,10507,4228
1070,13071,9708,3363,2836,2287,1297,1217,2276,3158,0,33026,13071
1071,2332,1527,805,336,504,184,209,428,671,0,6970,2332
1072,2120,1388,732,306,459,167,190,389,609,0,6338,2120
1073,3794,2842,952,392,476,398,450,715,1363,0,9509,3794
1074,712,501,211,64,94,69,64,156,265,5,2079,717
1075,1032,726,306,92,136,100,93,226,385,9,3015,1041
1076,480,338,142,43,63,47,43,105,179,0,1404,480
1077,4,3,1,1,0,0,0,1,2,0,9,4
1078,3383,2550,833,314,512,339,368,622,1228,0,7851,3383
1079,290,204,86,23,40,22,20,74,111,0,953,290
1080,707,511,196,71,81,75,77,141,262,2,1830,709
1081,3822,2757,1065,261,717,355,380,757,1352,0,9475,3822
1082,372,186,186,29,48,30,42,77,146,0,1343,372
1083,203,102,101,16,26,16,23,42,80,0,734,203
1084,1629,1246,383,172,196,164,191,310,596,0,4107,1629
1085,525,293,232,43,70,45,66,96,205,43,1701,568
1086,555,310,245,46,74,48,69,102,216,0,1800,555
1087,812,506,306,73,107,64,94,167,307,0,2362,812
1088,2811,1912,899,266,386,251,314,548,1046,0,7686,2811
1089,1327,903,424,126,182,119,148,259,493,0,3628,1327
1090,641,399,242,57,85,51,75,132,241,13,1866,654
1091,1546,1052,494,147,212,138,173,301,575,0,4225,1546
1092,695,556,139,76,85,69,77,137,251,0,1641,695
1093,3426,2301,1125,340,431,306,326,769,1254,0,10361,3426
1094,2033,1331,702,293,440,160,182,373,585,0,6075,2033
1095,5999,4964,1035,626,803,423,700,1267,2180,13,15577,6012
1096,3251,2212,1039,308,447,291,363,634,1208,0,8889,3251
1097,1585,1268,317,172,193,158,175,312,575,4,3742,1589
1098,6402,5123,1279,696,778,638,706,1259,2325,0,15113,6402
1099,725,504,221,64,94,78,92,132,265,126,2060,851
1100,639,444,195,56,83,69,81,116,234,0,1817,639
1101,1297,901,396,114,168,140,164,235,476,0,3685,1297
1102,990,722,268,97,116,101,114,196,366,0,2464,990
1103,578,388,190,52,70,53,65,111,227,0,1624,578
1104,1115,813,302,109,131,114,128,221,412,0,2776,1115
1105,1821,1142,679,165,222,173,180,397,684,15,5538,1836
1106,1099,712,387,102,182,91,115,219,390,0,2746,1099
1107,548,355,193,51,91,45,57,109,195,0,1368,548
1108,330,239,91,33,41,34,37,65,120,0,876,330
1109,2687,1776,911,257,343,262,325,494,1006,7,7626,2694
1110,6108,2050,4058,545,749,578,661,1249,2326,10,23470,6118
1111,3260,2278,982,290,436,331,365,607,1231,111,8123,3371
1112,1283,942,341,124,170,133,83,283,490,0,3025,1283
1113,15554,12532,3022,3889,6021,1115,717,1694,2118,0,46460,15554
1114,1470,736,734,113,190,118,165,305,579,8,5308,1478
1115,831,557,274,75,101,76,94,160,325,0,2335,831
1116,0,0,0,0,0,0,0,0,0,0,0,0
1117,1522,1140,382,157,191,160,181,287,546,10,3815,1532
1118,2677,2005,672,277,336,281,318,505,960,0,6709,2677
1119,2428,1499,929,228,301,200,295,466,938,11,7010,2439
1120,1173,549,624,88,125,99,134,254,473,0,3966,1173
1121,1084,568,516,74,124,79,132,203,472,0,3602,1084
1122,1416,738,678,123,165,131,170,287,540,7,4784,1423
1123,8596,4962,3634,767,1180,621,1050,1717,3261,20,27336,8616
1124,1942,1467,475,218,246,192,198,380,708,0,4743,1942
1125,3421,2221,1200,337,404,321,332,684,1343,0,9496,3421
1126,3800,2010,1790,380,461,365,410,715,1469,13,11845,3813
1127,3127,2090,1037,299,411,290,343,587,1197,245,8473,3372
1128,14562,10988,3574,1576,1734,1555,1477,2778,5442,4,31998,14566
1129,5479,3870,1609,587,580,509,577,1122,2104,0,13586,5479
1130,1573,955,618,135,204,127,186,326,595,0,4896,1573
1131,8229,4619,3610,750,998,697,950,1634,3200,18,25341,8247
1132,1436,751,685,126,149,114,199,290,558,0,4549,1436
1133,3316,1894,1422,300,395,340,378,646,1257,15,9599,3331
1134,3071,1895,1176,245,337,243,361,614,1271,87,8580,3158
1135,2019,1215,804,138,284,181,179,445,792,212,5831,2231
1136,1375,879,496,101,171,129,133,275,566,0,4006,1375
1137,2728,1711,1017,204,322,213,324,559,1106,0,8181,2728
1138,3202,2500,702,292,317,246,378,652,1317,150,7469,3352
1139,1076,678,398,99,107,91,101,202,476,129,3095,1205
1140,2103,1414,689,172,221,165,218,448,879,0,5241,2103
1141,991,582,409,71,89,85,102,202,442,0,2968,991
1142,5271,3546,1725,441,496,403,542,1073,2316,133,14942,5404
1143,1049,689,360,79,98,91,113,227,441,0,2951,1049
1144,2318,1515,803,192,257,169,289,513,898,34,6604,2352
1145,1974,1203,771,145,212,156,179,417,865,0,6021,1974
1146,1745,955,790,166,200,131,194,347,707,0,5592,1745
1147,2037,1017,1020,182,231,170,209,414,831,0,6565,2037
1148,2930,1825,1105,239,360,207,303,590,1231,325,8634,3255
1149,6780,3245,3535,617,852,595,828,1309,2579,0,22094,6780
1150,1969,922,1047,175,238,146,209,408,793,0,6658,1969
1151,1694,908,786,150,180,126,184,342,712,0,5459,1694
1152,3466,1994,1472,296,423,309,350,700,1388,0,10277,3466
1153,7220,4462,2758,666,875,539,897,1394,2849,34,21000,7254
1154,4047,2114,1933,294,531,297,501,791,1633,42,12814,4089
1155,13373,8607,4766,1186,2100,935,1710,2499,4943,3,38098,13376
1156,5009,3916,1093,479,587,481,457,1105,1900,185,12341,5194
1157,2683,2094,589,221,347,221,194,629,1071,25,7235,2708
1158,4575,3596,979,389,606,424,393,992,1771,0,12225,4575
1159,4844,3256,1588,437,550,409,547,997,1904,314,14076,5158
1160,8545,5357,3188,906,1123,827,925,1642,3122,0,23537,8545
1161,2987,1964,1023,275,412,317,333,587,1063,0,7728,2987
1162,1403,961,442,153,170,141,160,258,521,25,3452,1428
1163,4459,2390,2069,497,539,393,517,796,1717,0,14632,4459
1164,2542,1541,1001,247,284,229,261,514,1007,0,7273,2542
1165,2044,1218,826,192,242,189,216,395,810,13,5684,2057
1166,1705,1066,639,158,233,135,193,310,676,0,4987,1705
1167,2988,2018,970,269,322,223,356,565,1253,14,8230,3002
1168,3039,1685,1354,190,371,251,300,649,1278,53,9412,3092
1169,1359,1006,353,102,161,108,147,279,562,1,3035,1360
1170,2511,1836,675,210,269,193,263,489,1087,0,6483,2511
1171,1889,1103,786,149,218,134,207,405,776,7,5990,1896
1172,2202,1222,980,170,260,155,231,449,937,3,6950,2205
1173,1644,1038,606,140,191,118,145,346,704,24,4381,1668
1174,4137,2856,1281,376,478,401,459,750,1673,18,11159,4155
1175,6653,4285,2368,463,838,600,615,1448,2689,280,18007,6933
1176,2777,1966,811,279,331,284,321,540,1022,11,7404,2788
1177,2067,1476,591,147,261,205,165,456,833,35,6026,2102
1178,2234,1598,636,192,296,193,175,516,862,46,6863,2280
1179,2169,1269,900,241,248,174,244,449,813,14,6730,2183
1180,1393,709,684,97,185,101,140,287,583,0,4431,1393
1181,4373,3595,778,374,837,457,450,823,1432,0,11500,4373
1182,1003,430,573,57,103,79,113,211,440,63,4268,1066
1183,926,114,812,67,128,110,88,186,347,14,4713,940
1184,1269,513,756,109,166,112,192,225,465,70,5851,1339
1185,911,316,595,58,123,76,118,164,372,69,4262,980
1186,858,382,476,85,117,90,107,154,305,107,3164,965
1187,4716,2366,2350,556,592,489,530,974,1575,94,15382,4810
1188,414,334,80,49,55,44,36,84,146,86,1125,500
1189,1087,605,482,146,121,122,113,200,385,25,3141,1112
1190,4932,2848,2084,523,544,563,484,953,1865,289,14894,5221
1191,1697,1410,287,181,242,167,186,315,606,0,3643,1697
1192,1571,1290,281,130,209,167,153,319,593,8,3808,1579
1193,3172,2100,1072,255,402,304,322,584,1305,46,9200,3218
1194,1613,679,934,163,232,194,186,304,534,49,5644,1662
1195,9878,5108,4770,904,1642,990,1001,1889,3452,34,30671,9912
1196,502,96,406,36,64,37,46,96,223,7,2603,509
1197,1344,579,765,119,197,138,150,255,485,94,5407,1438
1198,1367,1003,364,160,172,140,119,291,485,18,3258,1385
1199,2298,1602,696,268,219,233,234,471,873,213,6047,2511
1200,7132,5378,1754,763,1001,738,747,1370,2513,0,17697,7132
1201,3922,2939,983,343,455,395,394,803,1532,15,9942,3937
1202,1098,791,307,99,143,102,110,215,429,3,2867,1101
1203,2434,1741,693,206,320,230,246,445,987,22,6657,2456
1204,11203,8912,2291,1149,1426,1157,1196,2104,4171,29,25637,11232
1205,3864,2927,937,355,488,335,387,832,1467,0,10668,3864
1206,800,129,671,97,69,96,87,162,289,7,3588,807
1207,3497,2298,1199,360,405,309,396,748,1279,11,9621,3508
1208,3256,2105,1151,249,440,320,348,637,1262,53,9787,3309
1209,1876,1337,539,133,247,182,208,377,729,11,5359,1887
1210,1588,1205,383,129,233,141,166,289,630,158,4279,1746
1211,4654,1892,2762,419,661,508,512,908,1646,0,18471,4654
1212,3459,585,2874,356,518,313,418,657,1197,0,16255,3459
1213,1061,277,784,79,151,95,140,181,415,88,5434,1149
1214,2106,1845,261,231,278,219,153,433,792,179,5145,2285
1215,1005,724,281,91,131,93,101,197,392,13,2626,1018
1216,1507,971,536,163,190,167,162,282,543,74,4213,1581
1217,4059,2615,1444,439,513,451,438,759,1459,541,11346,4600
1218,2410,526,1884,257,269,322,254,468,840,0,9942,2410
1219,3762,2841,921,435,585,429,412,673,1228,0,10007,3762
1220,14938,11280,3658,1728,2323,1703,1636,2672,4876,0,39730,14938
1221,314,239,75,43,27,30,37,69,108,4162,837,4476
1222,447,321,126,46,51,50,37,90,173,99,1129,546
1223,72047,59237,12810,6160,13783,7522,7406,13552,23624,0,189447,72047
1224,2041,1662,379,313,225,214,193,422,674,24,4359,2065
1225,595,321,274,68,64,67,58,117,221,0,1931,595
1226,588,317,271,67,64,66,57,116,218,13,1907,601
1227,2473,2014,459,379,273,260,234,511,816,4,5281,2477
1228,1686,1005,681,220,215,165,187,337,562,22,4965,1708
1229,3240,2088,1152,351,409,360,349,606,1165,1,9055,3241
1230,1391,441,950,117,198,166,128,257,525,0,5504,1391
1231,7263,3361,3902,843,820,881,725,1373,2621,34,24882,7297
1232,1009,506,503,119,127,105,113,208,337,0,3289,1009
1233,3151,2387,764,290,398,274,316,678,1195,0,8700,3151
1234,2581,807,1774,292,301,254,294,486,954,0,10513,2581
1235,727,159,568,77,81,97,77,141,254,296,2997,1023
1236,12664,9787,2877,1663,1710,1359,1236,2554,4142,59,28816,12723
1237,420,319,101,57,36,40,50,92,145,0,1120,420
1238,557,310,247,75,62,63,58,103,196,30,1609,587
1239,2255,1344,911,294,287,220,251,451,752,1,6641,2256
1240,4593,1829,2764,465,587,610,441,844,1646,122,16953,4715
1241,1218,785,433,132,154,135,131,228,438,388,3404,1606
1242,491,351,140,42,65,46,50,90,198,0,1344,491
1243,5365,4312,1053,1122,92,490,512,1166,1983,1905,13790,7270
1244,947,682,265,85,123,88,95,185,371,0,2472,947
1245,763,549,214,69,99,71,77,149,298,0,1994,763
1246,815,587,228,74,106,76,82,160,317,0,2128,815
1247,1389,1116,273,291,24,127,133,302,512,3,3571,1392
1248,541,390,151,49,70,50,54,106,212,0,1413,541
1249,426,82,344,31,55,32,39,82,187,3,2212,429
1250,1398,1025,373,164,176,143,122,297,496,0,3331,1398
1251,534,288,246,61,58,60,52,105,198,0,1732,534
1252,437,353,84,52,58,46,38,88,155,559,1189,996
1253,534,288,246,61,58,60,52,105,198,0,1732,534
1254,735,161,574,78,82,98,77,143,257,29,3034,764
1255,357,82,275,26,35,37,27,78,154,0,1561,357
1256,1874,835,1039,185,254,197,233,336,669,50,6914,1924
1257,150,13,137,9,19,18,13,34,57,8,722,158
1258,250,22,228,15,31,31,21,57,95,0,1202,250
1259,4597,3506,1091,518,540,439,439,983,1678,78,10830,4675
1260,418,91,327,45,47,56,44,81,145,0,1724,418
1261,1167,649,518,157,130,131,121,215,413,147,3374,1314
1262,809,450,359,109,90,91,84,149,286,122,2338,931
1263,1791,997,794,241,199,202,186,330,633,0,5176,1791
1264,762,123,639,93,66,91,83,154,275,49,3417,811
1265,992,395,597,100,127,132,95,182,356,0,3662,992
1266,1662,662,1000,168,212,221,160,305,596,0,6135,1662
1267,945,373,572,91,112,99,112,171,360,25,3905,970
1268,653,57,596,40,82,80,55,149,247,0,3138,653
1269,1498,592,906,145,177,157,177,271,571,0,6193,1498
1270,1627,1232,395,150,206,141,163,350,617,0,4491,1627
1271,1596,1217,379,180,188,152,153,341,582,16,3759,1612
1272,1294,898,396,160,121,143,135,264,471,60,3364,1354
1273,857,691,166,102,114,91,75,173,302,389,2333,1246
1274,556,263,293,75,58,76,62,93,192,0,1816,556
1275,482,389,93,57,64,51,42,97,171,30,1312,512
1276,451,214,237,61,47,62,50,75,156,0,1472,451
1277,199,94,105,27,21,27,22,33,69,62,650,261
1278,2369,1411,958,308,302,231,263,474,791,342,6978,2711
1279,610,289,321,82,64,84,68,102,210,26,1994,636
1280,640,255,385,65,82,85,61,118,229,0,2362,640
1281,1159,675,484,112,157,126,126,222,416,0,3465,1159
1282,576,182,394,48,82,69,53,107,217,125,2278,701
1283,1892,1103,789,182,256,206,205,362,681,0,5656,1892
1284,1630,1260,370,214,220,175,159,329,533,0,3710,1630
1285,0,0,0,0,0,0,0,0,0,0,0,0
1286,4651,3594,1057,611,628,499,454,938,1521,175,10584,4826
1287,580,405,175,88,68,70,56,105,193,37,1477,617
1288,1138,678,460,148,145,111,126,228,380,8,3352,1146
1289,2614,1826,788,398,308,314,251,474,869,72,6658,2686
1290,1232,861,371,188,145,148,118,223,410,1,3139,1233
1291,503,351,152,77,59,60,48,91,168,0,1282,503
1292,650,454,196,99,77,78,62,118,216,13,1655,663
1293,2818,2363,455,412,408,304,280,574,840,24,5778,2842
1294,1397,1172,225,204,202,151,139,285,416,110,2865,1507
1295,1408,1074,334,159,165,134,135,301,514,0,3317,1408
1296,555,355,200,65,77,51,53,118,191,98,1408,653
1297,741,514,227,91,69,82,77,151,271,56,1928,797
1298,238,94,144,23,28,25,28,43,91,0,983,238
1299,921,727,194,88,121,84,80,210,338,0,2471,921
1300,1197,945,252,114,157,109,104,272,441,64,3212,1261
1301,759,599,160,72,100,69,66,173,279,0,2038,759
1302,336,133,203,33,40,35,40,61,127,4,1387,340
1303,951,220,731,69,93,97,71,209,412,15,4160,966
1304,651,514,137,62,85,59,57,148,240,0,1747,651
1305,868,761,107,95,115,90,63,178,327,1285,2121,2153
1306,3716,3055,661,318,711,388,382,699,1218,0,9771,3716
1307,32510,26730,5780,2780,6219,3394,3342,6115,10660,0,85484,32510
1308,4063,3309,754,623,448,427,385,839,1341,0,8676,4063
1309,11500,4339,7161,1469,883,1267,1335,2159,4387,46,53391,11546
1310,14972,3773,11199,1821,1331,1446,1722,2945,5707,25,80412,14997
1311,1034,602,432,99,98,96,101,203,437,6,3729,1040
1312,2208,865,1343,153,283,182,265,461,864,35,9272,2243
1313,1821,551,1270,149,192,147,171,369,793,161,7980,1982
1314,3138,1169,1969,168,394,221,354,677,1324,67,12557,3205
1315,1056,415,641,56,141,109,83,226,441,43,4958,1099
1316,979,431,548,82,104,110,85,196,402,62,4394,1041
1317,856,370,486,45,84,86,84,188,369,20,3702,876
1318,1117,332,785,79,111,94,124,239,470,48,4800,1165
1319,2379,1187,1192,231,204,239,206,489,1010,13,9088,2392
1320,1469,680,789,150,135,172,133,304,575,28,5765,1497
1321,863,588,275,91,91,81,73,164,363,0,2379,863
1322,1464,691,773,123,155,136,129,339,582,8,5546,1472
1323,554,250,304,63,45,58,45,113,230,0,2031,554
1324,805,320,485,94,45,87,64,185,330,0,3165,805
1325,1221,409,812,118,116,129,117,259,482,14,5050,1235
1326,1387,631,756,131,116,143,114,270,613,10,5099,1397
1327,958,431,527,122,72,106,92,203,363,17,3802,975
1328,2040,944,1096,226,226,206,174,438,770,10,7677,2050
1329,535,363,172,61,68,51,57,102,196,0,1597,535
1330,7429,5151,2278,928,1273,746,924,1319,2239,0,22153,7429
1331,4440,1774,2666,561,355,468,502,817,1737,256,18377,4696
1332,1228,592,636,86,129,146,111,229,527,0,4841,1228
1333,3893,3287,606,331,410,389,457,682,1624,8,9424,3901
1334,1149,478,671,67,128,122,106,241,485,56,4954,1205
1335,917,136,781,110,75,84,104,184,360,7,5319,924
1336,1066,208,858,148,66,67,139,201,445,10,5373,1076
1337,1154,120,1034,130,107,98,136,217,466,6,6961,1160
1338,374,49,325,55,32,35,41,71,140,13,2361,387
1339,841,227,614,49,112,88,68,194,330,0,4349,841
1340,882,262,620,64,110,96,54,188,370,0,4340,882
1341,3458,1097,2361,468,301,409,403,643,1234,13,16283,3471
1342,292,104,188,25,38,33,37,52,107,0,1270,292
1343,2791,1650,1141,242,293,299,254,563,1140,34,10098,2825
1344,1637,519,1118,203,124,200,189,313,608,0,7880,1637
1345,1885,1108,777,151,233,208,187,331,775,28,6607,1913
1346,638,347,291,62,76,63,60,131,246,0,2119,638
1347,1202,521,681,126,112,142,98,237,487,36,4778,1238
1348,798,392,406,81,78,88,67,166,318,39,3013,837
1349,1664,597,1067,97,206,123,161,342,735,0,7110,1664
1350,1572,741,831,122,161,128,182,316,663,24,5865,1596
1351,4102,1822,2280,255,476,308,438,881,1744,34,15616,4136
1352,1178,134,1044,188,52,110,145,229,454,14,6664,1192
1353,1201,182,1019,100,143,146,83,244,485,78,6531,1279
1354,1654,432,1222,143,212,187,122,362,628,27,8161,1681
1355,559,247,312,72,56,67,61,101,202,3,2299,562
1356,1880,201,1679,288,114,205,208,359,706,0,9783,1880
1357,10283,6229,4054,1470,796,1341,1200,1754,3722,0,33090,10283
1358,245,94,151,36,18,27,33,43,88,0,994,245
1359,2215,1180,1035,168,304,236,202,440,865,231,8352,2446
1360,2635,1402,1233,155,382,237,282,508,1071,18,9565,2653
1361,2487,1151,1336,186,309,284,223,517,968,59,10152,2546
1362,1916,690,1226,149,262,222,145,400,738,0,8533,1916
1363,1011,398,613,84,129,106,84,211,397,460,4355,1471
1364,1282,455,827,94,175,133,108,293,479,7,5931,1289
1365,1912,1345,567,162,209,183,238,375,745,34,6020,1946
1366,1431,921,510,104,149,165,128,265,620,24,4786,1455
1367,1542,993,549,128,151,171,152,298,642,4,5037,1546
1368,2072,1107,965,291,480,168,197,358,578,0,6451,2072
1369,1950,872,1078,186,170,193,162,455,784,25,7180,1975
1370,695,330,365,67,67,75,65,147,274,17,2653,712
1371,1184,413,771,109,130,121,95,245,484,0,4919,1184
1372,1440,630,810,122,131,148,123,318,598,4,5298,1444
1373,1238,608,630,138,129,133,112,250,476,8,4807,1246
1374,2289,1399,890,241,249,233,235,432,899,0,7062,2289
1375,4693,2508,2185,658,1087,381,446,811,1310,0,14612,4693
1376,3335,1874,1461,354,511,350,345,734,1041,0,11630,3335
1377,446,211,235,77,105,41,37,74,112,10,1688,456
1378,1271,403,868,172,111,150,148,236,454,99,5985,1370
1379,119,44,75,13,11,13,12,23,47,17,479,136
1380,114,42,72,13,11,12,12,22,44,0,461,114
1381,4945,2643,2302,694,1146,401,470,855,1379,0,15399,4945
1382,658,301,357,58,66,64,52,147,271,20,2632,678
1383,8523,4556,3967,1196,1975,691,811,1474,2376,0,26540,8523
1384,543,239,304,56,58,51,57,114,207,0,2180,543
1385,10744,7450,3294,1342,1840,1079,1337,1907,3239,0,32036,10744
1386,1525,674,851,196,153,182,167,275,552,0,6270,1525
1387,2187,808,1379,248,203,239,223,430,844,0,8821,2187
1388,636,244,392,92,45,71,84,112,232,10,2580,646
1389,933,334,599,80,122,105,119,167,340,109,4059,1042
1390,1196,529,667,154,120,143,131,216,432,0,4917,1196
1391,299,107,192,26,39,34,38,53,109,0,1303,299
1392,2369,1281,1088,274,256,261,302,415,861,35,8683,2404
1393,2135,1154,981,247,230,235,272,374,777,122,7828,2257
1394,666,300,366,75,55,70,54,136,276,15,2439,681
1395,757,333,424,78,82,72,79,160,286,13,3037,770
1396,686,394,292,76,85,73,84,124,244,35,2583,721
1397,7331,4207,3124,817,910,779,902,1325,2598,0,27605,7331
1398,5159,3538,1621,633,787,533,609,893,1704,175,17970,5334
1399,531,243,288,46,54,52,42,119,218,18,2125,549
1400,233,111,122,23,22,25,22,49,92,0,890,233
1401,8325,3936,4389,1446,1961,758,697,1376,2087,0,31502,8325
1402,422,201,221,41,41,46,39,89,166,12,1610,434
1403,1655,885,770,232,383,134,157,286,463,60,5154,1715
1404,2566,1396,1170,248,307,252,242,526,991,1,8528,2567
1405,1358,642,716,236,320,124,114,224,340,8,5140,1366
1406,1214,697,517,135,151,129,149,219,431,7,4571,1221
1407,3133,1761,1372,332,480,329,324,689,979,0,10928,3133
1408,1220,664,556,118,146,120,115,250,471,0,4055,1220
1409,356,242,114,41,45,34,38,68,130,0,1063,356
1410,7831,5430,2401,978,1341,786,974,1390,2362,0,23350,7831
1411,3015,1650,1365,274,318,326,260,586,1251,45,9612,3060
1412,1298,751,547,70,161,132,132,298,505,0,4238,1298
1413,2722,1434,1288,177,306,246,273,556,1164,0,9026,2722
1414,4410,2742,1668,342,504,468,408,980,1708,57,12595,4467
1415,1651,809,842,104,187,148,145,355,712,11,5648,1662
1416,2824,1729,1095,225,302,261,278,632,1126,31,8843,2855
1417,2239,1012,1227,185,266,205,241,483,859,0,7985,2239
1418,1115,692,423,76,127,106,110,251,445,0,3503,1115
1419,1015,644,371,69,129,107,87,227,396,0,3193,1015
1420,1389,809,580,93,161,125,128,289,593,13,4507,1402
1421,7104,3501,3603,513,868,556,807,1617,2743,38,23856,7142
1422,1649,884,765,132,181,177,161,330,668,43,5699,1692
1423,1465,387,1078,143,130,153,129,322,588,1,6099,1466
1424,2323,1104,1219,137,290,177,243,565,911,32,7629,2355
1425,2147,933,1214,151,307,162,224,505,798,11,6817,2158
1426,1808,974,834,123,234,159,188,407,697,0,5549,1808
1427,530,297,233,37,57,54,48,112,222,23,1745,553
1428,976,506,470,70,106,85,96,222,397,0,3261,976
1429,537,246,291,45,69,61,55,112,195,11,1942,548
1430,4453,2454,1999,330,579,456,409,965,1714,42,14850,4495
1431,1345,701,644,122,127,121,141,290,544,0,4512,1345
1432,1762,937,825,157,171,160,164,389,721,41,5885,1803
1433,6626,4139,2487,536,781,728,606,1380,2595,88,18794,6714
1434,2292,894,1398,209,250,201,240,459,933,20,9188,2312
1435,804,454,350,47,89,66,74,174,354,0,2679,804
1436,2224,1217,1007,161,284,182,200,487,910,35,6755,2259
1437,868,463,405,58,87,89,90,183,361,18,3058,886
1438,5873,3723,2150,598,702,613,530,1231,2199,0,16890,5873
1439,1993,1033,960,138,225,211,176,442,801,23,6354,2016
1440,938,444,494,76,85,106,98,180,393,0,3243,938
1441,1311,653,658,103,115,147,118,272,556,11,4548,1322
1442,1629,867,762,108,214,157,152,373,625,25,4908,1654
1443,2075,1340,735,151,238,203,199,445,839,7,5736,2082
1444,1450,990,460,136,180,136,160,268,570,198,4131,1648
1445,1283,753,530,80,151,104,115,295,538,113,4030,1396
1446,2328,1339,989,163,300,188,205,525,947,38,7097,2366
1447,4011,2589,1422,383,524,376,408,847,1473,11,10830,4022
1448,1807,975,832,131,211,146,184,384,751,0,5634,1807
1449,1138,514,624,94,135,104,122,245,438,13,4058,1151
1450,542,245,297,45,64,50,58,117,208,1,1934,543
1451,894,404,490,74,106,82,96,193,343,0,3190,894
1452,362,204,158,21,40,30,33,79,159,10,1207,372
1453,3013,797,2216,295,268,314,266,662,1208,24,12536,3037
1454,16370,9022,7348,1211,2130,1676,1504,3549,6300,0,54585,16370
1455,463,291,172,27,62,43,38,103,190,17,1335,480
1456,2075,1304,771,122,277,193,171,460,852,0,5980,2075
1457,3056,1433,1623,202,353,242,296,684,1279,41,11222,3097
1458,627,288,339,53,80,71,65,131,227,11,2271,638
1459,477,268,209,33,51,49,43,101,200,0,1571,477
1460,598,336,262,42,64,61,54,126,251,34,1971,632
1461,1340,694,646,93,151,142,119,297,538,25,4270,1365
1462,624,350,274,44,67,64,57,132,260,9,2057,633
1463,1079,678,401,63,144,100,89,239,444,67,3109,1146
1464,836,326,510,76,91,73,87,167,342,11,3352,847
1465,722,408,314,42,79,59,66,157,319,0,2406,722
1466,574,278,296,37,77,44,59,127,230,22,1917,596
1467,977,474,503,64,131,76,101,216,389,25,3261,1002
1468,293,142,151,19,39,23,30,65,117,30,979,323
1469,1344,793,551,122,123,108,134,310,547,13,4123,1357
1470,2040,823,1217,162,203,199,181,496,799,147,7777,2187
1471,513,219,294,57,26,42,26,145,217,144,1750,657
1472,1509,784,725,130,129,137,138,330,645,11,5016,1520
1473,1248,803,445,97,96,123,131,269,532,0,3794,1248
1474,3051,1582,1469,259,320,263,305,671,1233,67,10412,3118
1475,234,117,117,20,17,24,23,53,97,10,852,244
1476,2377,1080,1297,171,208,250,247,517,984,0,8297,2377
1477,1874,607,1267,165,190,172,199,412,736,430,7484,2304
1478,4139,2045,2094,436,387,437,376,935,1568,40,13887,4179
1479,6959,2994,3965,824,643,719,678,1589,2506,0,24481,6959
1480,1618,861,757,144,151,170,160,331,662,0,5266,1618
1481,2628,1374,1254,243,245,268,268,601,1003,21,9225,2649
1482,752,398,354,72,70,80,77,176,277,7,2562,759
1483,462,321,141,51,49,49,40,102,171,55,1361,517
1484,2529,1238,1291,265,246,243,251,547,977,0,8299,2529
1485,1210,572,638,117,123,118,116,274,462,0,4148,1210
1486,2101,1029,1072,220,204,202,208,454,813,48,6895,2149
1487,634,310,324,66,62,61,63,137,245,12,2080,646
1488,451,213,238,44,46,44,43,102,172,18,1547,469
1489,1698,803,895,164,173,166,162,385,648,0,5822,1698
1490,1469,695,774,142,150,144,140,333,560,51,5036,1520
1491,2244,1174,1070,207,210,229,228,513,857,179,7875,2423
1492,5790,2835,2955,606,563,557,574,1252,2238,0,18997,5790
1493,351,71,280,38,33,31,36,85,128,167,1530,518
1494,706,349,357,74,66,74,64,159,269,6,2367,712
1495,831,169,662,90,78,72,86,201,304,36,3623,867
1496,342,70,272,37,32,30,35,83,125,0,1491,342
1497,1224,249,975,133,116,107,126,296,446,34,5340,1258
1498,4469,1923,2546,529,413,462,435,1021,1609,18,15721,4487
1499,1296,648,648,109,92,136,127,295,537,8,4710,1304
1500,1252,739,513,114,114,101,125,288,510,0,3842,1252
1501,608,288,320,59,62,59,58,138,232,51,2083,659
1502,5833,1186,4647,632,551,509,601,1410,2130,64,25445,5897
1503,726,384,342,70,67,77,74,170,268,13,2473,739
1504,1508,713,795,146,154,147,144,342,575,200,5170,1708
1505,854,277,577,75,86,79,91,188,335,137,3408,991
1506,1069,566,503,102,99,114,109,250,395,28,3642,1097
1507,546,111,435,59,52,48,56,132,199,20,2381,566
1508,783,414,369,75,72,83,80,183,290,0,2666,783
1509,1618,1223,395,182,205,160,165,316,590,105,3951,1723
1510,2209,1669,540,248,280,219,226,432,804,0,5394,2209
1511,1070,808,262,120,135,106,109,209,391,0,2613,1070
1512,4330,2967,1363,471,523,434,494,797,1611,0,10657,4330
1513,158,112,46,16,19,16,18,31,58,0,422,158
1514,126,89,37,13,15,13,15,25,45,0,336,126
1515,150,106,44,15,18,15,17,29,56,0,400,150
1516,3,3,0,2,1,0,0,0,0,0,0,3
1517,15970,11861,4109,3465,2795,1584,1487,2780,3859,0,40351,15970
1518,90,20,70,10,10,12,9,17,32,1,372,91
1519,2883,2348,535,442,318,303,273,596,951,1,6158,2884
1520,22,16,6,2,3,2,2,4,9,4,56,26
1521,3101,1981,1120,362,428,286,299,660,1066,130,7858,3231
1522,863,620,243,89,98,96,71,174,335,6,2182,869
1523,4973,3648,1325,582,625,510,433,1058,1765,13,11849,4986
1524,1288,945,343,151,162,132,112,274,457,0,3069,1288
1525,0,0,0,0,0,0,0,0,0,0,0,0
1526,1425,1045,380,167,179,146,124,303,506,0,3395,1425
1527,3421,2321,1100,390,437,329,367,654,1244,0,10207,3421
1528,3181,2159,1022,363,406,306,341,608,1157,0,9489,3181
1529,4262,2015,2247,740,1004,388,357,705,1068,0,16127,4262
1530,3296,2395,901,784,487,406,381,493,745,1,8077,3297
1531,1565,1103,462,139,129,129,196,345,627,0,3577,1565
1532,982,542,440,83,106,83,108,206,396,11,3071,993
1533,147,76,71,19,28,9,15,25,51,0,486,147
1534,399,206,193,52,75,24,40,68,140,18,1317,417
1535,1482,827,655,99,125,101,158,328,671,84,4542,1566
1536,1005,469,536,71,84,85,107,222,436,18,3198,1023
1537,5,2,3,0,0,0,1,1,3,0,16,5
1538,291,133,158,22,29,19,33,59,129,0,973,291
1539,884,405,479,67,88,58,101,180,390,0,2961,884
1540,1909,1076,833,136,174,154,194,400,851,0,5796,1909
1541,29129,18908,10221,2450,2689,2333,3286,5960,12411,0,89345,29129
1542,3572,2075,1497,300,322,301,389,719,1541,15,10634,3587
1543,2699,1763,936,172,253,217,273,603,1181,0,7494,2699
1544,1159,628,531,59,106,64,134,243,553,18,3789,1177
1545,342,157,185,29,32,26,35,70,150,18,1080,360
1546,1035,535,500,88,85,94,113,229,426,36,3489,1071
1547,1540,1079,461,106,134,130,142,318,710,0,4410,1540
1548,387,225,162,27,34,34,40,84,168,15,1145,402
1549,1623,1178,445,149,151,140,151,338,694,164,3927,1787
1550,2612,1455,1157,236,196,192,302,527,1159,0,8076,2612
1551,0,0,0,0,0,0,0,0,0,0,0,0
1552,502,270,232,40,45,44,54,102,217,4,1582,506
1553,1048,643,405,82,97,91,104,215,459,0,3023,1048
1554,295,193,102,20,22,20,32,61,140,0,853,295
1555,1571,923,648,134,154,131,171,315,666,17,4636,1588
1556,532,338,194,33,49,40,48,108,254,5,1551,537
1557,634,341,293,51,68,56,69,135,255,0,2060,634
1558,1618,871,747,131,174,142,176,345,650,0,5258,1618
1559,3108,1762,1346,225,266,273,306,669,1369,20,8873,3128
1560,426,207,219,35,36,36,45,94,180,13,1313,439
1561,1017,557,460,70,83,79,85,247,453,199,3171,1216
1562,1184,612,572,101,97,107,129,262,488,7,3993,1191
1563,136,66,70,11,12,12,14,30,57,0,421,136
1564,892,582,310,61,68,60,97,185,421,0,2579,892
1565,1102,696,406,69,93,86,110,231,513,16,3113,1118
1566,9742,5725,4017,829,953,811,1063,1955,4131,0,28746,9742
1567,464,305,159,29,47,39,50,89,210,0,1316,464
1568,277,176,101,17,26,21,25,56,132,16,806,293
1569,523,311,212,40,44,44,56,112,227,42,1442,565
1570,777,429,348,66,84,66,85,163,313,26,2431,803
1571,1561,844,717,139,168,130,171,320,633,0,4694,1561
1572,716,453,263,45,61,56,72,150,332,15,2024,731
1573,1887,1370,517,173,175,163,176,393,807,0,4567,1887
1574,9541,8133,1408,751,971,851,926,2110,3932,0,27223,9541
1575,487,320,167,31,49,41,53,93,220,195,1381,682
1576,1364,627,737,116,126,104,142,279,597,0,4315,1364
1577,47,25,22,4,5,4,5,10,19,0,154,47
1578,2258,1215,1043,183,243,198,246,482,906,0,7336,2258
1579,753,352,401,53,63,63,80,166,328,0,2398,753
1580,608,441,167,56,56,52,57,127,260,0,1472,608
1581,413,214,199,35,34,37,45,91,171,0,1393,413
1582,15188,8208,6980,1349,1636,1262,1666,3117,6158,0,45683,15188
1583,1117,512,605,85,111,74,127,228,492,0,3741,1117
1584,3698,2798,900,325,342,363,368,769,1531,0,9171,3698
1585,268,156,112,19,23,24,28,58,116,0,794,268
1586,14,12,2,1,1,1,1,3,7,0,39,14
1587,663,390,273,56,65,55,72,133,282,0,1955,663
1588,1671,994,677,128,140,140,179,356,728,0,4604,1671
1589,920,644,276,63,80,78,85,190,424,36,2632,956
1590,1847,1397,450,162,171,181,184,384,765,165,4583,2012
1591,2627,2239,388,207,267,234,255,581,1083,0,7495,2627
1592,320,147,173,24,32,21,36,65,142,0,1072,320
1593,1014,571,443,72,92,82,103,212,453,85,3078,1099
1594,322,181,141,23,29,26,33,67,144,0,976,322
1595,835,449,386,68,90,73,91,178,335,133,2712,968
1596,3703,1800,1903,305,314,314,392,819,1559,0,11427,3703
1597,232,113,119,19,20,20,25,51,97,0,715,232
1598,605,371,234,47,56,53,60,124,265,0,1746,605
1599,653,401,252,51,60,57,65,134,286,11,1883,664
1600,8029,4665,3364,674,723,677,875,1616,3464,0,23904,8029
1601,0,0,0,0,0,0,0,0,0,0,0,0
1602,310,160,150,26,25,28,34,68,129,0,1045,310
1603,251,146,105,18,22,22,26,54,109,9,744,260
1604,1202,622,580,156,225,72,122,206,421,20,3972,1222
1605,395,251,144,24,37,30,35,80,189,0,1152,395
1606,1651,889,762,132,149,143,176,337,714,38,5205,1689
1607,2993,1617,1376,266,322,249,328,614,1214,0,9002,2993
1608,549,361,188,35,56,47,60,105,246,0,1557,549
1609,428,254,174,33,36,36,46,91,186,95,1180,523
1610,4598,2539,2059,390,498,390,503,965,1852,45,14387,4643
1611,1338,779,559,94,117,119,138,289,581,22,3960,1360
1612,6179,4011,2168,520,570,495,697,1264,2633,0,18951,6179
1613,33,28,5,3,3,3,3,7,14,0,94,33
1614,0,0,0,0,0,0,0,0,0,0,0,0
1615,755,407,348,60,68,65,81,154,327,11,2380,766
1616,221,136,85,17,20,19,22,45,98,0,637,221
1617,4014,1974,2040,301,523,370,428,798,1594,0,12951,4014
1618,662,317,345,57,104,37,69,128,267,83,2721,745
1619,469,280,189,51,49,43,49,89,188,0,1376,469
1620,866,500,366,83,97,88,90,169,339,17,2850,883
1621,779,308,471,67,105,53,85,158,311,7,2969,786
1622,460,221,239,34,73,43,38,89,183,15,1735,475
1623,2731,1734,997,425,322,247,296,475,966,0,7791,2731
1624,503,229,274,47,64,51,49,106,186,10,1775,513
1625,728,403,325,82,88,68,81,144,265,37,2359,765
1626,944,477,467,97,119,81,86,171,390,25,3139,969
1627,2586,1226,1360,315,341,264,283,501,882,16,9052,2602
1628,1205,518,687,128,122,103,119,248,485,0,4395,1205
1629,2128,1223,905,229,222,162,234,435,846,8,6773,2136
1630,1545,679,866,127,253,138,195,267,565,20,5952,1565
1631,193,112,81,28,20,18,21,36,70,0,590,193
1632,926,389,537,47,93,70,97,213,406,15,3212,941
1633,647,308,339,43,78,57,59,132,278,0,2220,647
1634,601,300,301,49,69,56,64,114,249,0,2114,601
1635,2166,1006,1160,264,293,186,230,400,793,349,7693,2515
1636,945,586,359,79,121,91,100,197,357,11,2797,956
1637,1935,1002,933,191,243,174,190,384,753,27,6515,1962
1638,1383,603,780,102,163,117,153,286,562,98,4821,1481
1639,1254,403,851,82,131,111,135,236,559,106,4594,1360
1640,1167,564,603,72,102,89,114,253,537,0,3990,1167
1641,425,254,171,50,54,33,46,74,168,0,1377,425
1642,2224,875,1349,187,362,193,217,426,839,45,8414,2269
1643,1790,754,1036,140,253,148,190,332,727,64,6641,1854
1644,10078,5766,4312,943,1787,927,995,1854,3572,17,32684,10095
1645,1502,707,795,113,269,145,151,287,537,77,5583,1579
1646,688,475,213,86,79,62,71,129,261,87,1986,775
1647,1448,870,578,153,147,146,137,307,558,99,4055,1547
1648,2050,1112,938,212,249,183,226,408,772,31,6739,2081
1649,1586,854,732,155,183,164,160,304,620,22,5277,1608
1650,2011,916,1095,166,268,170,238,394,775,22,7231,2033
1651,1365,709,656,141,174,125,136,258,531,32,4754,1397
1652,320,105,215,22,42,29,32,63,132,0,1323,320
1653,251,120,131,21,39,14,26,49,102,28,1032,279
1654,731,489,242,78,96,56,93,124,284,0,2030,731
1655,5846,3767,2079,1039,649,649,130,1689,1690,1,16425,5847
1656,3062,2108,954,431,375,290,297,572,1097,0,8546,3062
1657,330,136,194,25,33,24,30,66,152,0,1163,330
1658,663,384,279,97,67,61,71,125,242,0,2024,663
1659,1721,816,905,209,227,175,189,334,587,16,6024,1737
1660,622,271,351,64,86,57,70,121,224,0,2262,622
1661,723,257,466,74,98,81,74,126,270,11,2859,734
1662,1101,713,388,133,151,90,110,199,418,10,3245,1111
1663,399,174,225,41,55,37,45,78,143,7,1451,406
1664,462,268,194,47,57,36,48,93,181,0,1458,462
1665,1331,649,682,179,149,142,148,209,504,9,4209,1340
1666,676,406,270,85,94,52,68,127,250,31,2187,707
1667,2812,1630,1182,410,286,258,302,531,1025,57,8587,2869
1668,4115,2386,1729,600,419,378,442,778,1498,141,12565,4256
1669,470,154,316,33,62,42,46,93,194,0,1940,470
1670,258,118,140,25,39,20,29,47,98,1,1027,259
1671,685,313,372,65,104,52,78,124,262,39,2728,724
1672,752,344,408,71,114,57,85,136,289,44,2995,796
1673,5607,3097,2510,468,960,534,560,1069,2016,0,18495,5607
1674,6385,3526,2859,533,1094,608,638,1217,2295,0,21061,6385
1675,386,159,227,30,39,28,35,78,176,0,1362,386
1676,711,346,365,95,80,76,79,111,270,11,2247,722
1677,797,348,449,82,110,74,90,155,286,18,2895,815
1678,828,495,333,89,87,77,87,156,332,49,2431,877
1679,493,203,290,38,50,36,45,99,225,6,1738,499
1680,1014,607,407,120,129,79,110,177,399,15,3284,1029
1681,587,282,305,44,94,54,48,114,233,7,2214,594
1682,1373,796,577,139,169,106,143,277,539,30,4336,1403
1683,1270,580,690,121,193,97,144,230,485,0,5057,1270
1684,10,5,5,1,1,1,1,2,4,60,31,70
1685,817,452,365,92,99,77,91,162,296,0,2647,817
1686,394,229,165,40,48,30,41,80,155,0,1245,394
1687,8356,5481,2875,870,1329,778,984,1568,2827,0,22751,8356
1688,1792,1175,617,187,285,167,211,336,606,0,4878,1792
1689,2716,1781,935,283,432,253,320,510,918,0,7394,2716
1690,1443,946,497,150,230,134,170,271,488,0,3928,1443
1691,264,159,105,33,37,20,27,50,97,19,855,283
1692,257,85,172,22,38,22,23,52,100,0,990,257
1693,340,142,198,30,42,26,37,69,136,0,1333,340
1694,334,193,141,32,37,34,35,65,131,18,1099,352
1695,5770,3785,1985,601,918,537,680,1082,1952,0,15710,5770
1696,2868,1881,987,299,456,267,338,538,970,0,7809,2868
1697,848,468,380,71,145,81,85,162,304,0,2797,848
1698,806,445,361,67,138,77,81,154,289,30,2659,836
1699,297,38,259,35,38,25,34,57,108,23,1334,320
1700,881,560,321,137,104,80,95,153,312,4,2514,885
1701,848,403,445,57,103,74,77,174,363,0,2907,848
1702,646,363,283,71,82,71,69,123,230,136,1924,782
1703,1256,705,551,137,159,137,135,238,450,12,3739,1268
1704,708,398,310,77,90,77,76,134,254,0,2108,708
1705,1466,1009,457,206,180,139,142,274,525,0,4093,1466
1706,528,263,265,43,61,49,56,100,219,0,1859,528
1707,1782,777,1005,131,209,150,197,369,726,0,6209,1782
1708,482,202,280,42,60,37,52,97,194,7,1890,489
1709,316,190,126,40,44,24,32,60,116,17,1022,333
1710,338,162,176,25,54,31,28,65,135,13,1276,351
1711,336,43,293,40,44,29,38,64,121,0,1510,336
1712,288,93,195,27,38,23,27,61,112,30,1201,318
1713,888,499,389,97,113,97,95,169,317,0,2644,888
1714,908,502,406,102,110,85,102,180,329,183,2941,1091
1715,777,436,341,85,99,85,84,147,277,8,2313,785
1716,1375,772,603,150,174,150,148,261,492,11,4094,1386
1717,506,280,226,57,61,48,57,100,183,0,1638,506
1718,562,245,317,41,66,47,62,116,230,0,1958,562
1719,602,360,242,71,77,47,65,105,237,7,1949,609
1720,389,153,236,33,63,34,38,74,147,0,1472,389
1721,491,193,298,41,80,43,48,94,185,11,1860,502
1722,372,169,203,34,47,38,37,78,138,0,1314,372
1723,405,279,126,50,47,36,42,76,154,4,1170,409
1724,161,76,85,12,29,16,16,31,57,18,600,179
1725,297,171,126,29,33,30,31,58,116,8,978,305
1726,311,154,157,37,39,28,34,59,114,0,1026,311
1727,5634,3880,1754,792,691,534,546,1052,2019,481,15725,6115
1728,1023,611,412,110,107,95,107,193,411,1,3002,1024
1729,415,137,278,35,61,35,37,85,162,0,1599,415
1730,737,427,310,107,75,68,79,139,269,0,2249,737
1731,132,65,67,10,17,12,14,26,53,0,427,132
1732,461,210,251,43,58,47,45,97,171,0,1629,461
1733,446,203,243,41,57,45,44,94,165,0,1574,446
1734,462,231,231,38,53,43,49,88,191,0,1625,462
1735,667,214,453,63,87,53,63,141,260,19,2778,686
1736,789,311,478,68,106,53,87,160,315,7,3007,796
1737,393,236,157,49,55,30,40,74,145,0,1271,393
1738,326,42,284,39,42,28,37,62,118,13,1465,339
1739,314,40,274,37,41,27,36,60,113,0,1413,314
1740,647,320,327,77,82,59,70,123,236,27,2133,674
1741,188,93,95,22,24,17,20,36,69,19,621,207
1742,877,433,444,105,111,80,95,167,319,0,2893,877
1743,428,179,249,38,53,32,46,87,172,25,1679,453
1744,489,201,288,37,50,36,45,98,223,7,1726,496
1745,1354,785,569,137,166,105,141,274,531,4,4275,1358
1746,0,0,0,0,0,0,0,0,0,0,0,0
1747,770,379,391,58,100,71,82,153,306,0,2486,770
1748,1054,481,573,100,160,80,119,191,404,0,4198,1054
1749,728,402,326,61,125,69,73,139,261,22,2401,750
1750,370,204,166,31,63,35,37,71,133,14,1220,384
1751,171,112,59,18,27,16,20,32,58,7,467,178
1752,1047,607,440,153,107,96,112,198,381,0,3198,1047
1753,102,57,45,25,43,6,3,10,15,0,328,102
1754,4495,2519,1976,1108,1875,283,128,448,653,0,14492,4495
1755,990,555,435,244,413,62,28,99,144,0,3192,990
1756,1697,951,746,418,708,107,48,169,247,4,5470,1701
1757,473,236,237,39,54,44,50,90,196,0,1664,473
1758,940,707,233,78,92,82,81,169,438,4,2753,944
1759,1282,904,378,93,115,102,127,252,593,0,3904,1282
1760,373,201,172,30,33,39,41,61,169,3,1247,376
1761,1110,610,500,91,92,98,125,195,509,178,3501,1288
1762,2712,1658,1054,160,243,255,293,475,1286,28,8321,2740
1763,2195,1363,832,113,189,204,218,389,1082,150,6609,2345
1764,682,470,212,32,68,70,70,125,317,0,2019,682
1765,852,510,342,75,72,90,66,161,388,0,2467,852
1766,1099,735,364,53,94,101,105,195,551,20,3289,1119
1767,1467,958,509,99,142,142,155,260,669,10,4437,1477
1768,1264,625,639,137,104,136,101,229,557,503,4256,1767
1769,1412,718,694,94,146,145,129,252,646,27,5062,1439
1770,1245,753,492,88,157,110,128,220,542,38,4245,1283
1771,1443,859,584,88,175,162,156,269,593,6,4730,1449
1772,883,610,273,69,93,103,89,162,367,39,2441,922
1773,935,707,228,45,83,78,94,177,458,21,2647,956
1774,1136,648,488,98,220,143,115,213,347,13,3503,1149
1775,492,224,268,52,70,51,48,80,191,24,1863,516
1776,908,520,388,76,137,92,101,175,327,7,3273,915
1777,742,388,354,67,121,84,86,133,251,8,2949,750
1778,211,65,146,25,33,21,23,40,69,0,882,211
1779,883,554,329,75,108,84,104,169,343,31,2857,914
1780,1394,746,648,86,238,179,150,263,478,14,5711,1408
1781,782,483,299,60,111,76,86,145,304,10,2694,792
1782,528,329,199,39,49,46,56,104,234,0,1606,528
1783,1327,849,478,93,116,126,149,262,581,10,3750,1337
1784,828,626,202,71,82,74,81,146,374,1,2187,829
1785,1369,1049,320,106,121,140,117,255,630,11,3862,1380
1786,1866,1345,521,182,183,184,201,341,775,0,4698,1866
1787,1522,944,578,102,155,161,145,313,646,7,5199,1529
1788,964,630,334,78,104,98,89,193,402,14,3292,978
1789,896,575,321,65,105,88,85,175,378,0,2818,896
1790,644,353,291,56,72,68,61,127,260,11,2024,655
1791,3283,1963,1320,323,511,390,323,619,1117,53,10343,3336
1792,1437,1118,319,109,156,158,148,277,589,1533,4046,2970
1793,370,216,154,36,28,34,33,72,167,0,1048,370
1794,797,452,345,51,84,94,75,142,351,18,2700,815
1795,1320,884,436,74,168,125,130,242,581,7,4410,1327
1796,783,486,297,90,93,103,82,143,272,0,2283,783
1797,426,192,234,43,73,49,42,76,143,0,1561,426
1798,3173,2148,1025,320,496,378,332,570,1077,33,9843,3206
1799,1093,744,349,103,152,116,115,217,390,94,3338,1187
1800,818,275,543,67,150,87,87,171,256,167,3455,985
1801,653,412,241,43,118,88,73,112,219,298,2371,951
1802,1356,650,706,101,186,133,159,279,498,52,5268,1408
1803,796,376,420,59,121,88,83,138,307,59,3618,855
1804,331,219,112,26,30,30,28,65,152,0,894,331
1805,593,256,337,64,51,64,44,110,260,14,1917,607
1806,368,271,97,34,40,32,39,72,151,79,923,447
1807,427,283,144,36,46,42,44,79,180,0,1327,427
1808,403,310,93,38,44,37,44,70,170,0,1003,403
1809,276,183,93,23,30,27,28,51,117,0,856,276
1810,837,618,219,70,85,77,88,160,357,0,2238,837
1811,720,439,281,62,141,85,71,137,224,9,2370,729
1812,312,171,141,27,35,33,30,61,126,0,982,312
1813,545,384,161,40,49,44,54,107,251,4,1660,549
1814,1039,800,239,98,114,95,114,180,438,12,2588,1051
1815,597,370,227,40,61,63,57,123,253,0,2038,597
1816,742,535,207,73,73,73,80,136,307,8,1869,750
1817,363,289,74,30,38,39,31,70,155,0,854,363
1818,814,648,166,67,85,88,70,157,347,52,1915,866
1819,911,673,238,76,92,84,96,175,388,153,2436,1064
1820,1417,940,477,120,152,141,145,263,596,0,4401,1417
1821,506,349,157,39,53,59,51,93,211,13,1398,519
1822,480,315,165,42,52,48,43,87,208,50,1275,530
1823,765,431,334,56,88,75,78,142,326,18,2690,783
1824,798,575,223,78,78,79,86,146,331,0,2011,798
1825,576,415,161,56,57,57,62,105,239,0,1450,576
1826,1480,1067,413,145,145,146,159,270,615,0,3726,1480
1827,331,205,126,22,34,35,32,68,140,25,1130,356
1828,8906,5326,3580,875,1387,1057,875,1680,3032,0,28058,8906
1829,204,141,63,16,22,24,21,37,84,6,565,210
1830,1701,974,727,143,257,172,189,328,612,0,6132,1701
1831,540,309,231,45,81,55,60,104,195,0,1945,540
1832,836,569,267,79,116,89,88,166,298,124,2554,960
1833,156,88,68,11,18,15,16,29,67,0,548,156
1834,381,215,166,28,44,37,39,71,162,0,1341,381
1835,633,357,276,46,72,62,65,117,271,0,2228,633
1836,404,228,176,30,46,40,41,75,172,0,1422,404
1837,1824,1348,476,153,185,168,192,349,777,49,4876,1873
1838,215,141,74,19,23,21,19,39,94,7,571,222
1839,448,273,175,39,87,53,44,85,140,9,1475,457
1840,497,338,159,29,55,47,50,97,219,38,1372,535
1841,409,239,170,40,31,37,37,80,184,180,1159,589
1842,530,360,170,30,58,50,53,104,235,11,1463,541
1843,1162,836,326,97,129,117,122,211,486,0,2943,1162
1844,490,306,184,36,46,42,52,97,217,50,1491,540
1845,119,37,82,14,19,12,13,23,38,45,496,164
1846,427,131,296,50,67,43,46,82,139,0,1785,427
1847,1853,1224,629,183,272,188,214,359,637,75,6078,1928
1848,1767,1167,600,175,260,179,204,342,607,32,5796,1799
1849,1061,784,277,89,108,98,112,203,451,0,2836,1061
1850,4456,2665,1791,438,694,529,438,840,1517,0,14039,4456
1851,369,221,148,36,57,44,36,70,126,20,1162,389
1852,758,375,383,82,62,82,61,137,334,122,2552,880
1853,426,244,182,36,64,43,47,82,154,24,1535,450
1854,322,139,183,35,28,34,24,60,141,0,1042,322
1855,627,270,357,67,54,67,47,116,276,9,2024,636
1856,559,394,165,41,50,45,55,110,258,0,1701,559
1857,939,748,191,77,99,102,81,182,398,109,2211,1048
1858,216,124,92,18,33,22,24,42,77,0,780,216
1859,342,196,146,29,52,35,38,66,122,7,1235,349
1860,432,133,299,50,68,44,47,83,140,0,1805,432
1861,440,217,223,48,36,47,35,80,194,0,1481,440
1862,600,268,332,78,38,75,52,105,252,95,1958,695
1863,3281,2168,1113,324,482,333,380,636,1126,10,10761,3291
1864,316,135,181,24,39,30,33,59,131,0,1263,316
1865,569,243,326,43,71,54,59,107,235,6,2269,575
1866,278,85,193,32,44,28,30,53,91,0,1162,278
1867,321,143,178,41,21,40,28,56,135,124,1047,445
1868,463,245,218,39,67,51,51,89,166,0,1624,463
1869,1130,838,292,98,116,139,118,205,454,19,2749,1149
1870,532,362,170,50,74,57,56,106,189,33,1625,565
1871,1721,1137,584,170,253,175,199,334,590,19,5646,1740
1872,610,403,207,60,90,62,71,118,209,0,2001,610
1873,407,277,130,38,56,43,43,81,146,0,1242,407
1874,454,241,213,38,66,50,50,88,162,32,1594,486
1875,1783,1373,410,168,196,164,196,310,749,0,4441,1783
1876,3215,2476,739,303,354,295,354,558,1351,132,8008,3347
1877,885,681,204,83,97,81,98,154,372,182,2205,1067
1878,225,117,108,24,33,30,20,42,76,0,854,225
1879,172,87,85,16,26,17,22,37,54,0,649,172
1880,476,249,227,51,70,63,43,90,159,0,1805,476
1881,845,393,452,72,120,97,88,170,298,11,2955,856
1882,495,230,265,42,71,57,51,99,175,90,1732,585
1883,632,294,338,54,90,73,66,127,222,133,2210,765
1884,718,363,355,66,107,72,90,155,228,64,2717,782
1885,266,188,78,19,24,21,26,52,124,0,811,266
1886,199,107,92,16,18,21,22,33,89,107,666,306
1887,493,271,222,43,55,52,47,97,199,0,1550,493
1888,308,205,103,28,36,33,27,56,128,9,877,317
1889,347,227,120,23,33,34,37,61,159,0,1049,347
1890,1079,776,303,91,119,109,114,196,450,0,2733,1079
1891,535,228,307,40,67,51,55,101,221,0,2134,535
1892,269,153,116,17,28,32,25,48,119,0,912,269
1893,729,329,400,73,125,84,71,130,246,14,2675,743
1894,178,96,82,14,16,18,20,29,81,2,596,180
1895,503,241,262,38,69,49,59,104,184,0,1954,503
1896,755,452,303,67,64,80,58,143,343,890,2188,1645
1897,759,502,257,59,69,70,64,148,349,301,2051,1060
1898,246,167,79,14,27,23,25,48,109,0,680,246
1899,224,152,72,13,25,21,22,44,99,0,619,224
1900,2413,1378,1035,230,250,263,246,425,999,0,7833,2413
1901,612,357,255,59,46,56,55,120,276,190,1731,802
1902,327,148,179,33,56,38,32,58,110,7,1200,334
1903,1339,765,574,128,139,146,136,236,554,0,4347,1339
1904,391,168,223,42,34,42,29,73,171,4,1262,395
1905,385,284,101,35,42,33,41,76,158,79,965,464
1906,197,92,105,17,28,23,20,40,69,0,687,197
1907,1033,641,392,119,123,135,109,188,359,0,3011,1033
1908,422,282,140,39,50,46,37,76,174,21,1203,443
1909,635,438,197,49,67,74,64,117,264,12,1755,647
1910,169,72,97,13,21,16,17,32,70,0,675,169
1911,1231,833,398,124,193,147,129,221,417,22,3818,1253
1912,557,308,249,51,55,57,61,104,229,0,1918,557
1913,747,413,334,68,74,76,82,140,307,7,2574,754
1914,462,256,206,42,46,47,50,87,190,0,1593,462
1915,653,417,236,58,76,65,63,126,265,17,2107,670
1916,1181,753,428,104,138,118,114,228,479,0,3808,1181
1917,293,221,72,24,29,26,25,53,136,0,860,293
1918,787,505,282,58,92,78,74,153,332,0,2475,787
1919,932,688,244,85,101,80,98,184,384,92,2339,1024
1920,1290,957,333,112,132,159,134,233,520,147,3138,1437
1921,2099,1557,542,182,216,259,219,380,843,41,5107,2140
1922,523,349,174,48,61,57,46,95,216,22,1491,545
1923,1240,708,532,118,129,135,126,218,514,0,4025,1240
1924,431,246,185,41,45,47,44,76,178,0,1399,431
1925,274,154,120,20,31,27,28,51,117,0,963,274
1926,75,48,27,7,9,8,7,14,30,0,242,75
1927,8314,5304,3010,733,972,832,803,1602,3372,0,26807,8314
1928,98,56,42,6,10,12,9,17,44,0,332,98
1929,457,302,155,35,42,42,39,89,210,0,1235,457
1930,248,197,51,20,26,27,21,48,106,0,584,248
1931,51,33,18,4,6,5,5,9,22,0,134,51
1932,108,71,37,9,12,11,10,20,46,0,286,108
1933,247,141,106,21,37,25,27,48,89,0,889,247
1934,0,0,0,0,0,0,0,0,0,0,0,0
1935,1955,862,1093,180,243,202,231,307,792,50,7519,2005
1936,568,530,38,81,65,60,64,105,193,0,978,568
1937,2095,1648,447,160,170,197,186,435,947,0,5279,2095
1938,691,526,165,55,43,66,77,152,298,1,1800,692
1939,284,216,68,28,27,28,33,48,120,0,693,284
1940,1978,1545,433,169,153,196,180,393,887,34,5114,2012
1941,203,147,56,18,15,16,23,44,87,0,534,203
1942,918,667,251,83,68,74,104,201,388,11,2413,929
1943,588,459,129,47,40,43,56,137,265,0,1549,588
1944,2061,1635,426,135,146,217,220,447,896,7,5268,2068
1945,1518,1174,344,90,119,144,148,318,699,0,3967,1518
1946,505,269,236,68,55,59,47,93,183,48,1611,553
1947,1245,1012,233,92,99,104,148,286,516,492,3134,1737
1948,2813,2162,651,224,224,310,264,583,1208,0,7158,2813
1949,274,150,124,27,27,36,19,58,107,14,725,288
1950,1079,812,267,88,80,114,108,229,460,0,2877,1079
1951,35,18,17,4,3,4,4,7,13,0,112,35
1952,1363,854,509,85,135,142,105,285,611,3,4120,1366
1953,643,483,160,59,71,63,66,120,264,0,1625,643
1954,2847,1391,1456,236,359,292,274,546,1140,0,8485,2847
1955,878,685,193,77,107,85,98,149,362,0,2046,878
1956,1711,1335,376,150,208,166,192,290,705,13,3986,1724
1957,635,462,173,61,67,61,57,106,283,0,1636,635
1958,3464,2405,1059,279,369,335,330,675,1476,0,10025,3464
1959,2234,1385,849,178,184,199,212,444,1017,18,6407,2252
1960,80,38,42,8,9,10,5,18,30,0,241,80
1961,822,602,220,76,83,79,91,167,326,0,2068,822
1962,335,287,48,33,32,31,37,58,144,0,734,335
1963,247,176,71,24,24,25,27,49,98,0,667,247
1964,400,278,122,32,37,49,43,74,165,964,1050,1364
1965,438,294,144,42,39,41,46,93,177,0,1182,438
1966,752,349,403,84,72,92,63,144,297,46,2865,798
1967,407,189,218,45,39,50,34,78,161,9,1550,416
1968,388,215,173,42,35,54,24,76,157,0,1053,388
1969,516,378,138,48,52,49,57,105,205,0,1299,516
1970,666,426,240,112,78,83,74,105,214,0,1729,666
1971,229,94,135,26,24,26,19,45,89,0,890,229
1972,498,364,134,46,50,48,55,101,198,0,1254,498
1973,496,317,179,83,58,62,55,78,160,9,1288,505
1974,560,358,202,94,65,70,62,88,181,0,1454,560
1975,2138,2011,127,641,458,217,228,264,330,0,3504,2138
1976,452,236,216,144,70,69,37,59,73,0,1293,452
1977,311,169,142,88,55,41,31,40,56,7,870,318
1978,1301,1200,101,477,211,152,156,138,167,0,2528,1301
1979,0,0,0,0,0,0,0,0,0,119,0,119
1980,2285,1440,845,389,486,302,282,316,510,21,6121,2306
1981,368,259,109,34,34,39,37,69,155,0,999,368
1982,2890,2100,790,688,427,356,334,432,653,0,7081,2890
1983,1447,1094,353,136,149,131,143,261,627,0,3742,1447
1984,481,339,142,44,45,51,49,91,201,0,1305,481
1985,631,240,391,87,72,76,71,111,214,325,2364,956
1986,454,342,112,42,47,41,47,83,194,0,1053,454
1987,497,362,135,48,52,47,45,83,222,0,1280,497
1988,403,248,155,45,34,51,39,79,155,0,1077,403
1989,546,186,360,65,50,66,47,108,210,0,2340,546
1990,702,326,376,78,67,86,59,134,278,49,2674,751
1991,627,344,283,64,65,76,51,113,258,13,2074,640
1992,326,111,215,39,30,39,28,64,126,0,1396,326
1993,493,249,244,54,46,52,54,98,189,14,1583,507
1994,1327,1238,89,190,151,141,148,245,452,186,2282,1513
1995,641,545,96,140,82,81,68,107,163,0,1233,641
1996,703,417,286,136,92,89,71,113,202,0,1977,703
1997,1336,659,677,370,255,159,139,187,226,0,4235,1336
1998,893,760,133,195,114,113,95,149,227,0,1718,893
1999,837,712,125,183,107,106,89,140,212,0,1611,837
2000,672,398,274,130,88,85,68,108,193,0,1891,672
2001,601,356,245,117,78,76,61,96,173,0,1692,601
2002,417,247,170,81,54,53,42,67,120,177,1174,594
2003,239,150,89,15,24,25,18,50,107,0,723,239
2004,3258,2868,390,793,420,430,370,507,738,83,6360,3341
2005,1665,1466,199,405,215,220,189,259,377,683,3250,2348
2006,607,334,273,129,87,79,58,94,160,581,1545,1188
2007,740,605,135,96,85,94,79,135,251,0,1558,740
2008,708,453,255,119,82,89,79,112,227,23,1839,731
2009,869,407,462,183,161,102,110,115,198,69,2561,938
2010,952,696,256,78,87,89,82,198,418,0,2597,952
2011,411,284,127,45,46,44,35,82,159,0,1063,411
2012,672,465,207,74,75,73,57,134,259,15,1737,687
2013,468,245,223,54,55,58,40,89,172,28,1610,496
2014,420,224,196,56,45,49,39,77,154,0,1339,420
2015,245,135,110,25,25,30,20,44,101,0,812,245
2016,259,131,128,28,24,27,28,51,101,0,832,259
2017,422,148,274,61,51,48,44,70,148,11,1613,433
2018,566,199,367,82,69,64,59,94,198,8,2162,574
2019,454,153,301,48,48,49,46,85,178,20,1898,474
2020,738,502,236,207,120,89,86,116,120,13,1928,751
2021,1194,752,442,203,254,158,147,165,267,0,3198,1194
2022,347,273,74,32,32,34,38,61,150,0,818,347
2023,659,565,94,64,63,62,73,114,283,92,1446,751
2024,467,277,190,91,61,59,47,75,134,0,1314,467
2025,448,157,291,65,54,51,47,74,157,17,1710,465
2026,274,96,178,40,33,31,29,45,96,13,1045,287
2027,774,400,374,98,82,90,77,147,280,0,2642,774
2028,485,250,235,61,52,57,48,92,175,104,1654,589
2029,349,196,153,40,32,41,30,72,134,12,1039,361
2030,592,333,259,68,54,69,51,122,228,0,1761,592
2031,633,356,277,72,57,74,55,130,245,0,1883,633
2032,353,198,155,40,32,41,30,73,137,0,1048,353
2033,508,285,223,58,46,59,44,105,196,47,1510,555
2034,478,269,209,55,43,56,41,98,185,0,1422,478
2035,357,249,108,25,30,43,38,74,147,0,1026,357
2036,1514,1200,314,222,183,202,162,253,492,53,3267,1567
2037,728,596,132,94,83,92,77,133,249,0,1533,728
2038,592,277,315,124,110,70,75,78,135,1,1744,593
2039,693,567,126,90,79,88,74,127,235,0,1461,693
2040,1159,1035,124,173,141,149,116,207,373,0,2074,1159
2041,1123,890,233,165,136,150,120,188,364,157,2423,1280
2042,2103,875,1228,329,223,258,186,382,725,0,7456,2103
2043,609,291,318,63,63,57,46,128,252,87,2401,696
2044,688,289,399,97,71,82,71,128,239,46,2686,734
2045,397,212,185,53,43,46,37,73,145,0,1268,397
2046,403,211,192,47,47,50,34,77,148,0,1385,403
2047,370,256,114,41,42,40,31,74,142,0,955,370
2048,418,199,219,51,39,56,35,82,155,0,1459,418
2049,784,326,458,123,83,96,69,142,271,0,2778,784
2050,263,132,131,33,26,31,23,53,97,115,902,378
2051,2400,1059,1341,221,298,248,284,377,972,20,9230,2420
2052,2176,830,1346,293,161,217,188,375,942,862,7287,3038
2053,637,309,328,75,67,78,62,124,231,0,2360,637
2054,454,220,234,54,48,56,44,88,164,0,1682,454
2055,549,266,283,65,58,68,53,107,198,0,2034,549
2056,246,119,127,29,26,30,24,48,89,0,912,246
2057,269,131,138,32,28,33,26,52,98,0,997,269
2058,281,136,145,33,30,35,27,55,101,0,1041,281
2059,337,114,223,36,36,37,34,63,131,7,1409,344
2060,257,126,131,21,32,26,25,49,104,0,767,257
2061,515,265,250,143,92,73,55,62,90,1,1487,516
2062,380,195,185,105,68,54,41,45,67,0,1097,380
2063,709,332,377,149,131,83,90,93,163,643,2089,1352
2064,287,118,169,32,30,33,24,57,111,0,1116,287
2065,1021,508,513,135,123,117,96,187,363,119,3941,1140
2066,432,215,217,57,52,50,41,79,153,13,1666,445
2067,894,815,79,307,120,113,90,120,144,393,1448,1287
2068,1510,951,559,257,321,200,186,209,337,9,4045,1519
2069,642,395,247,71,54,81,62,126,248,0,1718,642
2070,350,183,167,41,41,43,30,67,128,0,1202,350
2071,679,315,364,76,65,83,57,130,268,0,2584,679
2072,378,181,197,45,42,41,31,77,142,4,1377,382
2073,446,218,228,58,43,51,44,86,164,0,1481,446
2074,319,156,163,42,31,36,31,62,117,0,1058,319
2075,939,356,583,111,99,102,89,185,353,0,3989,939
2076,885,778,107,128,95,101,112,158,291,9,1773,894
2077,1907,1433,474,176,212,187,196,357,779,39,4817,1946
2078,834,536,298,205,170,102,98,114,145,31,2043,865
2079,1144,578,566,281,171,168,114,170,240,7,3403,1151
2080,1726,872,854,424,259,253,171,256,363,74,5135,1800
2081,307,168,139,30,31,40,22,65,119,0,813,307
2082,1417,537,880,168,149,154,134,279,533,2,6017,1419
2083,2297,870,1427,272,242,250,218,452,863,8,9758,2305
2084,1286,433,853,136,136,140,131,240,503,0,5376,1286
2085,270,111,159,30,28,31,22,53,106,0,1050,270
2086,365,152,213,41,37,45,36,70,136,55,1279,420
2087,331,183,148,36,30,46,20,65,134,17,899,348
2088,661,532,129,53,70,60,84,117,277,448,1548,1109
2089,658,551,107,206,109,68,70,92,113,4,1321,662
2090,614,577,37,184,131,62,66,76,95,10,1007,624
2091,1,1,0,0,0,0,0,0,1,108,2,109
2092,577,240,337,65,58,70,57,111,216,0,2021,577
2093,319,281,38,46,34,36,40,57,106,0,639,319
2094,291,99,192,35,27,35,25,57,112,0,1246,291
2095,523,246,277,50,62,67,36,118,190,0,1587,523
2096,296,142,154,35,33,32,24,60,112,0,1079,296
2097,300,166,134,33,27,42,18,59,121,0,814,300
2098,2421,1295,1126,386,283,294,261,409,788,42,7762,2463
2099,224,156,68,16,19,27,24,46,92,0,644,224
2100,985,781,204,144,119,131,105,165,321,0,2125,985
2101,680,539,141,100,82,91,73,114,220,0,1467,680
2102,1896,1749,147,695,308,222,227,201,243,129,3682,2025
2103,844,746,98,120,95,123,97,144,265,7,1551,851
2104,451,265,186,55,41,42,40,88,185,0,1299,451
2105,305,145,160,37,28,41,25,59,115,0,1067,305
2106,2329,2050,279,567,300,307,265,363,527,46,4546,2375
2107,443,323,120,43,47,42,40,74,197,0,1141,443
2108,672,508,164,63,69,61,66,121,292,0,1738,672
2109,698,508,190,68,74,67,63,116,310,0,1799,698
2110,323,163,160,35,30,34,35,64,125,0,1038,323
2111,470,258,212,105,94,66,51,60,94,0,1372,470
2112,489,269,220,109,97,68,53,62,100,17,1427,506
2113,364,297,67,39,38,33,45,69,140,0,844,364
2114,365,284,81,27,28,31,39,76,164,0,950,365
2115,439,217,222,121,84,52,46,62,74,0,1391,439
2116,1403,548,855,186,92,135,134,260,596,0,4469,1403
2117,573,404,169,52,53,61,58,108,241,0,1555,573
2118,498,364,134,41,45,47,43,104,218,0,1357,498
2119,1065,861,204,291,238,123,117,132,164,1,2246,1066
2120,705,698,7,243,108,97,68,90,99,152,1362,857
2121,470,258,212,100,68,61,45,73,123,0,1197,470
2122,524,288,236,111,75,68,50,81,139,0,1335,524
2123,418,325,93,31,32,35,45,87,188,0,1086,418
2124,721,501,220,121,75,71,78,126,250,0,1808,721
2125,793,673,120,276,133,99,86,92,107,24,1403,817
2126,146,141,5,46,33,14,14,18,21,53,271,199
2127,625,471,154,58,64,56,65,114,268,0,1451,625
2128,336,253,83,31,35,30,35,61,144,0,779,336
2129,993,737,256,72,119,76,100,191,435,0,2365,993
2130,729,587,142,59,77,66,93,129,305,0,1707,729
2131,539,434,105,43,57,49,68,95,227,0,1263,539
2132,1027,772,255,95,114,101,105,192,420,0,2593,1027
2133,639,417,222,106,85,76,77,108,187,0,1687,639
2134,360,254,106,33,33,38,36,68,152,38,976,398
2135,1047,824,223,96,98,101,115,186,451,85,2469,1132
2136,294,215,79,27,30,28,32,60,117,0,741,294
2137,554,453,101,59,58,50,68,104,215,0,1288,554
2138,475,369,106,35,36,40,51,99,214,0,1233,475
2139,791,423,368,126,93,96,85,134,257,0,2535,791
2140,992,886,106,148,120,128,100,178,318,0,1776,992
2141,923,816,107,131,104,134,107,158,289,17,1696,940
2142,508,447,61,74,54,58,64,90,168,13,1018,521
2143,679,566,113,111,89,77,71,114,217,0,1403,679
2144,408,266,142,68,55,49,49,69,118,21,1077,429
2145,375,244,131,62,50,45,45,64,109,0,989,375
2146,283,118,165,41,34,34,31,44,99,0,986,283
2147,364,254,110,26,31,44,39,75,149,0,1047,364
2148,274,198,76,33,29,31,42,45,94,0,765,274
2149,395,164,231,57,47,47,44,61,139,0,1376,395
2150,521,304,217,58,59,64,48,97,195,179,1609,700
2151,541,347,194,133,111,66,63,74,94,0,1324,541
2152,428,175,253,48,45,49,35,84,167,0,1666,428
2153,2806,2559,247,963,375,354,281,376,457,44,4543,2850
2154,3140,2740,400,740,423,415,346,473,743,27,5763,3167
2155,643,483,160,72,53,72,74,126,246,3,1532,646
2156,510,387,123,50,49,51,60,86,214,56,1243,566
2157,318,241,77,31,30,32,37,54,134,0,775,318
2158,400,286,114,39,39,40,44,80,158,0,1080,400
2159,250,190,60,25,24,25,29,42,105,0,609,250
2160,422,270,152,71,49,53,47,67,135,0,1097,422
2161,464,297,167,78,54,58,52,73,149,0,1204,464
2162,1304,1138,166,307,176,173,144,196,308,19,2393,1323
2163,308,269,39,73,42,41,34,46,72,0,564,308
2164,359,313,46,85,48,47,40,54,85,0,659,359
2165,481,420,61,113,65,64,53,72,114,25,883,506
2166,2033,1772,261,421,283,224,223,329,553,228,3732,2261
2167,487,453,34,107,72,57,49,81,121,74,807,561
2168,817,761,56,180,121,95,82,135,204,0,1353,817
2169,514,479,35,113,76,60,52,85,128,0,851,514
2170,725,675,50,160,107,84,73,120,181,0,1200,725
2171,1115,1040,75,159,127,119,125,206,379,0,1918,1115
2172,494,461,33,71,56,53,55,91,168,0,851,494
2173,1015,533,482,131,117,114,108,186,359,3,3857,1018
2174,316,158,158,40,32,37,28,63,116,0,1084,316
2175,258,143,115,28,23,36,16,51,104,8,699,266
2176,620,417,203,59,55,58,65,132,251,11,1670,631
2177,389,215,174,42,35,55,24,77,156,0,1055,389
2178,708,538,170,70,67,71,83,119,298,0,1727,708
2179,471,251,220,63,51,55,44,86,172,0,1504,471
2180,742,606,136,79,77,67,92,140,287,3,1724,745
2181,396,164,232,57,47,47,44,61,140,0,1379,396
2182,688,600,88,142,96,76,75,111,188,0,1264,688
2183,235,98,137,34,28,28,26,36,83,0,818,235
2184,513,436,77,112,66,65,54,86,130,0,986,513
2185,432,152,280,62,52,49,45,71,153,0,1649,432
2186,622,236,386,85,71,75,70,110,211,0,2331,622
2187,276,114,162,34,32,32,30,45,103,12,1001,288
2188,578,298,280,73,62,68,57,110,208,0,1972,578
2189,5863,2586,3277,540,728,605,694,920,2376,0,22550,5863
2190,372,160,212,37,34,45,35,68,153,6,1514,378
2191,275,196,79,27,27,27,30,55,109,0,742,275
2192,351,252,99,28,28,32,32,82,149,39,914,390
2193,439,314,125,43,43,44,48,88,173,0,1185,439
2194,247,166,81,23,22,23,26,52,101,0,666,247
2195,448,322,126,36,36,41,40,105,190,0,1167,448
2196,261,187,74,21,21,24,24,61,110,6,680,267
2197,443,329,114,32,53,34,44,85,195,0,1054,443
2198,294,204,90,24,27,36,32,54,121,0,772,294
2199,557,234,323,78,58,67,57,104,193,13,2173,570
2200,355,245,110,39,40,38,30,71,137,0,918,355
2201,3430,1801,1629,444,397,385,364,629,1211,3,13027,3433
2202,507,252,255,67,61,58,48,93,180,57,1956,564
2203,353,148,205,50,36,42,36,66,123,13,1376,366
2204,516,270,246,60,61,64,44,98,189,0,1776,516
2205,1020,424,596,160,108,125,90,185,352,0,3616,1020
2206,564,268,296,69,53,75,47,110,210,0,1972,564
2207,594,365,229,66,50,75,58,116,229,0,1589,594
2208,3174,2439,735,253,252,349,298,657,1365,0,8079,3174
2209,2340,1170,1170,295,235,273,204,468,865,0,8037,2340
2210,443,232,211,142,69,68,37,58,69,4,1268,447
2211,361,150,211,41,36,44,36,70,134,0,1263,361
2212,241,116,125,29,27,26,20,49,90,0,879,241
2213,478,420,58,69,51,54,60,85,159,0,958,478
2214,239,115,124,29,27,26,20,48,89,0,868,239
2215,353,147,206,40,36,43,35,68,131,0,1237,353
2216,4053,3275,778,1106,905,470,443,502,627,65,8544,4118
2217,494,247,247,62,50,58,43,99,182,0,1697,494
2218,425,208,217,55,41,49,42,82,156,0,1411,425
2219,341,163,178,41,38,37,28,69,128,0,1241,341
2220,282,155,127,29,29,34,23,51,116,0,933,282
2221,681,322,359,91,80,82,64,127,237,170,2520,851
2222,403,211,192,47,47,50,34,77,148,0,1385,403
2223,486,254,232,56,57,60,41,93,179,0,1670,486
2224,472,394,78,77,62,54,49,79,151,17,975,489
2225,539,449,90,88,70,61,56,90,174,0,1115,539
2226,1759,1705,54,565,307,186,217,209,275,0,2794,1759
2227,645,380,265,79,58,59,58,125,266,13,1859,658
2228,734,612,122,120,96,84,77,123,234,0,1516,734
2229,296,207,89,21,25,36,32,61,121,0,850,296
2230,446,337,109,42,46,40,44,81,193,0,1155,446
2231,341,214,127,21,34,36,26,71,153,0,1030,341
2232,1452,687,765,195,170,174,137,271,505,8,5373,1460
2233,434,384,50,62,49,63,50,74,136,25,798,459
2234,279,105,174,37,33,40,27,43,99,0,1067,279
2235,778,424,354,220,139,104,76,100,139,0,2177,778
2236,752,602,150,84,67,76,78,157,290,0,1781,752
2237,545,234,311,54,49,67,51,100,224,0,2218,545
2238,240,167,73,17,20,29,26,50,98,0,691,240
2239,551,441,110,61,49,55,57,115,214,0,1304,551
2240,308,126,182,34,32,35,26,61,120,15,1200,323
2241,515,441,74,50,49,48,57,89,222,92,1130,607
2242,413,311,102,39,42,37,43,75,177,0,959,413
2243,471,355,116,44,48,42,49,86,202,111,1093,582
2244,587,321,266,58,59,77,42,125,226,179,1554,766
2245,304,211,93,51,32,30,33,53,105,0,762,304
2246,514,316,198,73,52,54,64,91,180,0,1407,514
2247,291,190,101,48,39,35,35,49,85,0,768,291
2248,6762,3618,3144,1077,791,820,728,1141,2205,10,21679,6772
2249,484,336,148,81,51,48,52,84,168,0,1214,484
2250,487,300,187,69,49,51,60,87,171,21,1334,508
2251,399,245,154,56,40,42,49,71,141,0,1093,399
2252,643,514,129,72,57,65,67,134,248,0,1523,643
2253,725,580,145,81,65,73,75,151,280,0,1716,725
2254,472,340,132,57,49,54,73,78,161,440,1314,912
2255,430,162,268,58,51,62,41,67,151,0,1646,430
2256,403,190,213,38,48,52,27,91,147,0,1224,403
2257,685,323,362,65,81,88,47,155,249,0,2077,685
2258,3900,2087,1813,621,456,473,420,658,1272,6,12502,3906
2259,614,461,153,69,51,68,71,121,234,0,1464,614
2260,531,201,330,71,63,77,51,83,186,0,2031,531
2261,410,155,255,55,49,59,39,64,144,0,1568,410
2262,304,115,189,42,35,37,34,54,102,0,1139,304
2263,331,137,194,41,38,38,36,54,124,52,1201,383
2264,393,162,231,48,45,45,43,64,148,0,1427,393
2265,479,279,200,53,54,59,44,89,180,0,1481,479
2266,314,130,184,38,36,36,34,51,119,0,1138,314
2267,265,137,128,33,28,31,26,50,97,0,904,265
2268,537,313,224,59,61,66,49,100,202,0,1660,537
2269,474,253,221,64,51,55,44,87,173,25,1514,499
2270,539,314,225,60,61,66,50,101,201,0,1667,539
2271,365,213,152,40,41,45,34,68,137,33,1128,398
2272,3077,1280,1797,482,326,378,272,559,1060,0,10908,3077
2273,458,228,230,60,55,52,43,84,164,0,1766,458
2274,113,82,31,10,8,9,13,25,48,212,298,325
2275,95,69,26,9,7,8,11,21,39,0,251,95
2276,974,965,9,336,150,134,94,124,136,60,1881,1034
2277,1486,1441,45,477,260,157,183,177,232,113,2361,1599
2278,285,268,17,85,61,29,30,35,45,33,467,318
2279,285,134,151,84,45,41,29,32,54,49,785,334
2280,452,213,239,134,72,64,45,52,85,7,1247,459
2281,51,37,14,4,4,5,5,12,21,10,133,61
2282,780,417,363,124,91,95,84,132,254,4,2500,784
2283,896,767,129,61,68,80,81,188,418,0,2161,896
2284,758,595,163,63,50,73,82,131,359,0,1938,758
2285,959,720,239,80,74,101,92,168,444,0,2523,959
2286,621,478,143,68,50,62,64,98,279,0,1612,621
2287,1327,1058,269,101,113,133,151,225,604,31,3336,1358
2288,783,665,118,69,72,77,98,124,343,0,1891,783
2289,436,308,128,62,49,44,50,72,159,0,1077,436
2290,606,512,94,65,56,64,66,103,252,50,1311,656
2291,7,4,3,0,1,3,2,0,1,1653,22,1660
2292,241,194,47,29,22,27,29,43,91,1560,487,1801
2293,708,474,234,106,60,80,69,141,252,1539,1724,2247
2294,334,224,110,50,28,38,33,66,119,895,815,1229
2295,3369,2983,386,474,339,364,388,611,1193,184,7093,3553
2296,319,245,74,44,28,35,36,52,124,8,782,327
2297,1571,1186,385,140,137,149,193,269,683,28,3888,1599
2298,1827,1327,500,238,187,202,205,263,732,0,4297,1827
2299,837,741,96,118,84,90,96,152,297,3,1763,840
2300,19,16,3,3,3,2,2,3,6,0,36,19
2301,538,465,73,96,74,65,58,91,154,0,1023,538
2302,1678,1450,228,300,230,204,182,284,478,0,3187,1678
2303,6655,5752,903,1191,913,809,723,1127,1892,0,12640,6655
2304,600,398,202,62,56,58,68,91,265,0,1599,600
2305,324,229,95,46,36,33,37,53,119,0,801,324
2306,615,496,119,67,69,71,67,103,238,0,1365,615
2307,477,376,101,62,41,51,48,64,211,0,1057,477
2308,387,274,113,55,43,39,45,64,141,10,957,397
2309,575,390,185,85,64,57,64,85,220,0,1483,575
2310,405,311,94,49,45,49,45,68,149,12,944,417
2311,621,439,182,89,70,63,72,102,225,132,1535,753
2312,311,255,56,45,21,36,32,56,121,0,722,311
2313,285,234,51,41,19,33,30,51,111,0,662,285
2314,2232,1929,303,399,306,271,243,378,635,0,4239,2232
2315,1183,1022,161,212,162,144,129,200,336,0,2248,1183
2316,1721,1487,234,308,236,209,187,291,490,3,3268,1724
2317,2148,1857,291,384,295,261,233,364,611,0,4080,2148
2318,993,841,152,146,111,123,85,174,354,1,2379,994
2319,745,632,113,89,69,80,88,140,279,0,1607,745
2320,168,140,28,16,13,19,19,32,69,0,403,168
2321,1275,1081,194,152,118,137,151,240,477,14,2750,1289
2322,920,755,165,133,61,107,96,166,357,177,2137,1097
2323,812,663,149,98,75,91,98,140,310,62,1761,874
2324,655,534,121,79,60,74,79,113,250,0,1422,655
2325,400,308,92,39,39,42,50,57,173,0,1014,400
2326,568,470,98,69,55,64,59,94,227,46,1267,614
2327,642,457,185,116,60,81,64,102,219,3,1566,645
2328,4055,3505,550,725,556,493,441,687,1153,99,7702,4154
2329,279,198,81,42,27,34,33,52,91,0,693,279
2330,484,343,141,72,47,59,57,90,159,215,1204,699
2331,514,375,139,63,44,52,68,59,228,0,1339,514
2332,492,343,149,81,47,55,60,87,162,190,1168,682
2333,370,263,107,55,36,45,44,68,122,19,919,389
2334,416,266,150,35,40,40,45,78,178,5,1147,421
2335,620,440,180,92,60,76,74,115,203,0,1542,620
2336,494,379,115,68,43,53,56,81,193,0,1211,494
2337,812,665,147,102,75,89,106,123,317,14,1911,826
2338,901,763,138,133,100,112,77,158,321,116,2159,1017
2339,1139,794,345,187,108,128,139,202,375,0,2704,1139
2340,520,323,197,61,50,66,52,79,212,119,1413,639
2341,4124,2996,1128,537,421,456,463,593,1654,0,9703,4124
2342,396,252,144,48,44,49,45,67,143,832,921,1228
2343,840,745,95,109,81,94,102,141,313,0,1730,840
2344,758,672,86,99,73,85,92,127,282,0,1562,758
2345,0,0,0,0,0,0,0,0,0,0,0,0
2346,621,514,107,75,60,70,64,103,249,0,1385,621
2347,820,694,126,121,91,102,70,144,292,5,1967,825
2348,288,244,44,25,26,28,36,46,127,11,695,299
2349,646,529,117,81,60,70,84,98,253,57,1520,703
2350,369,234,135,45,41,45,42,62,134,46,860,415
2351,863,714,149,104,84,97,90,142,346,0,1925,863
2352,357,298,59,33,27,41,41,67,148,98,857,455
2353,626,482,144,60,60,65,78,89,274,0,1586,626
2354,940,847,93,155,89,108,105,162,321,5184,1910,6124
2355,1228,895,333,166,139,135,141,214,433,0,2986,1228
2356,234,144,90,34,25,26,22,36,91,0,637,234
2357,494,379,115,40,44,49,49,78,234,0,1227,494
2358,336,215,121,28,33,33,36,63,143,0,928,336
2359,346,213,133,50,37,39,32,53,135,60,940,406
2360,335,238,97,31,32,36,41,59,136,0,861,335
2361,362,224,138,31,31,40,41,56,163,0,1037,362
2362,508,395,113,51,51,57,57,78,214,5,1177,513
2363,539,419,120,54,54,61,60,83,227,0,1249,539
2364,465,331,134,43,44,51,56,82,189,0,1194,465
2365,449,298,151,47,42,44,51,68,197,0,1195,449
2366,521,334,187,43,51,51,56,97,223,6,1438,527
2367,339,255,84,28,26,36,32,60,157,0,891,339
2368,653,464,189,60,62,71,79,116,265,7,1678,660
2369,591,454,137,48,52,59,58,94,280,0,1467,591
2370,506,428,78,54,47,54,55,86,210,1,1094,507
2371,261,192,69,29,24,25,28,45,110,0,638,261
2372,455,365,90,54,41,54,50,77,179,0,1002,455
2373,588,474,114,70,53,65,70,105,225,30,1186,618
2374,670,538,132,80,60,80,74,114,262,3,1476,673
2375,1410,1251,159,183,136,158,171,237,525,8,2905,1418
2376,239,186,53,24,24,27,27,37,100,0,555,239
2377,655,525,130,73,58,70,74,106,274,0,1426,655
2378,1314,1035,279,170,113,140,133,177,581,35,2914,1349
2379,366,288,78,47,32,39,37,49,162,207,812,573
2380,473,372,101,61,41,51,48,64,208,0,1048,473
2381,341,228,113,51,29,39,33,68,121,295,830,636
2382,584,426,158,79,66,64,67,102,206,0,1420,584
2383,582,361,221,69,56,74,58,88,237,0,1582,582
2384,350,296,54,37,32,37,38,59,147,16,757,366
2385,847,684,163,92,95,98,93,142,327,21,1881,868
2386,368,286,82,37,37,41,41,56,156,0,852,368
2387,188,145,43,18,18,20,24,27,81,0,476,188
2388,619,496,123,69,55,67,70,100,258,83,1349,702
2389,1708,1312,396,208,189,205,192,287,627,153,3978,1861
2390,315,220,95,52,30,35,39,56,103,26,746,341
2391,324,199,125,46,35,37,30,50,126,0,881,324
2392,462,384,78,57,55,55,50,74,171,37,980,499
2393,402,334,68,49,48,48,43,64,150,89,851,491
2394,596,425,171,107,56,75,60,94,204,0,1454,596
2395,897,724,173,98,100,103,98,151,347,174,1993,1071
2396,273,201,72,30,25,26,30,47,115,0,668,273
2397,583,468,115,69,53,69,65,99,228,0,1284,583
2398,525,333,192,64,58,65,59,88,191,0,1223,525
2399,537,484,53,88,51,62,60,92,184,1816,1091,2353
2400,292,181,111,25,25,32,33,45,132,0,838,292
2401,821,739,82,135,78,94,92,141,281,613,1668,1434
2402,933,751,182,110,83,103,111,166,360,820,1881,1753
2403,1850,1482,368,207,165,199,210,298,771,9,4030,1859
2404,1119,930,189,137,133,132,120,179,418,2,2371,1121
2405,702,476,226,104,79,70,78,103,268,0,1814,702
2406,394,243,151,56,43,44,36,61,154,127,1070,521
2407,2007,1515,492,179,175,190,247,343,873,0,4965,2007
2408,299,254,45,26,28,29,37,47,132,0,722,299
2409,415,319,96,33,37,41,41,66,197,0,1030,415
2410,450,279,171,39,39,50,51,69,202,0,1289,450
2411,1074,811,263,96,94,102,132,184,466,1,2659,1075
2412,913,665,248,113,77,91,120,106,406,0,2378,913
2413,38,28,10,5,4,4,4,5,16,0,88,38
2414,492,421,71,33,37,44,44,103,231,3,1189,495
2415,0,0,0,0,0,0,0,0,0,0,0,0
2416,170,125,45,19,16,16,18,29,72,0,415,170
2417,183,135,48,20,17,18,20,32,76,0,448,183
2418,233,181,52,23,23,26,26,36,99,6,540,239
2419,3011,2187,824,392,307,333,338,433,1208,0,7083,3011
2420,2027,1472,555,264,207,224,228,291,813,0,4768,2027
2421,0,0,0,0,0,0,0,0,0,10,0,10
2422,1262,1091,171,226,173,153,137,214,359,0,2397,1262
2423,543,481,62,76,55,59,63,99,191,0,1143,543
2424,433,383,50,61,44,47,50,79,152,3,912,436
2425,573,507,66,81,58,62,66,104,202,210,1205,783
2426,316,285,31,52,30,36,35,54,109,0,643,316
2427,403,335,68,49,48,48,43,64,151,179,853,582
2428,459,381,78,56,55,54,49,73,172,0,972,459
2429,182,151,31,22,22,22,20,29,67,0,385,182
2430,190,158,32,23,23,22,20,30,72,0,402,190
2431,292,243,49,36,35,35,31,47,108,0,619,292
2432,425,301,124,61,48,43,49,70,154,29,1051,454
2433,90,55,35,13,10,10,8,14,35,0,244,90
2434,360,277,83,44,40,43,40,60,133,0,839,360
2435,170,131,39,21,19,20,19,29,62,0,397,170
2436,92,57,35,13,10,10,9,14,36,18,249,110
2437,94,67,27,14,9,11,11,17,32,0,234,94
2438,110,78,32,16,11,13,13,20,37,0,274,110
2439,107,76,31,16,10,13,13,20,35,0,267,107
2440,120,85,35,18,12,15,14,22,39,0,299,120
2441,289,241,48,27,22,33,33,54,120,0,694,289
2442,381,323,58,45,35,41,45,72,143,0,822,381
2443,1098,931,167,131,101,118,130,206,412,0,2369,1098
2444,315,267,48,38,29,34,37,59,118,41,680,356
2445,775,296,479,104,57,77,67,133,337,0,2594,775
2446,0,0,0,0,0,0,0,0,0,0,0,0
2447,0,0,0,0,0,0,0,0,0,0,0,0
2448,362,142,220,48,24,35,34,67,154,0,1155,362
2449,0,0,0,0,0,0,0,0,0,0,0,0
2450,1087,817,270,101,121,106,112,203,444,0,2745,1087
2451,531,399,132,49,59,52,55,99,217,0,1342,531
2452,2167,1629,538,200,241,212,223,405,886,0,5473,2167
2453,1155,980,175,402,194,144,125,134,156,0,2043,1155
2454,333,282,51,116,56,41,36,39,45,0,589,333
2455,1387,1343,44,441,315,136,130,175,190,6,2575,1393
2456,171,124,47,41,25,21,20,26,38,0,420,171
2457,1062,772,290,253,157,131,123,159,239,6,2603,1068
2458,53,51,2,17,12,5,5,7,7,3,98,56
2459,722,525,197,172,107,89,84,108,162,0,1769,722
2460,201,195,6,64,46,20,19,25,27,0,373,201
2461,124,120,4,39,28,12,12,16,17,4,231,128
2462,200,145,55,26,20,22,22,29,81,415,471,615
2463,997,724,273,130,102,110,112,143,400,0,2345,997
2464,1789,1300,489,233,183,198,201,257,717,1,4209,1790
2465,0,0,0,0,0,0,0,0,0,0,0,0
2466,560,403,157,51,45,64,53,112,235,0,1530,560
2467,1362,745,617,142,144,159,141,247,529,0,4805,1362
2468,962,436,526,124,116,127,96,164,335,0,3296,962
2469,940,758,182,64,97,94,90,182,413,0,2292,940
2470,1326,763,563,91,122,127,146,242,598,0,3997,1326
2471,1470,780,690,120,150,153,171,249,627,9,4411,1479
2472,2384,1408,976,160,256,221,244,467,1036,14,7181,2398
2473,2074,1211,863,142,201,200,215,428,888,25,6349,2099
2474,1538,1195,343,110,148,164,147,309,660,0,3503,1538
2475,2311,1418,893,151,215,225,253,405,1062,59,6799,2370
2476,1572,979,593,119,156,156,159,318,664,32,4467,1604
2477,2548,1556,992,200,240,238,284,458,1128,9,7370,2557
2478,3802,2479,1323,253,385,328,417,734,1685,64,11500,3866
2479,2270,1464,806,150,210,209,243,471,987,85,6378,2355
2480,1065,771,294,88,119,87,114,230,427,0,2730,1065
2481,546,249,297,43,50,44,64,95,250,10,1946,556
2482,958,648,310,98,87,117,98,178,380,338,2657,1296
2483,1529,1054,475,145,143,172,149,301,619,3,4248,1532
2484,1437,935,502,137,156,168,159,240,577,6,4388,1443
2485,6551,5785,766,1386,1891,552,366,793,1563,4,13560,6555
2486,4886,3495,1391,623,519,522,512,857,1853,0,11555,4886
2487,318,262,56,19,31,23,31,66,148,0,828,318
2488,337,262,75,21,34,32,34,64,152,0,859,337
2489,488,227,261,36,45,33,53,95,226,0,1683,488
2490,817,371,446,105,99,108,81,139,285,244,2797,1061
2491,613,285,328,80,72,76,59,110,216,90,2253,703
2492,2800,1653,1147,188,301,260,287,548,1216,0,8435,2800
2493,679,401,278,46,73,63,70,133,294,0,2044,679
2494,527,245,282,39,48,36,57,102,245,0,1817,527
2495,889,505,384,63,91,84,91,159,401,0,2783,889
2496,570,324,246,41,58,54,58,102,257,0,1783,570
2497,315,143,172,31,34,35,28,54,133,0,1205,315
2498,395,179,216,39,43,44,35,68,166,8,1512,403
2499,282,128,154,28,30,31,25,48,120,0,1079,282
2500,800,341,459,83,84,103,81,150,299,0,3070,800
2501,353,205,148,37,31,40,41,59,145,6,1043,359
2502,1010,585,425,107,90,115,117,168,413,0,2985,1010
2503,1012,811,201,90,79,106,102,196,439,0,2461,1012
2504,1239,993,246,110,97,129,125,239,539,10,3012,1249
2505,413,329,84,30,46,45,38,75,179,0,1074,413
2506,422,337,85,31,47,46,39,76,183,0,1097,422
2507,303,138,165,24,28,24,35,52,140,10,1078,313
2508,1561,922,639,105,168,145,160,306,677,0,4701,1561
2509,415,132,283,47,37,59,44,69,159,158,1634,573
2510,306,244,62,22,26,32,30,56,140,0,796,306
2511,3948,2331,1617,266,424,366,405,773,1714,0,11892,3948
2512,329,270,59,24,30,39,30,58,148,0,786,329
2513,293,234,59,21,33,32,27,53,127,6,763,299
2514,444,354,90,33,50,48,41,80,192,0,1155,444
2515,724,598,126,43,71,53,70,150,337,0,1888,724
2516,957,737,220,71,108,96,90,187,405,0,2399,957
2517,236,193,43,21,25,20,27,45,98,0,594,236
2518,667,514,153,47,69,72,65,127,287,0,1618,667
2519,1683,1204,479,215,179,180,176,295,638,3,3981,1686
2520,1885,1151,734,148,178,176,210,339,834,13,5453,1898
2521,1842,1246,596,189,167,225,188,343,730,146,5108,1988
2522,3289,2905,384,696,949,277,184,398,785,2,6806,3291
2523,507,212,295,75,55,66,53,88,170,0,1827,507
2524,302,246,56,27,33,26,35,58,123,0,762,302
2525,3680,2835,845,274,416,369,345,719,1557,0,9221,3680
2526,1055,813,242,79,119,106,99,206,446,6,2644,1061
2527,388,299,89,29,44,39,36,76,164,0,972,388
2528,336,267,69,26,39,31,29,63,148,7,807,343
2529,254,202,52,19,30,23,22,48,112,11,611,265
2530,567,451,116,43,67,52,49,106,250,0,1361,567
2531,526,406,120,37,54,57,52,101,225,15,1278,541
2532,715,483,232,73,65,87,73,133,284,0,1982,715
2533,981,565,416,68,90,94,108,179,442,0,2957,981
2534,5747,4234,1513,703,689,624,561,1077,2093,0,16077,5747
2535,617,421,196,60,63,69,63,113,249,0,1781,617
2536,1073,791,282,131,129,116,105,201,391,0,3001,1073
2537,6354,4682,1672,777,762,689,621,1191,2314,0,17778,6354
2538,327,186,141,23,33,31,33,58,149,0,1022,327
2539,967,549,418,69,99,91,99,173,436,0,3026,967
2540,339,158,181,25,31,23,37,66,157,17,1168,356
2541,656,509,147,40,66,61,65,124,300,0,1671,656
2542,1500,781,719,136,142,148,177,268,629,18,4962,1518
2543,4547,3350,1197,556,545,493,444,852,1657,0,12722,4547
2544,283,193,90,27,29,32,29,52,114,9,816,292
2545,338,231,107,33,34,38,34,62,137,29,975,367
2546,564,176,388,72,48,75,44,112,213,0,2415,564
2547,190,59,131,24,16,25,15,38,72,0,814,190
2548,396,124,272,51,34,53,31,79,148,56,1698,452
2549,449,140,309,57,38,60,35,89,170,0,1923,449
2550,335,218,117,32,36,39,37,56,135,0,1024,335
2551,268,147,121,28,28,31,28,49,104,4,944,272
2552,389,213,176,40,41,45,40,71,152,0,1371,389
2553,301,165,136,31,32,35,31,55,117,28,1063,329
2554,366,152,214,46,45,40,32,75,128,0,1558,366
2555,266,111,155,33,33,29,24,55,92,0,1131,266
2556,441,184,257,55,55,48,39,90,154,0,1876,441
2557,486,339,147,59,53,55,50,90,179,0,1377,486
2558,315,220,95,38,34,35,33,58,117,0,892,315
2559,482,336,146,59,52,54,50,89,178,7,1364,489
2560,396,276,120,48,43,45,41,73,146,21,1121,417
2561,654,194,460,87,77,86,61,129,214,0,2800,654
2562,1372,407,965,183,162,180,127,272,448,15,5870,1387
2563,3270,970,2300,437,387,428,304,647,1067,0,13991,3270
2564,296,124,172,44,32,38,31,51,100,0,1068,296
2565,484,202,282,72,53,63,50,84,162,0,1743,484
2566,824,345,479,122,90,107,85,143,277,10,2971,834
2567,1414,641,773,182,171,187,141,240,493,0,4843,1414
2568,705,320,385,91,85,93,70,120,246,0,2414,705
2569,542,246,296,70,65,72,54,92,189,8,1856,550
2570,418,195,223,55,49,52,40,75,147,0,1537,418
2571,434,202,232,57,51,54,41,78,153,39,1597,473
2572,574,267,307,75,68,71,55,103,202,0,2110,574
2573,3639,2603,1036,464,387,389,381,639,1379,1,8605,3640
2574,2483,1321,1162,257,287,293,241,464,941,239,8193,2722
2575,1356,721,635,140,157,160,131,253,515,30,4473,1386
2576,833,443,390,86,96,98,81,156,316,11,2749,844
2577,1643,874,769,170,190,194,159,307,623,4,5421,1647
2578,807,468,339,86,72,92,94,134,329,14,2384,821
2579,545,316,229,58,49,62,63,91,222,28,1610,573
2580,692,554,138,62,54,72,70,134,300,0,1682,692
2581,140,65,75,12,11,11,16,27,63,41,489,181
2582,206,109,97,17,21,21,24,35,88,0,618,206
2583,249,132,117,20,25,26,29,42,107,9,746,258
2584,864,369,495,90,91,112,87,161,323,0,3315,864
2585,1096,864,232,75,124,111,99,216,471,0,2722,1096
2586,2094,1651,443,143,236,213,188,414,900,1,5198,2095
2587,407,333,74,38,39,39,44,80,167,0,936,407
2588,453,370,83,43,43,43,49,89,186,63,1042,516
2589,275,86,189,35,23,36,22,55,104,0,1179,275
2590,282,88,194,36,24,37,22,56,107,0,1210,282
2591,542,367,175,56,49,66,55,101,215,68,1504,610
2592,1000,465,535,87,78,79,114,191,451,0,3503,1000
2593,355,202,153,25,36,34,36,63,161,0,1112,355
2594,437,139,298,49,39,62,46,73,168,0,1720,437
2595,434,138,296,49,39,61,46,72,167,0,1707,434
2596,557,380,177,54,56,63,56,102,226,0,1607,557
2597,270,215,55,19,23,28,26,49,125,3,702,273
2598,272,217,55,19,23,28,26,50,126,0,709,272
2599,408,335,73,30,37,49,37,72,183,15,976,423
2600,535,238,297,43,55,64,51,96,226,0,1985,535
2601,901,401,500,73,93,107,86,162,380,10,3341,911
2602,273,121,152,22,28,32,26,49,116,0,1011,273
2603,1467,896,571,115,138,137,163,264,650,8,4243,1475
2604,310,223,87,28,25,35,29,62,131,0,847,310
2605,412,297,115,37,33,47,39,83,173,13,1126,425
2606,277,162,115,23,19,30,16,64,125,0,901,277
2607,880,609,271,95,47,100,64,187,387,22,2299,902
2608,1680,1120,560,101,153,183,134,361,748,22,4676,1702
2609,1331,956,375,100,95,129,106,295,606,53,3591,1384
2610,3118,2043,1075,200,347,306,309,637,1319,22,9141,3140
2611,1211,701,510,71,120,105,120,263,532,0,3786,1211
2612,506,337,169,35,43,53,43,120,212,0,1432,506
2613,1955,1541,414,165,171,192,167,449,811,43,4932,1998
2614,1828,1179,649,143,169,198,131,393,794,6,5430,1834
2615,239,156,83,21,18,28,19,51,102,82,633,321
2616,1242,845,397,90,89,143,100,269,551,8,3324,1250
2617,1046,697,349,66,95,102,76,227,480,0,2837,1046
2618,2522,1855,667,193,269,244,208,547,1061,14,6692,2536
2619,2075,1744,331,193,186,239,167,441,849,26,4378,2101
2620,1497,1070,427,116,144,146,106,343,642,311,3937,1808
2621,8523,6074,2449,740,968,991,682,1769,3373,23,22820,8546
2622,518,376,142,35,57,51,52,121,202,0,1462,518
2623,192,139,53,13,21,19,19,45,75,9,541,201
2624,2766,1904,862,227,231,259,286,607,1156,0,8151,2766
2625,2383,1656,727,190,222,210,249,538,974,90,6999,2473
2626,1641,1204,437,149,141,156,179,351,665,7,4430,1648
2627,3260,2289,971,280,298,307,328,686,1361,17,8348,3277
2628,2499,1140,1359,279,215,312,150,558,985,10,9812,2509
2629,682,474,208,36,70,73,59,164,280,19,2017,701
2630,1012,549,463,100,87,107,92,201,425,0,3131,1012
2631,369,235,134,22,36,41,38,79,153,0,1071,369
2632,4493,3040,1453,336,466,421,421,944,1905,14,12535,4507
2633,1372,814,558,71,118,125,123,300,635,14,3983,1386
2634,2898,1833,1065,193,269,276,285,642,1233,11,8924,2909
2635,1668,1150,518,98,146,146,167,387,724,0,4979,1668
2636,464,298,166,36,36,50,41,100,201,0,1281,464
2637,4221,3008,1213,366,480,491,338,876,1670,96,11300,4317
2638,920,537,383,78,62,100,55,213,412,0,2993,920
2639,980,830,150,123,67,87,124,184,395,0,1940,980
2640,483,372,111,34,47,53,49,94,206,183,1055,666
2641,1632,1372,260,152,146,188,131,347,668,100,3443,1732
2642,689,465,224,50,81,63,64,143,288,5,2110,694
2643,747,482,265,58,69,81,53,161,325,0,2218,747
2644,446,351,95,31,46,46,37,105,181,0,1058,446
2645,602,463,139,43,59,66,61,118,255,1,1317,603
2646,734,577,157,50,76,76,61,172,299,0,1742,734
2647,848,524,324,74,66,100,60,184,364,0,2260,848
2648,628,388,240,55,49,74,44,136,270,31,1673,659
2649,625,387,238,55,49,74,44,136,267,0,1667,625
2650,369,237,132,28,29,40,32,79,161,0,1018,369
2651,1427,829,598,129,183,148,135,284,548,0,4721,1427
2652,780,656,124,73,70,90,63,166,318,0,1645,780
2653,2167,1821,346,202,194,250,174,460,887,0,4572,2167
2654,3054,2567,487,285,274,352,245,649,1249,100,6444,3154
2655,2937,1417,1520,233,379,346,290,578,1111,0,10657,2937
2656,14815,7539,7276,2554,6336,837,886,1536,2666,0,53789,14815
2657,6638,3378,3260,1144,2839,375,397,688,1195,0,24099,6638
2658,769,502,267,67,58,91,63,164,326,0,2038,769
2659,1216,841,375,131,65,138,89,259,534,37,3177,1253
2660,900,523,377,81,116,94,85,179,345,0,2977,900
2661,263,169,94,20,20,28,23,56,116,0,725,263
2662,784,465,319,40,68,72,70,171,363,7,2276,791
2663,858,531,327,75,67,101,61,186,368,553,2286,1411
2664,830,565,265,60,60,95,67,180,368,0,2221,830
2665,292,195,97,18,27,28,21,63,135,0,791,292
2666,669,463,206,72,36,76,49,142,294,0,1747,669
2667,6316,4501,1815,548,717,735,505,1311,2500,0,16911,6316
2668,4610,4323,287,605,422,538,427,904,1714,4,8233,4614
2669,2895,2715,180,380,265,338,268,568,1076,146,5169,3041
2670,574,389,185,46,59,54,56,121,238,40,1746,614
2671,471,319,152,38,48,44,46,100,195,7,1432,478
2672,469,341,128,32,51,46,47,109,184,37,1325,506
2673,479,348,131,32,52,47,48,112,188,81,1354,560
2674,434,315,119,29,47,43,44,101,170,24,1226,458
2675,559,399,160,43,54,54,39,128,241,0,1471,559
2676,1323,769,554,120,170,137,125,263,508,0,4378,1323
2677,2634,1271,1363,209,340,311,260,519,995,0,9560,2634
2678,1548,900,648,140,199,161,146,308,594,0,5123,1548
2679,1689,1208,481,126,202,156,179,345,681,24,4992,1713
2680,586,419,167,44,70,54,62,120,236,0,1733,586
2681,655,515,140,45,67,67,54,154,268,57,1554,712
2682,319,173,146,31,28,34,29,63,134,106,986,425
2683,750,490,260,66,57,89,61,160,317,3,1989,753
2684,716,468,248,63,54,85,58,153,303,0,1899,716
2685,480,343,137,36,57,44,51,98,194,14,1417,494
2686,641,446,195,33,66,68,55,154,265,24,1897,665
2687,132,104,28,11,12,13,11,30,55,0,332,132
2688,82,65,17,7,7,8,7,19,34,75,207,157
2689,1291,1017,274,109,113,127,111,297,534,267,3256,1558
2690,369,241,128,32,28,44,30,79,156,0,978,369
2691,279,182,97,24,21,33,23,59,119,6,738,285
2692,3169,2033,1136,243,246,340,279,680,1381,92,8739,3261
2693,614,418,196,45,44,71,50,133,271,8,1644,622
2694,789,526,263,50,72,77,57,171,362,13,2141,802
2695,429,277,152,34,40,47,31,92,185,37,1274,466
2696,602,408,194,48,61,56,59,127,251,13,1830,615
2697,645,437,208,52,66,60,63,136,268,3,1960,648
2698,377,254,123,28,44,34,35,78,158,8,1156,385
2699,569,384,185,42,67,52,53,118,237,31,1744,600
2700,366,247,119,27,43,33,34,76,153,5,1120,371
2701,773,561,212,52,84,76,78,180,303,0,2185,773
2702,1946,1603,343,130,230,225,204,365,792,0,3768,1946
2703,1881,1433,448,153,152,173,130,430,843,409,4836,2290
2704,2381,1481,900,125,211,240,192,532,1081,38,6969,2419
2705,1054,709,345,107,65,118,90,240,434,36,3023,1090
2706,2055,1361,694,112,210,213,263,366,891,63,5979,2118
2707,1813,1281,532,136,177,174,157,347,822,28,4677,1841
2708,1175,791,384,87,109,135,108,247,489,25,3041,1200
2709,943,660,283,71,85,103,85,194,405,7,2381,950
2710,1360,843,517,76,147,120,118,313,586,8,3847,1368
2711,6763,6744,19,706,863,875,693,1256,2370,0,9802,6763
2712,738,499,239,36,67,45,59,159,372,1363,2111,2101
2713,380,262,118,26,37,42,34,74,167,0,930,380
2714,115,79,36,8,11,13,10,23,50,0,282,115
2715,710,431,279,40,68,75,83,133,311,0,2179,710
2716,1699,1135,564,90,142,129,141,392,805,801,5078,2500
2717,2396,1621,775,129,225,240,234,521,1047,0,6523,2396
2718,992,775,217,91,78,85,76,220,442,0,2521,992
2719,429,261,168,26,40,49,32,98,184,0,1258,429
2720,672,468,204,45,55,65,58,132,317,0,1882,672
2721,1129,587,542,54,120,134,99,226,496,8,3522,1137
2722,252,174,78,15,23,24,29,44,117,0,752,252
2723,681,443,238,40,68,62,39,136,336,0,1949,681
2724,1088,882,206,83,125,120,108,208,444,0,2286,1088
2725,1970,1577,393,160,200,199,252,350,809,196,4528,2166
2726,1111,677,434,66,102,126,82,255,480,0,3253,1111
2727,6457,5319,1138,431,765,747,678,1211,2625,31,12505,6488
2728,1910,1561,349,143,208,223,209,338,789,10,3699,1920
2729,6558,5360,1198,491,714,764,717,1162,2710,0,12701,6558
2730,1037,847,190,65,108,108,94,210,452,0,2181,1037
2731,654,534,120,41,68,68,59,132,286,0,1376,654
2732,1379,1127,252,87,144,143,125,279,601,2,2898,1381
2733,3866,3160,706,290,421,450,423,685,1597,43,7487,3909
2734,1736,1408,328,133,200,191,172,332,708,0,3650,1736
2735,2089,1403,686,148,205,253,185,429,869,57,5525,2146
2736,535,378,157,40,52,51,46,102,244,0,1381,535
2737,603,493,110,38,63,63,55,122,262,2,1267,605
2738,800,654,146,60,87,93,88,142,330,0,1549,800
2739,2337,1564,773,141,233,229,290,404,1040,2,7014,2339
2740,262,181,81,16,24,25,30,45,122,0,782,262
2741,422,292,130,26,38,41,48,73,196,0,1258,422
2742,407,273,134,29,40,49,36,84,169,0,1077,407
2743,748,502,246,53,73,91,66,154,311,0,1979,748
2744,987,663,324,70,97,120,87,203,410,236,2610,1223
2745,1833,1282,551,138,165,200,165,378,787,7,4628,1840
2746,406,276,130,24,35,41,38,86,182,97,1155,503
2747,1494,1017,477,89,131,150,141,316,667,28,4248,1522
2748,1469,1192,277,112,169,162,146,281,599,0,3089,1469
2749,251,177,74,19,24,24,22,48,114,14,647,265
2750,780,551,229,59,76,75,67,149,354,0,2014,780
2751,736,495,241,54,68,85,68,155,306,17,1903,753
2752,267,203,64,22,22,25,19,61,118,84,686,351
2753,1042,729,313,79,94,114,94,215,446,0,2632,1042
2754,801,501,300,53,76,86,69,176,341,0,2106,801
2755,1225,844,381,84,120,134,111,240,536,0,2998,1225
2756,720,482,238,43,72,70,89,124,322,20,2160,740
2757,1519,950,569,101,144,164,130,333,647,70,3993,1589
2758,1580,988,592,105,150,170,136,346,673,0,4154,1580
2759,2065,1422,643,141,202,226,186,404,906,0,5051,2065
2760,414,251,163,23,40,44,48,78,181,0,1270,414
2761,825,501,324,46,79,87,96,154,363,0,2532,825
2762,512,354,158,31,46,49,59,89,238,11,1526,523
2763,1547,1077,470,104,126,150,133,304,730,59,4335,1606
2764,315,219,96,21,26,31,27,62,148,0,883,315
2765,2996,2144,852,240,282,348,253,610,1263,0,8208,2996
2766,1744,1006,738,120,169,146,145,379,785,41,5310,1785
2767,2612,1548,1064,189,268,241,237,540,1137,46,7769,2658
2768,335,172,163,21,35,27,26,76,150,0,1096,335
2769,1691,1047,644,117,167,157,159,358,733,24,4896,1715
2770,1229,747,482,52,113,112,107,275,570,0,3532,1229
2771,13392,6661,6731,777,1173,1308,1102,2824,6208,489,45778,13881
2772,3943,2428,1515,255,332,388,363,791,1814,8,11409,3951
2773,5291,3975,1316,456,524,503,481,1161,2166,0,12980,5291
2774,3620,2257,1363,289,376,315,358,736,1546,0,10496,3620
2775,6684,4585,2099,486,614,660,597,1381,2946,53,18400,6737
2776,1691,1190,501,127,156,145,152,354,757,0,4449,1691
2777,1892,1153,739,122,152,190,152,385,891,39,5823,1931
2778,7365,4573,2792,518,698,782,679,1450,3238,6,21996,7371
2779,4088,2220,1868,273,334,363,380,850,1888,7,12557,4095
2780,1284,592,692,72,132,110,127,276,567,0,4317,1284
2781,994,699,295,75,92,85,89,208,445,0,2616,994
2782,268,167,101,21,28,23,26,54,116,0,777,268
2783,512,236,276,29,53,44,50,110,226,0,1721,512
2784,456,210,246,25,47,39,45,98,202,19,1532,475
2785,1208,850,358,91,112,103,109,253,540,0,3177,1208
2786,538,248,290,30,55,46,53,116,238,8,1809,546
2787,315,162,153,20,33,26,25,71,140,1,1030,316
2788,479,246,233,31,50,39,38,109,212,3,1570,482
2789,9327,7007,2320,803,924,887,848,2046,3819,0,22878,9327
2790,1518,946,572,121,158,132,150,308,649,0,4402,1518
2791,3958,2468,1490,315,412,344,391,804,1692,0,11477,3958
2792,1539,980,559,112,169,121,174,342,621,63,4825,1602
2793,1563,953,610,118,148,150,159,316,672,10,4772,1573
2794,1285,636,649,135,129,135,139,239,508,83,4279,1368
2795,1501,690,811,169,139,189,132,290,582,0,4731,1501
2796,424,241,183,33,44,35,45,85,182,0,1373,424
2797,1839,1033,806,165,157,230,186,359,742,129,5717,1968
2798,334,131,203,27,28,44,27,67,141,3,1283,337
2799,423,340,83,43,54,41,50,81,154,21,1050,444
2800,989,388,601,66,111,77,93,211,431,16,3648,1005
2801,1437,655,782,104,178,110,146,317,582,0,5162,1437
2802,7237,3990,3247,693,1163,653,740,1452,2536,0,23833,7237
2803,1521,872,649,140,166,162,164,266,623,0,4903,1521
2804,458,197,261,38,55,53,31,100,181,5,1637,463
2805,3517,1514,2003,291,425,409,239,765,1388,31,10864,3548
2806,669,445,224,62,67,80,83,110,267,10,2018,679
2807,2513,1505,1008,189,275,248,281,476,1044,39,8313,2552
2808,1295,674,621,109,139,134,138,256,519,21,4533,1316
2809,201,105,96,17,22,21,21,40,80,0,704,201
2810,1710,559,1151,161,160,198,152,328,711,7,7199,1717
2811,6998,3215,3783,450,669,681,646,1530,3022,119,26493,7117
2812,2004,817,1187,147,200,155,194,436,872,0,7245,2004
2813,1399,570,829,102,140,108,135,304,610,44,5058,1443
2814,5153,3280,1873,374,565,405,581,1144,2084,209,16160,5362
2815,197,125,72,14,22,15,22,44,80,0,619,197
2816,338,106,232,30,34,36,31,65,142,4,1353,342
2817,547,238,309,40,68,40,58,117,224,16,2041,563
2818,224,117,107,19,24,23,24,44,90,0,786,224
2819,971,381,590,80,80,127,77,195,412,0,3727,971
2820,392,176,216,37,36,34,44,83,158,66,1278,458
2821,127,66,61,11,14,13,14,25,50,0,443,127
2822,598,272,326,43,74,46,61,132,242,0,2148,598
2823,1172,510,662,86,147,86,124,251,478,0,4372,1172
2824,618,277,341,58,57,54,69,131,249,11,2017,629
2825,775,347,428,73,71,67,87,164,313,1,2529,776
2826,525,235,290,50,48,46,59,111,211,4,1713,529
2827,842,330,512,56,95,66,79,179,367,1,3106,843
2828,667,261,406,45,75,52,63,142,290,0,2461,667
2829,702,315,387,66,65,61,79,149,282,20,2289,722
2830,1656,1103,553,153,167,199,206,272,659,0,4994,1656
2831,702,286,416,51,70,54,68,153,306,96,2540,798
2832,844,480,364,65,88,69,90,169,363,13,2734,857
2833,863,484,379,84,101,104,84,161,329,50,2686,913
2834,1555,1058,497,128,167,160,178,285,637,46,4525,1601
2835,1689,735,954,125,211,124,179,362,688,0,6302,1689
2836,402,180,222,38,37,35,45,85,162,0,1313,402
2837,1023,389,634,84,88,99,96,207,449,0,3649,1023
2838,262,100,162,21,23,25,24,53,116,13,935,275
2839,994,405,589,73,99,77,96,216,433,0,3594,994
2840,602,313,289,51,65,62,64,119,241,42,2108,644
2841,267,129,138,25,27,31,23,51,110,0,923,267
2842,689,334,355,64,71,81,60,131,282,38,2384,727
2843,383,149,234,39,35,38,36,72,163,0,1447,383
2844,2001,1122,879,195,234,242,194,374,762,11,6224,2012
2845,747,419,328,73,87,90,73,140,284,124,2324,871
2846,589,330,259,58,69,71,57,110,224,35,1832,624
2847,567,358,209,43,75,50,50,126,223,57,1754,624
2848,497,314,183,38,66,44,43,111,195,15,1536,512
2849,827,522,305,63,110,73,72,185,324,147,2556,974
2850,711,449,262,54,94,62,62,159,280,0,2196,711
2851,3031,1923,1108,247,338,296,317,626,1207,0,9351,3031
2852,237,136,101,22,26,25,26,42,96,0,764,237
2853,498,283,215,39,52,41,53,100,213,0,1614,498
2854,1102,626,476,85,114,90,118,220,475,0,3571,1102
2855,465,191,274,45,48,51,52,89,180,0,1759,465
2856,372,153,219,36,39,41,41,71,144,0,1407,372
2857,1257,563,694,101,123,142,124,235,532,36,4774,1293
2858,770,345,425,62,76,87,76,144,325,0,2922,770
2859,459,206,253,37,45,52,45,86,194,0,1743,459
2860,1047,534,513,95,115,125,104,196,412,0,3411,1047
2861,535,356,179,49,54,64,66,88,214,1,1614,536
2862,2132,1420,712,197,215,256,265,350,849,0,6429,2132
2863,400,126,274,35,40,43,36,77,169,6,1604,406
2864,942,333,609,70,99,92,110,204,367,0,3776,942
2865,696,362,334,59,75,72,74,137,279,0,2436,696
2866,386,151,235,32,32,50,31,77,164,0,1480,386
2867,1060,594,466,104,124,128,103,198,403,0,3298,1060
2868,997,434,563,74,125,73,105,214,406,5,3721,1002
2869,255,99,156,26,24,26,24,48,107,14,965,269
2870,1044,407,637,106,96,105,97,197,443,0,3949,1044
2871,523,253,270,48,54,61,46,99,215,0,1811,523
2872,2136,1034,1102,197,219,251,187,405,877,87,7390,2223
2873,442,279,163,34,59,39,39,99,172,0,1366,442
2874,959,608,351,78,107,94,100,198,382,3,2957,962
2875,802,546,256,66,86,83,92,147,328,0,2335,802
2876,1049,432,617,101,109,115,117,200,407,0,3966,1049
2877,680,354,326,57,73,70,72,134,274,0,2379,680
2878,446,140,306,40,45,47,41,86,187,0,1790,446
2879,9,4,5,1,1,1,1,2,3,41,34,50
2880,888,405,483,64,110,68,90,196,360,0,3190,888
2881,1717,782,935,124,213,132,174,379,695,4,6168,1721
2882,989,451,538,71,123,76,100,218,401,110,3553,1099
2883,1020,465,555,74,126,78,103,225,414,2,3664,1022
2884,1820,1003,817,174,292,164,186,365,639,12,5993,1832
2885,1016,560,456,97,163,92,104,204,356,0,3345,1016
2886,1421,783,638,136,228,128,145,285,499,0,4680,1421
2887,1207,665,542,116,194,109,123,242,423,0,3976,1207
2888,1350,744,606,129,217,122,138,271,473,3,4447,1353
2889,1738,958,780,166,279,157,178,349,609,5,5724,1743
2890,3256,1795,1461,312,523,294,333,653,1141,19,10723,3275
2891,4441,2448,1993,425,714,401,454,891,1556,0,14626,4441
2892,1914,1055,859,183,308,173,196,384,670,3,6305,1917
2893,7765,4281,3484,743,1248,700,794,1558,2722,22,25574,7787
2894,9909,5463,4446,948,1592,894,1014,1989,3472,48,32634,9957
2895,1718,947,771,164,276,155,176,345,602,9,5659,1727
2896,2227,873,1354,149,250,173,209,475,971,12,8216,2239
2897,54,34,20,4,6,4,6,12,22,0,169,54
2898,1451,1168,283,148,184,139,173,278,529,0,3604,1451
2899,3520,1839,1681,262,318,288,366,714,1572,53,11903,3573
2900,1177,743,434,110,96,113,125,246,487,99,3586,1276
2901,1239,779,460,123,110,135,131,234,506,13,3523,1252
2902,1145,731,414,97,91,89,114,219,535,35,3395,1180
2903,1515,730,785,128,132,155,138,301,661,29,5273,1544
2904,3099,1809,1290,240,279,273,313,608,1386,27,9275,3126
2905,1094,712,382,120,91,91,120,216,456,643,2674,1737
2906,4141,2580,1561,474,334,355,530,748,1700,0,13282,4141
2907,822,570,252,74,78,93,82,147,348,0,2261,822
2908,2383,1566,817,191,221,225,236,513,997,73,7200,2456
2909,1500,887,613,134,108,139,136,311,672,78,4521,1578
2910,832,516,316,72,63,77,73,175,372,45,2539,877
2911,261,148,113,25,23,29,24,53,107,21,820,282
2912,1119,567,552,117,101,114,134,224,429,0,3378,1119
2913,313,142,171,24,31,27,29,71,131,22,1248,335
2914,2160,997,1163,183,187,232,190,443,925,24,8039,2184
2915,1286,779,507,104,110,102,118,247,605,0,3546,1286
2916,1504,969,535,147,112,152,155,296,642,0,4161,1504
2917,286,182,104,26,32,29,27,58,114,243,845,529
2918,2673,2170,503,233,224,259,267,542,1148,7,5871,2680
2919,4462,2807,1655,507,390,418,457,903,1787,20,11913,4482
2920,2073,1298,775,176,173,200,213,415,896,29,6075,2102
2921,1686,718,968,139,124,139,169,363,752,0,5774,1686
2922,2150,1375,775,171,197,201,220,437,924,0,5822,2150
2923,1666,1049,617,141,144,167,159,321,734,8,4583,1674
2924,775,400,375,85,65,83,77,146,319,17,2547,792
2925,837,511,326,104,65,80,93,161,334,0,2189,837
2926,336,152,184,26,33,29,31,76,141,14,1341,350
2927,458,235,223,43,40,44,37,94,200,0,1784,458
2928,825,469,356,80,71,90,74,166,344,3,2599,828
2929,955,659,296,121,84,108,103,175,364,9,2110,964
2930,1614,1113,501,205,141,182,175,295,616,302,3566,1916
2931,296,195,101,37,28,33,33,53,112,0,734,296
2932,401,285,116,38,33,43,45,69,173,0,1076,401
2933,325,214,111,41,31,37,36,59,121,0,806,325
2934,317,209,108,40,30,36,35,57,119,0,787,317
2935,337,174,163,37,28,36,34,63,139,0,1106,337
2936,299,173,126,36,26,30,29,55,123,7,909,306
2937,294,170,124,35,26,29,28,54,122,14,895,308
2938,470,271,199,56,41,46,46,87,194,0,1430,470
2939,436,310,126,41,36,47,49,75,188,0,1170,436
2940,304,216,88,29,25,32,34,53,131,0,816,304
2941,613,425,188,55,58,69,61,110,260,0,1685,613
2942,350,203,147,42,33,39,36,65,135,0,1023,350
2943,463,269,194,55,44,51,47,86,180,4,1355,467
2944,772,470,302,83,86,85,90,136,292,0,1969,772
2945,287,175,112,31,32,31,33,50,110,10,733,297
2946,572,349,223,71,44,55,64,110,228,64,1497,636
2947,353,181,172,33,31,34,28,72,155,34,1376,387
2948,398,204,194,37,35,38,32,82,174,34,1550,432
2949,870,553,317,79,96,88,81,177,349,202,2567,1072
2950,682,434,248,62,75,69,63,139,274,78,2013,760
2951,296,131,165,25,28,31,23,61,128,12,1173,308
2952,523,231,292,43,50,54,41,107,228,0,2073,523
2953,242,107,135,20,23,25,19,49,106,12,961,254
2954,567,250,317,47,54,59,45,116,246,28,2248,595
2955,556,323,233,67,53,62,56,103,215,0,1627,556
2956,5748,4598,1150,606,561,573,602,1156,2250,55,12698,5803
2957,323,146,177,25,32,28,30,73,135,26,1287,349
2958,262,134,128,25,23,25,21,54,114,7,1021,269
2959,879,610,269,79,83,99,88,158,372,15,2417,894
2960,32,18,14,3,3,3,3,7,13,0,104,32
2961,225,96,129,18,22,20,22,52,91,0,780,225
2962,1755,764,991,111,178,188,164,351,763,3,6241,1758
2963,777,323,454,111,98,75,111,155,227,1272,2952,2049
2964,4791,2083,2708,419,481,443,398,1109,1941,0,15749,4791
2965,1204,657,547,83,136,121,99,269,496,0,3672,1204
2966,0,0,0,0,0,0,0,0,0,0,0,0
2967,1261,798,463,107,171,135,112,255,481,0,3413,1261
2968,1262,716,546,113,127,139,99,280,504,0,3523,1262
2969,2052,1461,591,132,252,174,169,528,797,0,5744,2052
2970,6856,5145,1711,591,1037,732,524,1568,2404,163,16270,7019
2971,1207,777,430,96,114,102,116,246,533,0,3441,1207
2972,3624,2591,1033,300,350,334,402,703,1535,164,9863,3788
2973,473,224,249,38,52,48,57,91,187,0,1667,473
2974,2280,1200,1080,165,231,233,277,473,901,254,7464,2534
2975,884,549,335,53,75,75,94,188,399,0,2771,884
2976,498,205,293,28,50,40,49,110,221,0,1741,498
2977,1622,1032,590,106,166,156,196,324,674,7,5042,1629
2978,4273,2758,1515,276,398,369,477,872,1881,43,12266,4316
2979,4576,2346,2230,314,462,442,476,973,1909,181,15932,4757
2980,2809,1492,1317,229,287,264,316,591,1122,116,9044,2925
2981,1843,1041,802,155,179,169,223,374,743,46,6152,1889
2982,1247,602,645,103,113,116,150,269,496,8,4283,1255
2983,2249,1209,1040,171,208,223,238,448,961,27,7327,2276
2984,1653,775,878,128,160,140,161,357,707,11,5510,1664
2985,1152,468,684,80,111,109,116,257,479,0,4042,1152
2986,1807,1092,715,126,161,188,206,376,750,0,5531,1807
2987,2931,2263,668,223,324,252,282,719,1131,0,7080,2931
2988,1473,1056,417,79,210,121,122,358,583,11,4412,1484
2989,3113,2324,789,276,588,220,228,693,1108,29,8801,3142
2990,1144,577,567,72,117,114,99,279,463,0,3713,1144
2991,1929,946,983,152,221,185,127,466,778,15,6080,1944
2992,500,382,118,32,62,44,48,109,205,4,1351,504
2993,2264,1368,896,169,303,230,196,502,864,0,6527,2264
2994,1470,1153,317,139,138,139,164,293,597,6,4277,1476
2995,4298,1867,2431,311,416,424,350,962,1835,6,14394,4304
2996,1508,1001,507,115,174,129,143,343,604,0,4353,1508
2997,763,480,283,48,142,54,61,171,287,21,2440,784
2998,1039,491,548,83,113,106,124,200,413,147,3661,1186
2999,658,280,378,53,65,57,64,154,265,0,2282,658
3000,640,332,308,38,82,55,52,157,256,0,2183,640
3001,1280,663,617,75,165,110,104,313,513,1,4371,1281
3002,518,268,250,30,67,44,42,127,208,0,1769,518
3003,971,563,408,48,135,81,83,223,401,0,3230,971
3004,862,447,415,51,111,74,70,211,345,0,2944,862
3005,0,0,0,0,0,0,0,0,0,0,0,0
3006,7500,3845,3655,515,758,725,781,1595,3126,0,26113,7500
3007,698,362,336,41,90,60,57,171,279,0,2382,698
3008,936,543,393,46,130,78,80,215,387,0,3114,936
3009,1012,587,425,50,141,84,86,232,419,0,3366,1012
3010,599,310,289,35,77,51,49,147,240,0,2044,599
3011,633,367,266,31,88,53,54,145,262,0,2105,633
3012,626,345,281,52,66,57,64,129,258,16,2005,642
3013,76,42,34,6,8,7,8,16,31,0,244,76
3014,922,508,414,76,97,84,94,190,381,0,2952,922
3015,1006,473,533,99,94,104,110,205,394,6,3373,1012
3016,300,128,172,24,29,26,29,70,122,0,1042,300
3017,1829,1008,821,151,192,168,186,377,755,0,5860,1829
3018,566,242,324,49,49,59,66,117,226,9,2068,575
3019,150,94,56,10,28,11,12,34,55,0,479,150
3020,458,215,243,45,43,47,50,93,180,2,1536,460
3021,789,550,239,83,84,67,84,161,310,0,2284,789
3022,716,441,275,74,71,73,83,146,269,111,2195,827
3023,247,152,95,26,25,25,28,51,92,53,757,300
3024,420,293,127,44,45,35,45,86,165,0,1218,420
3025,664,283,381,57,58,69,77,138,265,11,2428,675
3026,483,227,256,47,45,50,53,98,190,0,1618,483
3027,1544,959,585,92,132,131,164,328,697,4,4845,1548
3028,1520,944,576,91,130,129,161,323,686,0,4768,1520
3029,2084,857,1227,118,210,168,204,461,923,0,7292,2084
3030,602,248,354,34,61,48,59,133,267,1,2108,603
3031,214,164,50,14,27,19,21,47,86,14,577,228
3032,299,229,70,19,37,26,29,65,123,0,809,299
3033,1040,795,245,66,130,91,100,228,425,10,2810,1050
3034,713,451,262,60,96,76,64,144,273,0,1932,713
3035,502,318,184,42,68,54,45,102,191,0,1360,502
3036,431,273,158,36,58,46,38,87,166,0,1166,431
3037,1104,699,405,93,149,118,98,223,423,0,2990,1104
3038,751,580,171,57,83,65,72,184,290,0,1815,751
3039,817,631,186,62,90,70,79,200,316,0,1973,817
3040,565,436,129,43,62,49,54,139,218,0,1366,565
3041,14,9,5,1,3,1,1,3,5,0,44,14
3042,0,0,0,0,0,0,0,0,0,0,0,0
3043,0,0,0,0,0,0,0,0,0,0,0,0
3044,0,0,0,0,0,0,0,0,0,0,0,0
3045,4,3,1,0,1,0,0,1,2,0,14,4
3046,2596,1431,1165,215,273,238,265,535,1070,25,8317,2621
3047,337,203,134,27,41,28,35,76,130,0,1097,337
3048,3764,2393,1371,302,378,310,373,864,1537,78,11154,3842
3049,2403,1074,1329,173,240,229,234,572,955,28,8376,2431
3050,2224,1456,768,167,218,159,233,506,941,83,5982,2307
3051,2760,1761,999,222,291,240,278,615,1114,11,8367,2771
3052,2418,1545,873,194,223,192,236,579,994,50,6770,2468
3053,1086,729,357,73,111,84,115,240,463,1,3094,1087
3054,2407,1690,717,205,255,239,222,499,987,140,6440,2547
3055,40,39,1,0,3,0,4,5,28,0,61,40
3056,1498,614,884,88,187,92,139,346,646,71,5700,1569
3057,3880,2389,1491,286,400,300,336,902,1656,0,13751,3880
3058,352,200,152,27,37,38,34,80,136,0,995,352
3059,1380,719,661,95,155,128,130,312,560,0,4377,1380
3060,833,416,417,62,98,80,72,179,342,1,2659,834
3061,487,349,138,38,40,41,47,113,208,8,1218,495
3062,631,452,179,49,52,53,61,146,270,0,1578,631
3063,518,372,146,43,43,48,51,122,211,0,1217,518
3064,312,224,88,26,26,29,31,74,126,176,733,488
3065,467,265,202,35,50,51,45,106,180,0,1322,467
3066,507,288,219,38,54,55,49,115,196,115,1434,622
3067,1140,683,457,88,120,110,112,253,457,57,3303,1197
3068,786,463,323,50,79,94,76,160,327,17,2139,803
3069,856,615,241,71,72,79,85,202,347,164,2013,1020
3070,499,301,198,40,60,41,51,112,195,0,1627,499
3071,1041,628,413,83,125,87,107,235,404,0,3393,1041
3072,1061,636,425,82,112,102,104,236,425,0,3074,1061
3073,351,207,144,23,35,42,34,72,145,0,956,351
3074,999,521,478,69,112,93,94,226,405,0,3168,999
3075,1824,950,874,125,205,169,172,412,741,62,5783,1886
3076,547,392,155,43,45,46,53,127,233,0,1369,547
3077,467,280,187,36,49,45,46,104,187,0,1354,467
3078,438,263,175,34,46,42,43,97,176,382,1267,820
3079,440,264,176,34,46,42,43,98,177,0,1274,440
3080,443,182,261,26,55,27,41,102,192,0,1685,443
3081,549,225,324,32,69,34,51,127,236,0,2088,549
3082,679,418,261,50,70,52,59,158,290,8,2406,687
3083,1258,775,483,93,130,97,109,292,537,0,4459,1258
3084,1189,1022,167,119,110,153,151,217,439,1383,2380,2572
3085,3095,2107,988,256,310,303,318,724,1184,137,7963,3232
3086,846,559,287,73,105,98,97,181,292,14,2265,860
3087,2256,1605,651,211,245,204,242,548,806,76,6158,2332
3088,2260,1771,489,184,235,200,197,487,957,15,5844,2275
3089,2694,2042,652,201,261,213,302,602,1115,63,6868,2757
3090,995,754,241,75,82,103,108,228,399,20,2536,1015
3091,1841,1310,531,167,216,153,225,407,673,1493,4736,3334
3092,709,539,170,68,74,56,78,151,282,88,1688,797
3093,4,2,2,0,0,0,0,1,3,0,16,4
3094,460,189,271,27,57,28,43,106,199,0,1750,460
3095,1,0,1,0,0,0,0,0,1,0,3,1
3096,1,0,1,0,0,0,0,0,1,0,3,1
3097,0,0,0,0,0,0,0,0,0,0,0,0
3098,0,0,0,0,0,0,0,0,0,0,0,0
3099,1,0,1,0,0,0,0,0,1,0,3,1
3100,0,0,0,0,0,0,0,0,0,0,0,0
3101,300,227,73,22,29,24,34,67,124,27,764,327
3102,310,235,75,23,30,24,35,69,129,0,791,310
3103,189,143,46,14,18,15,21,42,79,14,481,203
3104,1117,809,308,91,111,104,95,235,481,6,2856,1123
3105,2248,1949,299,207,192,232,308,346,963,17,4736,2265
3106,2065,1227,838,212,165,191,236,400,861,39,6137,2104
3107,2296,1609,687,220,196,136,358,433,953,986,5426,3282
3108,3114,1851,1263,213,357,343,192,567,1442,0,9238,3114
3109,1503,954,549,92,156,141,104,245,765,0,4605,1503
3110,2826,1893,933,198,245,313,175,520,1375,170,8460,2996
3111,9996,6483,3513,842,1073,1181,703,1911,4286,66,29495,10062
3112,572,313,259,42,72,53,45,113,247,0,1602,572
3113,542,383,159,42,70,57,38,102,233,0,1363,542
3114,689,386,303,71,69,68,51,124,306,8,2079,697
3115,1689,1250,439,145,203,159,112,298,772,0,4257,1689
3116,686,520,166,67,59,105,88,85,282,3223,1955,3909
3117,1853,951,902,201,169,197,162,352,772,0,5461,1853
3118,4748,3536,1212,409,518,475,357,907,2082,355,11196,5103
3119,1608,1122,486,107,135,187,111,313,755,0,4501,1608
3120,785,626,159,43,82,89,48,152,371,0,2037,785
3121,368,255,113,30,38,43,27,73,157,0,955,368
3122,795,551,244,65,82,92,59,157,340,0,2062,795
3123,1497,1059,438,120,126,151,104,276,720,42,4033,1539
3124,1821,1085,736,143,169,165,185,345,814,593,5141,2414
3125,968,684,284,74,124,102,68,181,419,3,2433,971
3126,2697,1891,806,287,239,319,205,515,1132,0,6937,2697
3127,499,309,190,34,50,51,32,101,231,0,1492,499
3128,4844,3917,927,440,464,521,353,962,2104,17,12143,4861
3129,2157,1215,942,147,230,192,132,433,1023,0,6094,2157
3130,4214,3328,886,383,390,360,502,871,1708,0,9679,4214
3131,2976,2403,573,259,272,250,354,625,1216,59,6795,3035
3132,3428,1750,1678,366,354,355,336,658,1359,21,10765,3449
3133,1321,814,507,71,146,112,85,225,682,15,4400,1336
3134,1515,1123,392,149,134,179,119,326,608,205,4114,1720
3135,3902,3756,146,342,386,389,545,751,1489,0,7091,3902
3136,2115,1575,540,179,221,228,219,429,839,256,5388,2371
3137,7467,5590,1877,650,776,754,698,1658,2931,118,19402,7585
3138,1466,1052,414,104,148,163,146,316,589,60,3808,1526
3139,3195,2202,993,319,271,249,389,680,1287,46,8893,3241
3140,4305,3086,1219,404,569,450,358,780,1744,97,11255,4402
3141,1852,1205,647,164,191,171,213,383,730,0,5166,1852
3142,1781,1361,420,172,207,210,176,343,673,419,4147,2200
3143,2046,1448,598,190,204,231,215,435,771,60,4865,2106
3144,1685,1021,664,127,166,168,177,363,684,38,4527,1723
3145,2517,1439,1078,190,271,245,250,519,1042,43,7614,2560
3146,2390,1694,696,253,257,274,254,493,859,20,6314,2410
3147,1802,807,995,168,209,184,166,384,691,27,6529,1829
3148,841,433,408,79,89,95,86,173,319,8,2993,849
3149,2352,1061,1291,209,239,259,228,499,918,33,8874,2385
3150,930,420,510,83,95,102,90,197,363,13,3510,943
3151,2707,1837,870,226,304,255,308,507,1107,0,6791,2707
3152,3641,2365,1276,281,355,369,354,752,1530,21,10534,3662
3153,2168,1380,788,211,194,225,212,435,891,11,6306,2179
3154,2079,1448,631,213,236,229,208,418,775,20,6094,2099
3155,2299,1399,900,221,229,263,217,489,880,18,6995,2317
3156,2373,1552,821,163,267,232,250,513,948,67,7050,2440
3157,2925,2043,882,252,296,310,275,603,1189,43,8192,2968
3158,1677,514,1163,163,192,165,142,375,640,279,7302,1956
3159,6758,3225,3533,595,644,719,660,1439,2701,60,25628,6818
3160,1076,631,445,88,114,120,103,231,420,45,3570,1121
3161,1888,1363,525,148,218,178,187,389,768,206,4654,2094
3162,1709,1170,539,136,148,167,166,345,747,17,4294,1726
3163,1804,1254,550,159,157,164,187,361,776,22,4688,1826
3164,1550,1095,455,138,114,152,185,312,649,0,3918,1550
3165,2228,1550,678,199,200,217,240,467,905,151,5663,2379
3166,2957,1428,1529,259,306,286,278,630,1198,70,10631,3027
3167,5705,3436,2269,601,667,638,575,1088,2136,39,17287,5744
3168,3043,2258,785,273,304,298,288,639,1241,20,7387,3063
3169,3134,2411,723,271,304,316,294,656,1293,385,7786,3519
3170,1314,908,406,110,140,125,115,282,542,28,3569,1342
3171,2607,2088,519,318,261,315,233,538,942,342,5228,2949
3172,7127,5632,1495,757,775,856,656,1440,2643,0,17183,7127
3173,3456,2586,870,314,357,371,298,748,1368,98,8710,3554
3174,2466,2085,381,223,277,288,235,510,933,0,5125,2466
3175,1829,1522,307,162,198,195,151,381,742,240,4359,2069
3176,2438,1902,536,240,248,237,332,492,889,104,5056,2542
3177,2334,1763,571,244,224,255,273,489,849,60,5012,2394
3178,1629,1150,479,166,150,172,172,333,636,46,3932,1675
3179,1927,1118,809,204,168,175,215,405,760,19,5870,1946
3180,1870,1265,605,159,189,156,218,417,731,0,4824,1870
3181,1246,891,355,105,140,133,156,251,461,115,3133,1361
3182,1570,1025,545,117,132,109,219,337,656,144,4389,1714
3183,4755,2939,1816,488,450,439,562,1042,1774,157,13618,4912
3184,3382,2754,628,613,731,413,533,467,625,156,7424,3538
3185,2262,1757,505,182,228,222,284,458,888,0,5109,2262
3186,2105,1568,537,176,185,229,236,417,862,3,5173,2108
3187,366,155,211,37,29,39,39,76,146,68,1284,434
3188,852,453,399,77,77,83,89,180,346,25,2612,877
3189,2034,1452,582,182,212,187,236,416,801,230,5380,2264
3190,4975,2516,2459,489,423,390,746,973,1954,76,14949,5051
3191,222,142,80,21,16,18,27,50,90,0,604,222
3192,111,72,39,10,11,10,13,23,44,0,310,111
3193,1209,749,460,84,122,124,77,244,558,0,3615,1209
3194,256,183,73,23,27,24,30,52,100,0,677,256
3195,821,347,474,82,65,87,88,172,327,0,2883,821
3196,400,169,231,40,32,42,43,84,159,8,1405,408
3197,1206,641,565,109,109,118,126,255,489,0,3696,1206
3198,2480,1439,1041,263,216,225,277,521,978,0,7554,2480
3199,2350,993,1357,236,187,249,253,491,934,8,8252,2358
3200,2491,1446,1045,264,217,226,278,523,983,0,7589,2491
3201,749,435,314,79,65,68,84,157,296,6,2283,755
3202,1460,847,613,155,127,133,163,307,575,0,4446,1460
3203,449,261,188,48,39,41,50,94,177,6,1367,455
3204,340,181,159,31,31,33,35,72,138,0,1042,340
3205,511,272,239,46,46,50,53,108,208,0,1567,511
3206,306,163,143,28,28,30,32,65,123,0,938,306
3207,380,202,178,34,34,37,40,80,155,0,1164,380
3208,351,225,126,33,25,28,42,79,144,31,958,382
3209,718,460,258,68,51,58,87,161,293,0,1957,718
3210,716,458,258,68,51,57,86,160,294,0,1952,716
3211,242,157,85,21,25,22,28,50,96,0,674,242
3212,525,342,183,46,54,49,60,109,207,0,1466,525
3213,726,472,254,64,75,67,83,150,287,0,2027,726
3214,977,692,285,103,105,112,104,201,352,114,2582,1091
3215,1829,1296,533,193,197,210,195,377,657,0,4832,1829
3216,2778,1935,843,285,316,306,278,559,1034,0,8142,2778
3217,570,397,173,58,65,63,57,115,212,0,1672,570
3218,800,412,388,75,84,90,82,164,305,41,2847,841
3219,611,315,296,58,64,69,62,125,233,2,2175,613
3220,498,257,241,47,52,56,51,102,190,0,1771,498
3221,1068,550,518,101,112,120,109,219,407,301,3800,1369
3222,1194,957,237,145,120,144,107,246,432,22,2396,1216
3223,977,595,382,94,97,112,92,208,374,7,2971,984
3224,1801,1096,705,173,179,206,170,383,690,10,5481,1811
3225,3663,2895,768,389,399,440,337,740,1358,0,8832,3663
3226,669,302,367,59,68,74,65,142,261,21,2526,690
3227,456,206,250,41,46,50,44,97,178,65,1720,521
3228,804,450,354,83,81,79,60,145,356,0,2428,804
3229,449,278,171,31,45,46,29,91,207,0,1343,449
3230,401,304,97,39,35,61,52,50,164,0,1144,401
3231,353,267,86,35,30,54,45,44,145,0,1007,353
3232,192,145,47,19,17,29,25,24,78,8,548,200
3233,147,80,67,11,18,13,11,29,65,0,413,147
3234,753,412,341,55,94,69,59,149,327,13,2110,766
3235,535,293,242,39,67,49,42,106,232,0,1500,535
3236,836,457,379,61,105,77,65,165,363,0,2343,836
3237,681,350,331,74,62,72,60,129,284,0,2008,681
3238,936,481,455,102,85,99,82,178,390,0,2759,936
3239,1524,782,742,165,139,162,133,290,635,0,4491,1524
3240,1181,811,370,106,124,121,81,219,530,11,3125,1192
3241,640,439,201,57,67,65,44,119,288,0,1695,640
3242,746,512,234,67,78,76,51,139,335,2,1974,748
3243,338,252,86,29,37,34,25,65,148,0,798,338
3244,328,244,84,28,36,33,25,63,143,1,774,329
3245,229,159,70,19,24,26,17,45,98,0,593,229
3246,467,372,95,26,49,53,29,90,220,0,1211,467
3247,409,326,83,22,43,47,25,79,193,0,1061,409
3248,365,291,74,20,38,42,23,71,171,0,946,365
3249,397,277,120,26,33,46,27,77,188,6,1112,403
3250,536,300,236,56,54,53,40,97,236,236,1620,772
3251,4171,2444,1727,340,441,465,400,897,1628,287,13833,4458
3252,150,80,70,14,14,15,16,32,59,0,461,150
3253,1817,1384,433,131,164,187,200,287,848,273,3887,2090
3254,2904,1594,1310,219,224,360,447,308,1346,122,8122,3026
3255,3012,2217,795,271,221,373,226,548,1373,493,7886,3505
3256,677,489,188,52,45,81,91,98,310,6,1677,683
3257,1168,745,423,93,109,100,143,173,550,0,3115,1168
3258,2755,1395,1360,186,205,329,474,300,1261,38,7861,2793
3259,3509,2071,1438,264,296,484,564,303,1598,42,9695,3551
3260,2153,1346,807,179,197,238,342,263,934,18,5772,2171
3261,1609,1129,480,119,132,198,247,174,739,10,4182,1619
3262,2519,1731,788,312,243,363,328,274,999,0,6902,2519
3263,985,706,279,59,86,91,124,145,480,0,2595,985
3264,1086,591,495,98,93,132,190,104,469,0,3079,1086
3265,2363,1414,949,167,156,299,330,322,1089,116,6545,2479
3266,1230,1024,206,93,99,169,114,195,560,481,2496,1711
3267,2028,1444,584,173,191,263,244,241,916,234,5315,2262
3268,2751,1991,760,272,224,267,265,454,1269,53,7276,2804
3269,427,347,80,40,38,50,35,69,195,83,1013,510
3270,1468,1105,363,95,130,147,116,306,674,22,3538,1490
3271,2804,2040,764,216,205,185,302,552,1344,116,7864,2920
3272,187,146,41,12,10,13,31,31,90,0,481,187
3273,1249,934,315,126,133,167,188,190,445,8,2675,1257
3274,1788,1228,560,169,171,249,279,234,686,38,4353,1826
3275,1687,1144,543,113,173,141,175,289,796,24,4081,1711
3276,2598,1981,617,196,266,206,382,343,1205,10,6245,2608
3277,1381,993,388,123,142,130,104,295,587,0,3488,1381
3278,2350,1774,576,202,204,222,171,540,1011,35,5573,2385
3279,854,507,347,61,61,45,106,192,389,73,2724,927
3280,2420,2044,376,194,242,221,199,510,1054,0,5720,2420
3281,689,575,114,62,62,60,76,129,300,362,1628,1051
3282,2192,1755,437,163,174,117,284,403,1051,0,5684,2192
3283,1831,1484,347,154,197,174,142,367,797,86,4081,1917
3284,1065,847,218,89,125,108,82,209,452,10,2700,1075
3285,7965,2702,5263,910,1229,742,905,1412,2767,89,34603,8054
3286,2110,1815,295,197,173,167,228,422,923,171,4748,2281
3287,2783,2187,596,204,248,224,207,623,1277,0,7084,2783
3288,2593,2117,476,201,220,233,192,543,1204,343,5886,2936
3289,1274,772,502,150,92,126,126,226,554,0,3225,1274
3290,309,264,45,21,34,18,32,53,151,161,730,470
3291,1995,1509,486,148,142,142,232,382,949,20,5287,2015
3292,2610,2140,470,215,222,215,210,546,1202,13,6003,2623
3293,2393,1724,669,179,206,206,179,507,1116,0,5992,2393
3294,1128,920,208,81,87,66,124,236,534,0,2721,1128
3295,2303,1774,529,189,191,172,215,444,1092,0,5995,2303
3296,0,0,0,0,0,0,0,0,0,0,0,0
3297,3339,2820,519,294,253,241,356,712,1483,53,8203,3392
3298,2613,2035,578,197,204,200,267,549,1196,0,6973,2613
3299,2113,1681,432,179,172,212,147,444,959,0,4649,2113
3300,2235,1729,506,143,193,194,176,475,1054,8,5554,2243
3301,3425,2511,914,291,307,346,224,735,1522,20,8731,3445
3302,2037,1528,509,143,216,208,156,427,887,0,5237,2037
3303,5781,5392,389,438,636,548,479,1058,2622,18,10695,5799
3304,332,212,120,27,31,28,41,49,156,0,885,332
3305,589,323,266,44,45,73,91,63,273,0,1649,589
3306,385,211,174,29,30,48,59,41,178,0,1078,385
3307,956,525,431,72,74,118,147,102,443,15,2673,971
3308,774,422,352,70,66,94,136,74,334,1,2194,775
3309,3851,2646,1205,477,372,555,501,419,1527,137,10555,3988
3310,881,618,263,65,73,109,135,96,403,0,2288,881
3311,1664,1386,278,125,134,228,154,264,759,0,3376,1664
3312,3685,2999,686,348,329,434,305,597,1672,0,8749,3685
3313,638,519,119,60,57,75,53,103,290,139,1515,777
3314,840,684,156,79,75,99,70,136,381,25,1993,865
3315,117,95,22,11,10,14,10,19,53,0,279,117
3316,136,111,25,13,12,16,11,22,62,122,323,258
3317,404,288,116,35,38,52,49,48,182,27,1059,431
3318,692,585,107,55,69,63,57,146,302,0,1636,692
3319,881,744,137,71,88,80,73,186,383,28,2083,909
3320,2691,2244,447,242,244,233,297,504,1171,675,6364,3366
3321,1491,506,985,170,230,139,169,264,519,55,6476,1546
3322,2653,2111,542,222,312,269,203,521,1126,3,6725,2656
3323,657,565,92,61,54,52,71,131,288,0,1478,657
3324,534,459,75,50,44,42,58,107,233,0,1201,534
3325,179,147,32,15,15,15,14,37,83,0,411,179
3326,266,218,48,22,23,22,21,56,122,0,613,266
3327,351,276,75,26,31,28,26,79,161,0,894,351
3328,2344,1688,656,175,202,202,175,497,1093,0,5869,2344
3329,114,82,32,9,10,10,9,24,52,0,287,114
3330,1823,1478,345,153,196,173,141,365,795,464,4063,2287
3331,396,321,75,33,43,38,31,79,172,5,883,401
3332,611,486,125,51,72,62,47,120,259,0,1547,611
