TAZ,HHLESSGQ,HHCHILDNO,HHCHILDYES,HHINC1,HHINC2,HHINC3,HHINC4,HHINC5,HHINC6,HHGQYES,HHGQNO,HHBASE
1,698,679,19,172,124,57,58,85,202,4,957,702
2,818,359,459,447,335,13,14,7,2,30,2308,848
3,2637,2482,155,1008,599,211,197,187,435,18,4919,2655
4,2352,2192,160,529,331,285,283,253,671,0,4568,2352
5,3495,3433,62,839,507,356,336,363,1094,6,5599,3501
6,1231,1191,40,294,190,156,152,119,320,18,2494,1249
7,469,424,45,171,96,50,44,32,76,0,1048,469
8,741,728,13,188,107,85,83,78,200,0,1164,741
9,8843,6870,1973,409,243,333,731,1481,5646,898,27467,9741
10,4256,4183,73,593,232,398,246,518,2269,151,8744,4407
11,858,775,83,313,175,92,81,58,139,0,1681,858
12,642,632,10,195,121,86,77,58,105,0,913,642
13,649,639,10,197,123,87,77,59,106,0,1015,649
14,1044,1020,24,467,170,160,62,68,117,314,1334,1358
15,582,568,14,260,95,89,35,38,65,0,1014,582
16,1418,1385,33,634,231,217,84,92,160,258,1865,1676
17,1433,1400,33,641,233,219,85,93,162,0,1703,1433
18,1225,1182,43,714,211,112,36,55,97,296,1592,1521
19,1196,1154,42,697,206,109,35,53,96,169,1681,1365
20,1167,1144,23,578,261,93,69,58,108,95,1800,1262
21,2022,1983,39,480,300,182,123,199,738,142,3282,2164
22,1057,1037,20,251,157,95,64,104,386,41,1544,1098
23,5448,5354,94,759,296,509,314,663,2907,91,8325,5539
24,929,915,14,282,175,124,111,84,153,309,1327,1238
25,1460,1437,23,444,276,195,174,133,238,0,2086,1460
26,1762,1698,64,689,329,290,134,134,186,63,2829,1825
27,1143,1102,41,447,213,188,87,87,121,0,1802,1143
28,1714,1652,62,670,320,282,130,130,182,551,2594,2265
29,1383,1342,41,618,255,219,82,98,111,14,2189,1397
30,1919,1863,56,858,354,305,114,136,152,116,3206,2035
31,547,531,16,245,101,87,32,39,43,487,722,1034
32,628,607,21,150,97,80,77,61,163,0,1043,628
33,1146,1108,38,274,177,145,141,111,298,0,1745,1146
34,1483,1472,11,566,370,78,70,96,303,11,2796,1494
35,825,737,88,231,143,101,110,73,167,0,1543,825
36,856,765,91,240,148,105,114,76,173,3,1611,859
37,849,759,90,238,147,104,114,75,171,0,1301,849
38,527,476,51,193,108,56,49,36,85,0,1277,527
39,987,892,95,361,201,106,93,67,159,0,1933,987
40,2623,2546,77,1172,484,416,156,185,210,166,3674,2789
41,1348,1309,39,603,249,214,80,95,107,41,1852,1389
42,2024,1954,70,1179,348,185,60,90,162,2016,3333,4040
43,1289,1244,45,751,222,118,38,58,102,112,1620,1401
44,1081,977,104,288,180,142,127,103,241,0,1899,1081
45,872,788,84,232,146,114,102,83,195,0,1598,872
46,772,698,74,206,129,101,91,73,172,0,1355,772
47,1125,1105,20,286,162,129,127,119,302,0,1859,1125
48,1209,1187,22,307,174,138,136,127,327,0,1762,1209
49,627,572,55,149,104,73,73,67,161,0,1015,627
50,1144,1043,101,272,189,133,134,123,293,3,2257,1147
51,1248,1138,110,297,206,145,146,134,320,11,2236,1259
52,1331,1310,21,414,252,156,145,112,252,18,2056,1349
53,1579,1554,25,491,300,185,172,133,298,0,2283,1579
54,770,758,12,240,146,90,84,65,145,3,988,773
55,999,970,29,285,161,125,125,92,211,0,1453,999
56,429,417,12,123,69,54,54,40,89,3,743,432
57,813,790,23,232,131,102,102,75,171,0,1418,813
58,687,619,68,253,137,69,68,59,101,0,1488,687
59,998,899,99,368,198,101,98,85,148,2,1447,1000
60,1899,1856,43,550,266,151,135,187,610,29,2756,1928
61,795,776,19,276,174,121,69,62,93,320,1200,1115
62,329,319,10,107,23,38,11,30,120,29,524,358
63,321,313,8,108,29,36,21,28,99,12,437,333
64,848,757,91,258,170,104,83,81,152,17,1691,865
65,766,753,13,378,105,82,30,57,114,439,963,1205
66,1502,1476,26,741,206,162,59,111,223,0,2206,1502
67,2977,2925,52,1469,409,321,118,220,440,66,4603,3043
68,1712,1693,19,507,504,185,166,136,214,71,3001,1783
69,2221,2179,42,527,330,200,135,219,810,226,3557,2447
70,1637,1601,36,590,257,273,111,138,268,47,2243,1684
71,1590,1555,35,574,249,265,107,134,261,56,2400,1646
72,1724,1682,42,599,376,262,150,134,203,472,2514,2196
73,1108,1087,21,420,179,92,75,86,256,3,1676,1111
74,1082,964,118,338,216,128,118,97,185,12,2317,1094
75,637,567,70,199,127,75,70,57,109,0,1271,637
76,3147,3087,60,1451,577,434,194,188,303,101,3444,3248
77,1539,1509,30,709,282,212,95,92,149,44,4204,1583
78,1984,1945,39,983,444,159,117,99,182,72,3196,2056
79,1489,1460,29,738,333,119,88,74,137,9,1571,1498
80,2918,2852,66,288,235,239,205,344,1607,20,4598,2938
81,294,288,6,74,99,29,27,22,43,326,456,620
82,319,315,4,76,39,42,27,37,98,15,404,334
83,214,205,9,70,26,16,8,14,80,11,341,225
84,514,511,3,121,71,57,42,51,172,11,1101,525
85,334,325,9,120,42,60,17,21,74,60,531,394
86,94,92,2,37,13,11,4,8,21,21,153,115
87,41,41,0,9,5,4,3,5,15,2,66,43
88,1527,1510,17,452,449,165,148,121,192,330,3015,1857
89,472,461,11,47,38,39,33,56,259,327,727,799
90,744,728,16,186,251,75,68,55,109,32,1258,776
91,776,759,17,194,262,78,71,58,113,20,1490,796
92,2310,2240,70,422,254,264,239,312,819,17,3606,2327
93,4257,4185,72,844,574,462,454,539,1384,96,6738,4353
94,3572,3493,79,615,403,418,377,513,1246,30,5479,3602
95,2835,2747,88,537,312,325,281,351,1029,4,5174,2839
96,672,657,15,145,72,80,72,82,221,0,1217,672
97,2616,2264,352,365,376,253,299,358,965,111,6023,2727
98,1768,1516,252,246,245,209,190,221,657,21,4155,1789
99,1775,1517,258,203,278,201,199,237,657,0,3977,1775
100,67,59,8,8,8,12,7,9,23,0,104,67
101,305,245,60,19,34,27,31,44,150,0,757,305
102,825,708,117,128,119,95,89,100,294,0,1598,825
103,861,745,116,134,118,87,91,103,328,0,1901,861
104,455,394,61,71,62,46,48,55,173,0,982,455
105,448,387,61,70,61,45,47,54,171,4,991,452
106,632,547,85,98,86,64,67,76,241,0,1255,632
107,774,669,105,116,101,81,94,98,284,0,1612,774
108,720,622,98,108,94,75,87,91,265,30,1538,750
109,556,480,76,84,73,58,67,70,204,17,1242,573
110,871,752,119,131,114,91,106,110,319,0,1841,871
111,949,820,129,143,150,107,111,120,318,19,1806,968
112,973,841,132,147,153,110,113,123,327,36,1871,1009
113,902,780,122,136,142,102,105,114,303,0,1717,902
114,236,189,47,15,26,21,24,34,116,0,594,236
115,481,386,95,31,53,42,49,70,236,0,1105,481
116,740,637,103,113,114,69,85,94,265,0,1715,740
117,732,630,102,112,113,69,84,93,261,9,1614,741
118,1173,1010,163,179,181,110,135,149,419,9,2439,1182
119,599,508,91,91,86,64,67,78,213,2,1269,601
120,866,735,131,132,124,92,98,113,307,0,1803,866
121,492,417,75,75,70,53,55,64,175,0,1039,492
122,517,439,78,79,74,55,58,67,184,0,1240,517
123,803,681,122,122,115,86,90,105,285,6,1578,809
124,779,664,115,98,117,87,85,97,295,4,1653,783
125,627,535,92,79,94,70,69,78,237,6,1518,633
126,529,451,78,66,79,59,58,66,201,2,1219,531
127,712,607,105,89,107,79,78,89,270,0,1493,712
128,594,505,89,86,74,72,63,78,221,0,1401,594
129,807,692,115,125,116,93,87,98,288,6,1610,813
130,629,539,90,98,90,73,68,76,224,0,1325,629
131,730,621,109,106,91,89,78,96,270,4,1625,734
132,482,417,65,67,69,47,55,66,178,11,1349,493
133,1053,1020,33,305,254,119,96,87,192,47,1769,1100
134,847,623,224,67,60,104,116,153,347,6,2385,853
135,609,590,19,176,147,69,55,50,112,6,982,615
136,1139,1103,36,329,274,129,103,94,210,15,1687,1154
137,509,433,76,74,64,62,54,67,188,0,1308,509
138,1159,1139,20,258,161,130,132,137,341,130,1739,1289
139,1648,1619,29,367,229,185,187,195,485,2,2415,1650
140,938,922,16,209,131,105,106,111,276,66,1427,1004
141,848,833,15,189,118,95,96,100,250,0,1365,848
142,162,145,17,38,31,17,18,17,41,0,337,162
143,929,829,100,215,176,98,105,98,237,0,1902,929
144,804,717,87,186,152,85,91,85,205,157,1794,961
145,780,696,84,181,148,83,88,82,198,68,1493,848
146,942,840,102,218,179,100,106,99,240,66,1723,1008
147,784,722,62,165,149,91,76,81,222,72,1616,856
148,647,596,51,136,123,76,63,67,182,0,1223,647
149,1020,940,80,215,193,119,99,105,289,0,1462,1020
150,1604,1478,126,338,304,187,156,165,454,40,2245,1644
151,620,571,49,131,118,72,60,64,175,149,1170,769
152,707,651,56,149,134,83,69,73,199,94,1040,801
153,718,645,73,96,107,86,76,91,262,0,1359,718
154,607,545,62,81,90,72,64,77,223,147,1202,754
155,739,664,75,99,110,88,78,94,270,4,1361,743
156,369,331,38,49,55,44,39,47,135,0,766,369
157,939,843,96,126,140,112,99,119,343,30,1859,969
158,655,640,15,141,71,78,71,80,214,0,1143,655
159,691,675,16,149,74,82,74,84,228,0,1186,691
160,941,919,22,203,101,112,101,115,309,0,1477,941
161,630,559,71,72,67,65,70,80,276,0,1270,630
162,717,661,56,105,52,76,94,99,291,47,1444,764
163,369,340,29,54,27,39,48,51,150,4,672,373
164,1489,1372,117,218,107,157,194,205,608,0,2034,1489
165,336,298,38,39,36,34,37,42,148,0,815,336
166,578,513,65,66,62,59,65,73,253,340,913,918
167,287,254,33,33,31,29,32,36,126,0,713,287
168,567,503,64,65,60,58,63,72,249,0,1074,567
169,824,765,59,129,81,108,108,122,276,0,1567,824
170,830,770,60,130,81,109,109,123,278,0,1447,830
171,505,469,36,79,49,66,66,75,170,0,875,505
172,836,818,18,151,75,102,94,116,298,55,1254,891
173,1061,1038,23,192,96,129,119,148,377,0,1501,1061
174,1358,1357,1,307,214,151,122,149,415,176,1854,1534
175,642,642,0,145,101,71,58,70,197,15,865,657
176,496,479,17,147,119,51,45,37,97,0,902,496
177,884,854,30,262,211,91,80,67,173,0,1565,884
178,1296,1252,44,384,310,134,117,98,253,0,1841,1296
179,705,659,46,89,94,86,74,84,278,0,1358,705
180,539,504,35,68,72,65,57,64,213,45,1031,584
181,716,644,72,142,118,68,63,79,246,0,1276,716
182,659,592,67,130,108,62,58,72,229,0,1209,659
183,533,479,54,106,88,50,47,59,183,0,972,533
184,1389,1249,140,275,228,131,123,153,479,0,2235,1389
185,860,773,87,170,141,81,76,95,297,2,1685,862
186,367,359,8,101,70,28,32,34,102,9,761,376
187,1415,1384,31,388,269,108,125,132,393,176,1858,1591
188,1007,985,22,276,192,77,89,94,279,0,1298,1007
189,483,443,40,79,82,55,53,51,163,2,985,485
190,404,370,34,66,68,46,44,43,137,17,793,421
191,666,611,55,109,113,76,73,71,224,0,1340,666
192,507,485,22,72,78,50,55,60,192,3829,993,4336
193,578,552,26,82,89,57,63,68,219,4,1275,582
194,1075,1027,48,152,165,107,117,127,407,26,2243,1101
195,730,698,32,104,112,72,79,86,277,13,1387,743
196,1167,1051,116,389,311,93,94,95,185,11,2144,1178
197,1296,1167,129,432,346,104,105,105,204,0,2494,1296
198,2163,2129,34,710,573,204,184,148,344,23,3098,2186
199,827,733,94,408,311,17,28,18,45,0,1681,827
200,1153,1022,131,568,433,23,40,25,64,0,1888,1153
201,443,393,50,218,166,9,15,10,25,19,1052,462
202,430,381,49,212,161,9,15,10,23,0,891,430
203,416,375,41,94,107,46,42,34,93,0,787,416
204,689,621,68,156,177,76,69,57,154,19,1365,708
205,1268,1142,126,288,326,139,127,105,283,128,2609,1396
206,957,917,40,140,177,120,121,102,297,13,1786,970
207,1434,1374,60,210,266,179,182,153,444,38,2524,1472
208,572,533,39,106,110,70,67,63,156,43,1117,615
209,694,647,47,129,134,85,82,76,188,74,1463,768
210,588,548,40,109,113,72,69,64,161,30,1245,618
211,763,712,51,142,147,94,90,84,206,202,1713,965
212,835,780,55,141,182,98,85,96,233,13,1689,848
213,511,477,34,86,111,60,52,58,144,77,1181,588
214,652,609,43,110,142,77,66,75,182,13,1427,665
215,914,854,60,154,199,107,93,105,256,28,1726,942
216,697,644,53,89,118,86,76,88,240,28,1309,725
217,901,833,68,115,152,111,98,114,311,0,1768,901
218,933,805,128,130,132,106,116,126,323,6,1789,939
219,1122,968,154,156,158,127,140,152,389,0,2189,1122
220,536,462,74,74,76,61,67,72,186,4,1064,540
221,554,478,76,77,78,63,69,75,192,2,1162,556
222,602,519,83,84,85,68,75,81,209,2,1264,604
223,618,530,88,86,86,73,66,77,230,9,1386,627
224,857,735,122,119,119,101,92,107,319,0,1974,857
225,579,497,82,80,80,68,62,72,217,91,1278,670
226,505,467,38,64,85,62,55,64,175,100,881,605
227,342,316,26,44,58,42,37,43,118,2,725,344
228,1105,1054,51,178,183,130,107,135,372,0,2017,1105
229,624,595,29,100,103,73,61,76,211,0,1150,624
230,1708,1640,68,197,237,224,149,218,683,0,2612,1708
231,547,525,22,63,76,72,48,70,218,0,951,547
232,697,669,28,80,97,91,61,89,279,0,1251,697
233,0,0,0,0,0,0,0,0,0,119,0,119
234,72,53,19,6,5,9,10,13,29,9,203,81
235,586,526,60,78,87,70,62,74,215,0,1125,586
236,0,0,0,0,0,0,0,0,0,0,0,0
237,50,50,0,11,6,4,7,6,16,111,66,161
238,456,436,20,65,70,45,50,54,172,100,887,556
239,1290,1216,74,158,143,176,145,181,487,0,2251,1290
240,1499,1333,166,149,164,189,132,230,635,9,2988,1508
241,633,572,61,74,58,83,65,88,265,0,1140,633
242,743,542,201,83,57,103,74,115,311,100,2208,843
243,1567,1496,71,233,202,215,139,193,585,167,3073,1734
244,1232,1072,160,96,102,165,122,184,563,0,2492,1232
245,1138,800,338,121,124,144,125,161,463,48,3524,1186
246,1370,1286,84,85,137,150,120,211,667,0,3279,1370
247,4180,1933,2247,573,382,425,297,505,1998,0,14061,4180
248,700,629,71,156,154,73,58,68,191,9,1161,709
249,1408,1174,234,306,225,141,116,140,480,87,2068,1495
250,1508,1355,153,336,332,156,125,146,413,62,2856,1570
251,1486,1411,75,209,270,165,121,183,538,32,2455,1518
252,484,459,25,68,88,54,39,60,175,7,922,491
253,1026,974,52,144,186,114,83,127,372,41,1816,1067
254,495,470,25,80,68,62,54,63,168,0,908,495
255,482,458,24,78,66,60,53,61,164,9,808,491
256,982,932,50,160,135,123,108,124,332,5,1546,987
257,915,869,46,149,125,115,101,116,309,0,1627,915
258,570,523,47,82,111,69,55,65,188,5,1038,575
259,1207,1108,99,174,236,145,116,137,399,59,2154,1266
260,1733,1591,142,250,339,208,167,197,572,23,3213,1756
261,1266,1128,138,374,98,122,136,138,398,196,2590,1462
262,881,785,96,260,68,85,95,96,277,62,1641,943
263,754,672,82,223,59,72,81,82,237,0,1577,754
264,648,577,71,191,50,62,70,71,204,2,1536,650
265,552,509,43,161,44,49,58,58,182,0,1300,552
266,510,470,40,149,41,45,53,54,168,2,1298,512
267,716,660,56,209,57,63,75,75,237,2,1503,718
268,981,904,77,286,78,87,102,103,325,123,2470,1104
269,515,457,58,83,68,64,52,68,180,267,1129,782
270,1001,957,44,147,176,102,95,113,368,0,2228,1001
271,465,406,59,132,1,20,93,61,158,34,1439,499
272,482,313,169,61,63,79,46,57,176,14,1818,496
273,512,291,221,109,92,74,49,49,139,123,1736,635
274,627,275,352,342,257,10,11,5,2,0,1604,627
275,821,729,92,132,108,101,82,109,289,57,1529,878
276,553,491,62,89,72,68,55,73,196,0,1174,553
277,568,504,64,91,74,70,57,75,201,11,1221,579
278,416,371,45,51,66,52,38,52,157,0,906,416
279,519,462,57,63,82,65,48,65,196,0,1099,519
280,641,571,70,78,101,80,59,80,243,0,1381,641
281,529,471,58,64,84,66,49,66,200,2,975,531
282,430,381,49,55,64,57,44,54,156,5,865,435
283,741,656,85,95,111,99,75,94,267,0,1516,741
284,626,554,72,80,94,83,64,79,226,0,1370,626
285,618,543,75,80,96,92,65,80,205,0,1212,618
286,431,379,52,56,67,64,46,56,142,0,806,431
287,486,427,59,63,75,73,51,63,161,0,904,486
288,517,454,63,67,80,77,55,67,171,0,990,517
289,534,469,65,69,83,80,56,69,177,91,1021,625
290,850,769,81,99,78,111,87,118,357,0,1743,850
291,669,605,64,78,61,88,68,93,281,0,1239,669
292,697,666,31,103,123,71,66,79,255,0,1356,697
293,437,418,19,64,77,44,42,49,161,0,1058,437
294,506,476,30,68,54,62,55,66,201,0,1032,506
295,352,331,21,47,38,43,38,46,140,0,765,352
296,487,334,153,51,50,71,56,66,193,78,1736,565
297,642,442,200,76,76,89,79,78,244,9,2228,651
298,205,116,89,52,34,26,16,24,53,242,542,447
299,12445,6960,5485,4901,4185,823,997,528,1011,0,30560,12445
300,567,533,34,76,61,69,62,74,225,50,1097,617
301,552,519,33,74,59,67,60,72,220,0,1097,552
302,1985,1883,102,240,108,139,141,254,1103,2,4719,1987
303,1194,1133,61,145,65,84,85,153,662,7,1981,1201
304,1357,1154,203,388,141,121,122,149,436,46,3187,1403
305,991,843,148,284,103,89,89,109,317,32,2604,1023
306,628,599,29,107,45,69,49,86,272,2,1368,630
307,1133,963,170,324,118,101,102,125,363,18,3018,1151
308,720,596,124,210,98,38,92,75,207,27,2206,747
309,968,845,123,275,1,42,194,126,330,11,2382,979
310,450,393,57,128,0,20,90,59,153,0,1320,450
311,618,511,107,180,84,32,79,64,179,34,2077,652
312,200,178,22,49,22,21,25,18,65,14,423,214
313,675,558,117,196,92,35,87,70,195,0,2406,675
314,439,363,76,93,29,55,63,67,132,100,1249,539
315,403,333,70,85,27,50,58,61,122,34,1173,437
316,503,326,177,64,65,82,48,60,184,46,1900,549
317,403,337,66,110,33,65,34,49,112,16,1038,419
318,362,235,127,46,47,59,34,43,133,0,1298,362
319,350,307,43,39,32,36,34,47,162,0,923,350
320,401,313,88,29,51,61,35,66,159,7,1130,408
321,319,249,70,23,41,48,28,52,127,0,900,319
322,461,254,207,85,66,73,41,57,139,36,1503,497
323,556,306,250,102,79,88,50,69,168,21,1889,577
324,552,456,96,52,75,71,59,81,214,82,1531,634
325,507,418,89,48,69,65,54,74,197,30,1301,537
326,529,313,216,48,104,56,57,66,198,0,1563,529
327,650,335,315,183,177,48,36,49,157,0,2418,650
328,407,210,197,115,111,30,23,31,97,0,1484,407
329,319,266,53,28,48,45,25,44,129,32,874,351
330,642,535,107,57,97,91,51,88,258,50,1705,692
331,423,352,71,38,64,60,34,58,169,43,1056,466
332,521,430,91,50,71,67,56,76,201,237,1442,758
333,689,604,85,76,62,72,67,93,319,7,1916,696
334,577,506,71,64,52,60,56,78,267,0,1574,577
335,656,584,72,84,75,77,62,89,269,0,1563,656
336,791,704,87,102,90,93,74,107,325,0,1964,791
337,612,545,67,79,70,72,57,83,251,0,1684,612
338,519,462,57,67,59,61,49,70,213,5,1401,524
339,273,243,30,35,31,32,26,37,112,0,774,273
340,487,325,162,42,52,64,60,73,196,30,1646,517
341,262,175,87,23,28,34,32,39,106,0,868,262
342,427,285,142,37,45,56,52,64,173,30,1432,457
343,394,263,131,34,42,52,48,59,159,18,1323,412
344,419,280,139,36,44,55,51,63,170,82,1497,501
345,669,552,117,64,91,86,71,98,259,50,1529,719
346,763,632,131,79,137,101,79,102,265,30,1827,793
347,517,428,89,53,93,69,54,69,179,23,1167,540
348,362,300,62,37,65,48,38,48,126,11,989,373
349,391,324,67,40,70,52,41,52,136,64,885,455
350,382,298,84,28,49,58,33,63,151,7,1009,389
351,691,515,176,59,96,107,55,106,268,0,2234,691
352,692,515,177,129,260,70,58,40,135,7,1946,699
353,820,611,209,69,114,127,65,126,319,30,2831,850
354,432,321,111,80,162,44,36,25,85,0,1317,432
355,602,476,126,49,52,88,69,80,264,46,1798,648
356,460,377,83,51,69,45,47,66,182,36,1384,496
357,380,312,68,42,57,37,38,55,151,0,1199,380
358,459,376,83,51,69,45,46,66,182,0,1535,459
359,553,453,100,62,83,54,56,80,218,0,1662,553
360,345,283,62,39,52,34,35,50,135,68,1156,413
361,317,260,57,35,47,31,32,46,126,9,1020,326
362,490,347,143,45,48,61,52,70,214,9,1649,499
363,464,329,135,42,45,57,49,67,204,0,1546,464
364,353,250,103,32,34,44,37,51,155,5,1069,358
365,343,243,100,31,33,42,36,49,152,0,1061,343
366,253,180,73,33,29,40,21,29,101,41,680,294
367,379,270,109,49,43,61,32,44,150,0,1042,379
368,547,399,148,61,42,76,55,84,229,11,1713,558
369,168,122,46,19,13,23,17,26,70,0,515,168
370,701,455,246,84,78,93,65,97,284,0,2557,701
371,721,493,228,83,91,101,80,97,269,0,2543,721
372,788,527,261,85,95,92,110,106,300,0,2757,788
373,536,348,188,64,60,71,50,74,217,7,1973,543
374,385,305,80,32,33,56,44,51,169,0,1226,385
375,1693,1234,459,280,524,119,132,159,479,9,5929,1702
376,325,237,88,54,101,23,25,30,92,0,1018,325
377,570,415,155,94,176,40,44,53,163,0,2030,570
378,360,262,98,60,111,25,28,34,102,0,1184,360
379,498,343,155,44,64,56,66,70,198,18,1773,516
380,375,259,116,33,48,43,50,53,148,14,1376,389
381,337,232,105,29,43,38,45,48,134,0,1290,337
382,336,232,104,29,43,38,44,48,134,25,1268,361
383,317,219,98,28,41,36,42,45,125,55,1199,372
384,291,195,96,29,25,39,36,40,122,0,1093,291
385,362,247,115,42,46,51,40,49,134,14,1212,376
386,377,253,124,38,32,51,46,52,158,0,1549,377
387,365,257,108,39,40,46,40,52,148,0,1216,365
388,299,204,95,35,38,42,33,40,111,2,1029,301
389,455,305,150,46,39,61,56,63,190,0,1772,455
390,641,438,203,81,68,90,74,77,251,0,1940,641
391,507,334,173,71,93,80,47,50,166,32,1615,539
392,557,367,190,78,103,87,52,54,183,0,1846,557
393,473,424,49,66,85,60,49,59,154,55,1073,528
394,662,594,68,93,119,85,69,83,213,155,1393,817
395,472,423,49,66,85,60,49,59,153,2,1064,474
396,783,702,81,110,141,100,82,98,252,23,1440,806
397,1098,1044,54,182,114,135,111,144,412,687,1990,1785
398,961,913,48,159,99,118,98,126,361,0,1942,961
399,1672,1618,54,196,92,135,85,208,956,36,2496,1708
400,1356,1327,29,263,57,132,63,198,643,0,2441,1356
401,566,544,22,138,55,51,39,59,224,0,1100,566
402,420,399,21,70,43,52,43,55,157,0,838,420
403,2264,1629,635,191,315,223,160,322,1053,0,5346,2264
404,506,364,142,43,70,50,36,72,235,0,1599,506
405,230,203,27,48,41,29,21,21,70,0,494,230
406,1522,1435,87,186,169,207,171,214,575,0,2634,1522
407,536,474,62,111,96,68,50,49,162,23,1375,559
408,693,661,32,119,49,77,55,95,298,0,1430,693
409,11,10,1,3,1,1,1,1,4,167,21,178
410,488,408,80,133,40,79,41,60,135,2,1488,490
411,311,260,51,85,26,50,26,38,86,66,830,377
412,893,578,315,115,100,126,86,115,351,0,2755,893
413,430,278,152,55,48,61,42,56,168,0,1308,430
414,431,321,110,80,162,44,36,25,84,25,1211,456
415,613,411,202,62,54,87,67,86,257,0,2245,613
416,748,502,246,75,65,106,81,105,316,0,2522,748
417,832,557,275,90,100,97,117,112,316,9,2832,841
418,795,547,248,94,94,111,98,97,301,23,2902,818
419,559,382,177,70,59,78,64,68,220,21,1878,580
420,396,212,184,47,52,62,35,49,151,11,1626,407
421,293,157,136,35,38,46,26,36,112,0,1133,293
422,562,309,253,103,80,89,50,70,170,157,2041,719
423,649,612,37,79,72,88,73,91,246,0,1207,649
424,493,465,28,60,55,67,55,69,187,0,858,493
425,787,742,45,96,87,107,88,111,298,2,1578,789
426,1342,1282,60,251,96,162,110,179,544,7,2563,1349
427,916,875,41,172,65,110,75,122,372,0,1868,916
428,534,366,168,56,55,78,62,72,211,32,1790,566
429,372,255,117,39,38,54,43,50,148,2,1256,374
430,362,248,114,38,37,53,42,49,143,16,1299,378
431,399,273,126,42,41,58,46,54,158,14,1319,413
432,771,540,231,76,93,90,83,111,318,32,2780,803
433,618,433,185,61,74,72,66,89,256,46,2091,664
434,286,200,86,28,34,33,31,41,119,16,942,302
435,370,259,111,36,44,43,40,53,154,0,1260,370
436,450,315,135,44,54,53,48,65,186,0,1605,450
437,519,363,156,51,62,61,56,75,214,0,1923,519
438,898,524,374,158,129,142,80,106,283,201,2998,1099
439,1382,1296,86,349,256,153,158,130,336,18,2846,1400
440,3728,3109,619,810,595,374,308,371,1270,258,4871,3986
441,1283,1070,213,279,205,129,106,128,436,178,2839,1461
442,62,58,4,16,12,7,7,6,14,317,119,379
443,1436,1197,239,312,229,144,119,143,489,30,2979,1466
444,1743,1566,177,388,383,181,144,169,478,107,2929,1850
445,2306,2037,269,665,81,231,160,270,899,9,5602,2315
446,1725,1524,201,497,61,173,120,202,672,16,3688,1741
447,670,592,78,193,24,67,46,78,262,0,1477,670
448,12,11,1,2,2,2,1,2,3,32,16,44
449,561,384,177,59,58,82,65,76,221,2,1924,563
450,0,0,0,0,0,0,0,0,0,0,0,0
451,77,70,7,11,11,14,6,11,24,25,160,102
452,3245,3116,129,789,316,291,223,340,1286,132,6358,3377
453,796,747,49,201,148,88,91,75,193,141,2093,937
454,492,461,31,124,91,54,56,46,121,11,1044,503
455,0,0,0,0,0,0,0,0,0,5,0,5
456,119,112,7,30,22,13,14,11,29,34,305,153
457,819,801,18,159,34,80,38,120,388,205,1469,1024
458,1579,1516,63,384,154,141,108,165,627,34,2824,1613
459,515,498,17,61,28,41,26,64,295,406,694,921
460,219,195,24,53,24,23,27,20,72,0,541,219
461,330,294,36,80,37,35,41,30,107,0,861,330
462,16,15,1,2,1,1,1,2,9,0,60,16
463,4576,4342,234,554,250,321,324,586,2541,64,11775,4640
464,918,871,47,111,50,64,65,118,510,5,2362,923
465,298,283,15,36,16,21,21,38,166,0,414,298
466,0,0,0,0,0,0,0,0,0,0,0,0
467,247,225,22,35,34,44,19,36,79,0,294,247
468,0,0,0,0,0,0,0,0,0,46,0,46
469,0,0,0,0,0,0,0,0,0,5,0,5
470,53,48,5,7,7,9,4,8,18,5,103,58
471,9,8,1,1,1,2,1,1,3,11,15,20
472,0,0,0,0,0,0,0,0,0,0,0,0
473,209,190,19,29,29,37,16,31,67,0,537,209
474,491,291,200,181,119,69,37,30,55,0,1446,491
475,861,509,352,318,209,122,66,53,93,11,2292,872
476,3014,1321,1693,1646,1236,47,52,26,7,5,10228,3019
477,240,142,98,22,47,26,26,30,89,0,801,240
478,926,548,378,85,183,98,100,116,344,0,3066,926
479,434,224,210,122,118,32,24,33,105,0,1280,434
480,895,461,434,252,243,67,50,68,215,0,3118,895
481,260,143,117,48,37,41,23,32,79,2,834,262
482,63,42,21,6,5,8,8,9,27,0,248,63
483,5182,3729,1453,438,722,511,365,738,2408,0,11622,5182
484,2137,1538,599,181,298,211,151,304,992,14,6909,2151
485,311,227,84,51,96,22,24,29,89,14,1098,325
486,463,337,126,77,143,33,36,43,131,0,1442,463
487,248,203,45,28,37,24,25,36,98,0,796,248
488,719,675,44,45,72,79,63,111,349,0,1724,719
489,692,649,43,43,69,76,60,106,338,0,1676,692
490,367,352,15,89,36,33,25,38,146,1275,720,1642
491,610,544,66,40,62,61,55,78,314,0,1472,610
492,1425,1304,121,108,84,107,119,207,800,0,3334,1425
493,825,733,92,83,112,85,83,95,367,57,1951,882
494,253,225,28,26,34,26,25,29,113,7,664,260
495,303,269,34,31,41,31,30,35,135,0,869,303
496,326,290,36,33,44,34,33,38,144,13,866,339
497,435,382,53,50,42,46,46,56,195,2,1259,437
498,312,274,38,36,30,33,33,40,140,0,770,312
499,329,289,40,37,31,35,35,42,149,0,852,329
500,355,312,43,40,34,38,38,46,159,0,928,355
501,540,474,66,61,52,57,58,70,242,13,1390,553
502,330,290,40,38,32,35,35,43,147,0,870,330
503,346,304,42,39,33,37,37,45,155,9,924,355
504,342,281,61,30,53,43,34,45,137,4,894,346
505,599,493,106,53,92,76,59,79,240,0,1370,599
506,337,277,60,30,52,43,33,44,135,9,908,346
507,503,414,89,45,78,64,50,66,200,0,1330,503
508,322,265,57,29,50,41,32,42,128,0,850,322
509,314,258,56,28,48,40,31,41,126,0,845,314
510,291,239,52,26,45,37,29,38,116,0,774,291
511,472,413,59,48,47,54,45,63,215,0,1260,472
512,492,431,61,50,49,56,47,65,225,0,1345,492
513,559,489,70,57,56,64,53,74,255,16,1421,575
514,405,354,51,41,41,46,39,54,184,0,1088,405
515,582,509,73,60,59,67,55,77,264,36,1543,618
516,453,396,57,46,46,52,43,60,206,5,1227,458
517,572,523,49,52,57,59,45,84,275,5,1456,577
518,316,289,27,29,31,32,25,46,153,0,728,316
519,404,369,35,37,40,42,32,59,194,0,1007,404
520,247,226,21,23,24,25,19,36,120,0,624,247
521,772,647,125,99,126,108,74,97,268,0,1765,772
522,622,521,101,80,102,87,60,78,215,48,1423,670
523,565,460,105,51,63,68,55,85,243,0,1439,565
524,535,436,99,48,60,64,52,81,230,5,1439,540
525,429,350,79,39,48,52,42,65,183,0,1153,429
526,323,263,60,29,36,39,31,49,139,5,981,328
527,366,298,68,33,41,44,36,55,157,0,1053,366
528,343,279,64,31,38,41,33,52,148,0,973,343
529,490,399,91,44,55,59,48,74,210,0,1513,490
530,618,518,100,80,101,87,59,78,213,0,1427,618
531,401,323,78,34,41,52,40,61,173,0,1149,401
532,346,279,67,30,36,45,35,53,147,0,1035,346
533,387,312,75,33,40,50,39,59,166,0,1093,387
534,343,277,66,29,35,45,35,52,147,0,1013,343
535,518,420,98,42,63,67,53,74,219,0,1369,518
536,357,290,67,29,43,46,36,51,152,23,894,380
537,574,466,108,46,69,74,59,82,244,0,1436,574
538,372,302,70,30,45,48,38,53,158,5,960,377
539,492,399,93,40,59,63,50,70,210,0,1200,492
540,333,270,63,27,40,43,34,48,141,0,836,333
541,520,419,101,51,62,65,51,76,215,0,1193,520
542,473,381,92,46,56,59,46,69,197,0,1173,473
543,503,405,98,49,60,63,49,74,208,0,1347,503
544,462,372,90,45,55,58,45,68,191,7,1125,469
545,993,876,117,127,177,124,97,132,336,0,1923,993
546,543,479,64,70,97,68,53,72,183,5,1136,548
547,846,723,123,80,106,108,83,123,346,0,1847,846
548,617,544,73,79,110,77,60,82,209,0,1400,617
549,816,710,106,116,137,120,78,106,259,0,1503,816
550,871,757,114,124,147,128,84,113,275,27,1526,898
551,523,447,76,49,65,67,51,76,215,0,1228,523
552,3193,3090,103,327,349,245,245,521,1506,2,7619,3195
553,745,637,108,70,93,95,73,109,305,20,1584,765
554,495,404,91,44,57,55,45,72,222,0,1249,495
555,499,426,73,47,62,64,49,73,204,0,1086,499
556,496,405,91,44,57,56,45,72,222,0,1265,496
557,285,229,56,27,34,34,25,37,128,0,755,285
558,548,439,109,52,65,65,48,71,247,0,1363,548
559,469,376,93,45,55,56,41,61,211,0,1146,469
560,376,302,74,36,44,45,33,49,169,0,908,376
561,314,280,34,20,32,31,28,40,163,11,781,325
562,709,630,79,71,97,73,71,82,315,7,1928,716
563,691,601,90,98,116,102,66,90,219,18,1284,709
564,482,394,88,43,56,54,43,70,216,0,1095,482
565,411,322,89,41,41,48,46,60,175,16,1163,427
566,633,495,138,64,64,74,71,93,267,11,1730,644
567,520,407,113,52,52,61,58,76,221,0,1452,520
568,560,438,122,57,57,66,63,82,235,0,1647,560
569,555,434,121,56,56,65,62,82,234,0,1663,555
570,517,405,112,52,52,61,58,76,218,0,1494,517
571,820,684,136,93,116,107,76,110,318,7,1954,827
572,722,602,120,82,102,95,67,97,279,0,1809,722
573,668,557,111,76,94,87,62,89,260,7,1696,675
574,810,676,134,92,114,106,75,108,315,23,2083,833
575,576,480,96,65,81,75,53,77,225,0,1429,576
576,460,384,76,52,65,60,43,62,178,9,1218,469
577,561,466,95,53,67,69,53,85,234,0,1477,561
578,635,527,108,60,76,78,60,97,264,2,1560,637
579,455,378,77,43,54,56,43,69,190,0,1148,455
580,549,456,93,52,66,67,52,84,228,0,1289,549
581,575,478,97,54,69,70,55,88,239,0,1476,575
582,466,387,79,44,56,57,44,71,194,0,1282,466
583,416,338,78,33,48,53,39,63,180,0,1238,416
584,457,372,85,36,52,58,43,69,199,0,1291,457
585,474,385,89,37,54,60,45,72,206,0,1392,474
586,596,485,111,47,68,76,57,90,258,13,1652,609
587,417,339,78,33,48,53,40,63,180,0,1212,417
588,451,367,84,35,52,58,43,68,195,13,1338,464
589,476,387,89,37,55,61,45,72,206,0,1319,476
590,2054,1879,175,156,121,154,171,299,1153,0,4800,2054
591,455,416,39,35,27,34,38,66,255,0,1092,455
592,2035,1862,173,155,119,153,170,296,1142,0,4887,2035
593,1191,1090,101,91,70,89,99,173,669,0,2805,1191
594,538,434,104,46,55,70,54,82,231,0,1343,538
595,663,534,129,65,78,83,65,97,275,0,1661,663
596,318,310,8,79,57,26,26,39,91,4,464,322
597,0,0,0,0,0,0,0,0,0,0,0,0
598,321,251,70,32,32,38,36,47,136,0,1006,321
599,1556,1424,132,118,91,117,130,227,873,0,3421,1556
600,73,71,2,7,8,6,6,12,34,3282,183,3355
601,146,130,16,15,20,15,15,17,64,0,347,146
602,666,534,132,63,79,79,58,87,300,0,1689,666
603,464,449,15,55,26,37,24,58,264,0,551,464
604,52,50,2,6,3,4,3,6,30,0,189,52
605,3321,3213,108,390,184,267,168,414,1898,0,6826,3321
606,21,20,1,2,1,2,1,3,12,0,77,21
607,694,678,16,271,95,83,28,57,160,63,920,757
608,196,192,4,76,27,23,8,16,46,23,347,219
609,153,150,3,60,21,18,6,13,35,12,149,165
610,583,579,4,137,80,64,48,58,196,53,419,636
611,0,0,0,0,0,0,0,0,0,17,0,17
612,190,189,1,45,26,21,16,19,63,0,133,190
613,299,296,3,25,15,25,17,36,181,0,486,299
614,464,460,4,39,23,39,27,56,280,2,555,466
615,516,512,4,115,59,55,33,61,193,17,654,533
616,1042,746,296,100,141,131,121,184,365,0,2561,1042
617,559,462,97,59,79,70,66,85,200,0,1320,559
618,1578,1103,475,146,163,232,179,255,603,254,4606,1832
619,1548,1261,287,147,114,228,150,294,615,0,4066,1548
620,2579,2086,493,146,98,415,264,505,1151,15,6120,2594
621,7,5,2,0,1,0,1,1,4,0,19,7
622,3135,2801,334,75,191,440,438,610,1381,17,6291,3152
623,1367,988,379,83,154,156,174,250,550,0,3524,1367
624,1266,830,436,94,123,163,148,223,515,39,3612,1305
625,2153,1651,502,224,264,308,217,373,767,20,6224,2173
626,1402,959,443,70,79,182,152,260,659,33,4886,1435
627,435,316,119,42,59,60,51,79,144,0,1226,435
628,1838,1236,602,160,244,246,247,314,627,7,5484,1845
629,656,429,227,89,100,105,81,92,189,35,1861,691
630,3633,2428,1205,373,489,496,457,636,1182,11,9432,3644
631,1672,1308,364,144,148,215,173,315,677,50,4379,1722
632,1526,1329,197,65,41,231,240,244,705,13,2945,1539
633,1887,1707,180,203,156,309,209,306,704,79,3628,1966
634,1200,1003,197,50,36,176,101,255,582,0,2789,1200
635,1456,1163,293,61,42,208,180,316,649,0,3211,1456
636,1878,1637,241,149,75,338,202,354,760,0,4331,1878
637,2291,1531,760,71,93,281,273,475,1098,57,6138,2348
638,1692,1185,507,26,94,183,191,344,854,481,4360,2173
639,332,275,57,13,18,30,58,68,145,0,803,332
640,932,750,182,15,26,49,165,240,437,0,2383,932
641,635,492,143,8,15,40,106,155,311,35,1407,670
642,537,459,78,22,26,48,83,107,251,4,1100,541
643,309,252,57,20,27,26,43,55,138,15,775,324
644,2076,1359,717,174,296,293,247,347,719,52,5968,2128
645,2562,1650,912,457,633,287,210,312,663,2,6524,2564
646,1317,869,448,192,214,201,142,174,394,162,3490,1479
647,644,350,294,88,108,94,72,88,194,0,2076,644
648,724,599,125,29,64,91,99,129,312,0,1681,724
649,426,322,104,16,36,53,52,76,193,0,1001,426
650,325,246,79,12,28,40,40,58,147,2,772,327
651,421,318,103,16,36,52,51,75,191,0,1056,421
652,3042,2708,334,550,636,218,195,331,1112,0,3694,3042
653,592,405,187,30,65,71,73,101,252,177,1563,769
654,648,352,296,89,108,94,72,89,196,0,1920,648
655,863,569,294,126,140,132,93,114,258,17,2364,880
656,4413,3379,1034,479,1437,214,408,483,1392,2,10660,4415
657,725,478,247,106,118,111,78,96,216,17,1992,742
658,1017,829,188,66,90,86,142,182,451,122,2571,1139
659,331,227,104,17,36,40,41,56,141,85,899,416
660,453,310,143,23,50,54,56,77,193,0,1228,453
661,1656,1177,479,92,125,181,162,306,790,48,4354,1704
662,495,259,236,48,56,78,58,80,175,0,1251,495
663,292,153,139,28,33,46,34,47,104,0,883,292
664,2131,1787,344,111,171,196,222,350,1081,42,4538,2173
665,312,259,53,42,91,31,44,31,73,0,807,312
666,806,636,170,98,89,118,82,140,279,72,2109,878
667,741,634,107,31,37,67,115,148,343,59,1755,800
668,310,253,57,20,27,26,43,55,139,0,751,310
669,329,172,157,32,37,52,39,53,116,63,1047,392
670,3457,2262,1195,472,529,556,425,485,990,190,10141,3647
671,939,776,163,100,133,118,111,143,334,44,2065,983
672,1142,931,211,75,101,96,159,204,507,20,2300,1162
673,440,359,81,29,39,37,61,79,195,0,1063,440
674,2446,2034,412,330,715,245,344,241,571,0,4381,2446
675,227,169,58,13,37,16,41,34,86,0,571,227
676,390,290,100,22,64,27,70,58,149,0,939,390
677,364,270,94,20,60,25,66,54,139,31,878,395
678,596,427,169,57,81,75,69,105,209,0,1475,596
679,644,422,222,48,62,83,75,113,263,0,2088,644
680,377,288,89,90,118,24,22,36,87,13,926,390
681,325,249,76,77,102,21,19,31,75,0,850,325
682,334,248,86,18,55,23,60,50,128,0,839,334
683,520,309,211,67,47,71,53,84,198,0,1532,520
684,1064,632,432,138,95,146,108,172,405,0,3335,1064
685,368,241,127,27,36,48,43,65,149,0,1190,368
686,849,526,323,96,193,106,103,110,241,0,2615,849
687,849,526,323,96,193,106,103,110,241,0,2649,849
688,839,536,303,66,244,84,102,107,236,22,2547,861
689,575,367,208,45,167,58,70,73,162,4,1683,579
690,1086,694,392,85,316,109,132,138,306,230,3177,1316
691,534,341,193,42,155,53,65,68,151,15,1624,549
692,2442,2117,325,391,208,369,281,342,851,11,5451,2453
693,991,889,102,185,154,139,64,144,305,0,2328,991
694,3393,2354,1039,536,1229,257,272,326,773,20,9687,3413
695,897,774,123,71,113,117,107,154,335,0,2320,897
696,339,293,46,27,43,44,40,58,127,9,861,348
697,5656,4328,1328,1346,1767,359,336,542,1306,0,11006,5656
698,1587,1370,217,126,201,207,189,273,591,20,3957,1607
699,792,654,138,84,113,100,94,121,280,20,1837,812
700,801,632,169,97,88,117,81,139,279,0,1897,801
701,718,566,152,87,79,105,73,124,250,42,1871,760
702,421,304,117,29,36,59,44,73,180,0,1152,421
703,848,612,236,58,72,118,88,148,364,13,2322,861
704,742,535,207,51,63,103,77,129,319,48,2195,790
705,1076,989,87,164,122,159,116,186,329,0,2172,1076
706,1553,1129,424,150,210,215,184,281,513,22,3824,1575
707,828,686,142,34,73,104,113,147,357,11,1907,839
708,2013,1541,472,218,655,97,186,220,637,0,4248,2013
709,600,459,141,65,195,29,55,66,190,0,1199,600
710,751,621,130,29,41,68,131,153,329,15,1674,766
711,229,189,40,9,13,21,40,47,99,24,562,253
712,344,266,78,4,8,22,57,84,169,0,813,344
713,525,346,179,40,72,66,65,81,201,31,1695,556
714,433,286,147,33,59,54,54,67,166,11,1452,444
715,828,546,282,63,114,104,103,128,316,0,2636,828
716,700,628,72,130,109,98,45,102,216,0,1640,700
717,425,331,94,33,51,33,74,72,162,0,956,425
718,962,749,213,76,116,75,168,164,363,0,2101,962
719,546,425,121,43,66,43,95,93,206,11,1177,557
720,232,201,31,31,26,28,16,38,93,0,561,232
721,380,300,80,46,42,55,39,66,132,160,988,540
722,582,404,178,92,211,44,47,56,132,31,1574,613
723,560,389,171,89,203,42,45,54,127,0,1590,560
724,0,0,0,0,0,0,0,0,0,0,0,0
725,0,0,0,0,0,0,0,0,0,177,0,177
726,408,269,139,31,56,51,51,63,156,0,1135,408
727,1419,1229,190,190,158,174,99,234,564,0,4345,1419
728,1217,900,317,72,155,138,157,215,480,105,3532,1322
729,1120,828,292,66,143,127,144,198,442,77,3184,1197
730,2791,1984,807,154,210,305,272,515,1335,0,8533,2791
731,440,363,77,47,63,55,52,67,156,44,1084,484
732,339,281,58,14,30,43,46,60,146,24,762,363
733,599,496,103,24,53,75,82,106,259,22,1362,621
734,9809,8227,1582,512,789,900,1021,1611,4976,0,48955,9809
735,7205,6413,792,1303,1507,517,461,784,2633,0,18347,7205
736,159,142,17,29,33,11,10,17,59,0,563,159
737,2575,1658,917,459,636,288,211,313,668,22,7427,2597
738,355,299,56,10,15,39,45,55,191,0,842,355
739,1288,1058,230,20,38,142,179,202,707,14,3073,1302
740,1602,1389,213,41,67,185,179,283,847,0,3563,1602
741,263,219,44,8,13,28,32,43,139,0,688,263
742,852,549,303,16,31,80,108,168,449,168,2578,1020
743,378,288,90,6,18,33,56,66,199,47,1097,425
744,1793,1704,89,154,70,221,197,272,879,0,2902,1793
745,1445,1222,223,165,171,179,173,217,540,0,3072,1445
746,1451,1151,300,23,54,200,196,254,724,0,3426,1451
747,4050,3452,598,260,303,499,479,663,1846,0,9045,4050
748,530,383,147,4,26,68,69,84,279,3,1418,533
749,1344,1057,287,58,109,176,179,200,622,68,3426,1412
750,2634,2112,522,56,306,244,219,445,1364,0,6942,2634
751,3314,2892,422,163,363,396,299,572,1521,0,6882,3314
752,421,329,92,9,16,34,62,87,213,0,1195,421
753,1409,1072,337,14,33,107,212,284,759,0,3943,1409
754,679,525,154,23,42,56,101,110,347,5,1737,684
755,4403,3301,1102,199,309,350,422,736,2387,19,10638,4422
756,373,245,128,6,16,32,39,76,204,73,1128,446
757,1529,1128,401,54,98,206,166,254,751,10,3522,1539
758,1649,1293,356,51,95,214,214,298,777,0,3988,1649
759,1345,1090,255,31,66,203,186,261,598,23,3330,1368
760,2393,1789,604,45,90,338,318,483,1119,28,6325,2421
761,1647,1195,452,57,82,190,166,330,822,45,4509,1692
762,2605,1867,738,61,122,330,289,530,1273,24,6858,2629
763,4924,3797,1127,383,446,564,527,806,2198,135,11202,5059
764,2661,2037,624,218,495,248,255,400,1045,19,6177,2680
765,424,334,90,25,44,47,61,69,178,0,984,424
766,339,267,72,20,35,38,49,55,142,0,872,339
767,279,220,59,16,29,31,40,45,118,0,739,279
768,1371,1201,170,194,271,119,174,182,431,278,2509,1649
769,882,773,109,125,174,76,112,117,278,28,1909,910
770,419,346,73,45,86,46,55,55,132,68,1031,487
771,1672,1435,237,103,328,154,126,251,710,14,3295,1686
772,885,759,126,55,174,82,67,133,374,42,2216,927
773,868,745,123,54,170,80,66,131,367,0,2131,868
774,702,615,87,99,139,61,89,93,221,9,1262,711
775,782,659,123,42,59,84,137,150,310,0,2086,782
776,643,420,223,11,29,62,106,123,312,16,1991,659
777,447,292,155,7,20,43,74,86,217,0,1379,447
778,312,204,108,5,14,30,51,60,152,10,1104,322
779,433,252,181,22,44,47,66,79,175,0,1090,433
780,671,391,280,34,68,72,103,122,272,194,2248,865
781,642,374,268,32,65,69,98,117,261,52,2101,694
782,510,438,72,32,100,47,39,77,215,682,1291,1192
783,428,249,179,22,43,46,66,78,173,0,1260,428
784,838,731,107,98,110,67,96,131,336,141,1314,979
785,887,774,113,104,117,71,101,139,355,12,1651,899
786,506,411,95,46,68,41,45,67,239,0,1099,506
787,1092,953,139,128,144,88,125,171,436,0,2731,1092
788,418,348,70,12,20,45,51,69,221,0,1045,418
789,465,387,78,13,23,50,57,76,246,0,1242,465
790,641,530,111,69,124,61,51,83,253,0,1497,641
791,896,741,155,96,174,85,71,116,354,0,1970,896
792,336,262,74,7,13,27,49,69,171,0,934,336
793,1279,1078,201,69,96,137,225,245,507,19,2460,1298
794,2862,2276,586,114,169,274,313,412,1580,76,7314,2938
795,1517,1278,239,229,317,118,122,188,543,95,3379,1612
796,2318,1953,365,350,484,181,186,287,830,0,4824,2318
797,746,600,146,27,53,74,94,117,381,28,1822,774
798,678,560,118,72,139,74,89,89,215,54,1440,732
799,738,610,128,79,151,81,97,97,233,2,1520,740
800,327,270,57,35,67,36,43,43,103,12,839,339
801,835,650,185,97,201,76,94,96,271,0,1701,835
802,483,376,107,56,116,44,55,56,156,9,1072,492
803,1075,836,239,125,258,98,121,124,349,0,2449,1075
804,1816,1413,403,210,437,165,205,210,589,0,4207,1816
805,458,356,102,53,110,42,52,53,148,0,1062,458
806,624,502,122,23,44,62,78,98,319,61,1531,685
807,673,581,92,80,86,71,70,88,278,54,1615,727
808,1419,1225,194,168,182,149,148,186,586,88,2894,1507
809,349,301,48,41,45,37,36,46,144,35,853,384
810,4879,4023,856,478,558,385,421,672,2365,19,11469,4898
811,2008,1843,165,374,668,145,159,193,469,2,3197,2010
812,1410,1294,116,263,469,102,111,136,329,17,2782,1427
813,849,779,70,158,282,61,67,82,199,0,2186,849
814,642,489,153,10,30,56,95,113,338,108,1921,750
815,419,270,149,8,15,39,53,83,221,26,1278,445
816,357,235,122,6,15,31,38,73,194,95,1129,452
817,1495,1195,300,71,106,157,155,255,751,0,4015,1495
818,2832,2263,569,135,201,297,294,484,1421,0,6560,2832
819,660,513,147,44,75,67,76,114,284,29,1591,689
820,730,567,163,48,82,74,84,127,315,36,2007,766
821,369,287,82,24,42,37,43,64,159,50,968,419
822,406,315,91,27,46,41,47,70,175,0,1127,406
823,1095,950,145,171,156,125,97,164,382,0,2306,1095
824,346,270,76,7,13,28,51,71,176,0,992,346
825,448,341,107,4,10,34,67,90,243,0,1198,448
826,1040,977,63,155,217,91,108,134,335,0,1557,1040
827,928,724,204,20,35,74,136,191,472,0,2594,928
828,695,586,109,20,29,77,88,109,372,0,1539,695
829,666,625,41,99,139,58,69,86,215,0,1102,666
830,492,462,30,73,102,43,51,63,160,7,1196,499
831,792,744,48,118,165,69,82,102,256,76,1528,868
832,270,209,61,9,17,22,40,44,138,0,710,270
833,455,352,103,16,28,37,68,74,232,0,1090,455
834,489,397,92,45,65,39,43,65,232,26,1175,515
835,2888,2345,543,265,385,233,256,384,1365,0,6913,2888
836,191,165,26,21,46,19,14,26,65,0,508,191
837,2093,1727,366,35,164,213,181,409,1091,187,4777,2280
838,1655,1240,415,21,59,197,137,339,902,45,4292,1700
839,696,581,115,68,118,69,63,100,278,0,1631,696
840,1692,901,791,45,101,196,187,359,804,27,5262,1719
841,1416,690,726,127,245,194,149,241,460,152,4850,1568
842,1397,1078,319,60,173,154,119,237,654,0,3813,1397
843,665,558,107,24,85,74,46,119,317,0,1641,665
844,1869,1517,352,72,210,222,183,331,851,39,4688,1908
845,3051,2331,720,95,424,337,304,549,1342,0,7078,3051
846,414,177,237,25,54,68,42,77,148,0,1492,414
847,1812,1188,624,92,208,263,260,324,665,0,4823,1812
848,1052,825,227,41,144,135,99,158,475,46,2586,1098
849,851,590,261,48,60,108,83,156,396,111,2218,962
850,2464,871,1593,217,376,259,179,380,1053,130,10880,2594
851,1654,587,1067,117,152,277,182,340,586,27,6952,1681
852,1871,1503,368,50,74,295,250,415,787,229,4424,2100
853,700,553,147,74,76,104,72,109,265,0,1914,700
854,1210,893,317,21,49,160,115,245,620,12,3629,1222
855,1909,1541,368,36,86,250,189,388,960,9,4522,1918
856,1758,1569,189,44,80,231,179,336,888,10,4203,1768
857,2743,2177,566,60,104,345,271,582,1381,27,6603,2770
858,1254,971,283,46,54,154,111,257,632,0,3415,1254
859,1342,1047,295,27,52,163,123,289,688,0,3372,1342
860,2334,1853,481,200,354,329,232,361,858,61,5531,2395
861,2245,1753,492,53,202,279,238,433,1040,42,5622,2287
862,2508,2058,450,126,322,246,201,455,1158,70,6254,2578
863,1990,1557,433,53,102,263,200,392,980,19,4883,2009
864,800,635,165,33,52,114,76,159,366,0,2124,800
865,2370,1060,1310,262,417,400,219,406,666,1,8408,2371
866,2990,1390,1600,204,339,521,300,555,1071,94,10401,3084
867,2735,1518,1217,145,195,481,337,590,987,43,7834,2778
868,1101,990,111,200,220,147,98,130,306,70,2130,1171
869,223,177,46,9,15,32,21,44,102,672,576,895
870,500,397,103,21,33,71,48,100,227,0,1224,500
871,941,642,299,94,204,83,64,120,376,0,2523,941
872,411,327,84,8,41,43,41,71,207,0,1109,411
873,296,223,73,37,36,31,27,54,111,0,809,296
874,377,284,93,47,46,40,34,69,141,0,1023,377
875,613,461,152,76,74,64,56,113,230,0,1589,613
876,837,620,217,31,74,95,91,126,420,45,2204,882
877,1101,837,264,23,126,110,86,201,555,0,2850,1101
878,855,650,205,18,98,86,67,156,430,3,2227,858
879,352,264,88,11,17,50,29,66,179,0,832,352
880,579,500,79,63,139,57,42,78,200,0,1492,579
881,1536,1326,210,168,368,150,112,208,530,16,3402,1552
882,1229,1061,168,134,294,120,89,166,426,15,2790,1244
883,436,344,92,46,47,65,45,68,165,0,1222,436
884,327,207,120,26,33,30,31,66,141,247,772,574
885,706,446,260,57,72,65,66,142,304,0,1682,706
886,1243,1037,206,121,211,123,112,178,498,0,2217,1243
887,443,370,73,43,75,44,40,64,177,28,1056,471
888,1318,1185,133,240,263,176,117,156,366,1,2954,1319
889,472,355,117,14,23,67,40,88,240,3,1229,475
890,869,798,71,170,178,91,87,93,250,0,2139,869
891,704,646,58,138,144,73,71,75,203,0,1243,704
892,956,878,78,187,196,100,96,102,275,1,1823,957
893,1404,825,579,102,296,144,147,183,532,25,4637,1429
894,575,338,237,42,121,59,60,75,218,0,1901,575
895,5213,4610,603,779,1021,305,364,560,2184,12,10461,5225
896,1191,845,346,124,160,164,127,192,424,0,3630,1191
897,470,201,269,29,62,77,47,88,167,0,1887,470
898,1184,1022,162,129,284,116,86,160,409,31,1923,1215
899,737,433,304,54,155,76,77,96,279,0,2205,737
900,1372,1201,171,141,301,177,161,178,414,139,3571,1511
901,873,764,109,90,192,113,103,113,262,0,1827,873
902,592,404,188,59,129,52,40,76,236,13,1443,605
903,1491,1223,268,35,165,149,144,275,723,0,3637,1491
904,616,490,126,12,61,64,61,107,311,13,1616,629
905,430,370,60,45,84,49,38,58,156,34,1072,464
906,983,846,137,103,191,111,86,132,360,12,1922,995
907,477,411,66,50,93,54,42,64,174,9,1056,486
908,697,483,214,59,164,76,64,102,232,0,1698,697
909,613,262,351,38,81,100,62,114,218,403,1681,1016
910,673,366,307,52,121,84,94,100,222,7,2062,680
911,783,560,223,60,148,93,88,103,291,0,1775,783
912,497,447,50,90,99,67,44,59,138,0,1189,497
913,680,624,56,133,139,71,68,72,197,0,1331,680
914,557,303,254,43,100,69,78,83,184,188,2047,745
915,462,330,132,35,87,55,52,61,172,0,1015,462
916,890,636,254,68,168,105,100,117,332,43,2281,933
917,839,600,239,64,158,99,94,111,313,45,2194,884
918,1157,919,238,98,165,127,116,205,446,0,2943,1157
919,365,290,75,31,52,40,37,65,140,0,784,365
920,751,633,118,13,34,122,80,166,336,0,1867,751
921,3225,2608,617,343,473,428,309,564,1108,26,7686,3251
922,2186,1626,560,48,112,301,231,472,1022,12,6446,2198
923,1659,1255,404,25,87,278,148,372,749,2,4879,1661
924,1915,1642,273,33,112,316,196,419,839,0,4618,1915
925,644,510,134,28,69,80,54,120,293,0,1785,644
926,2079,1627,452,188,279,283,227,343,759,0,5509,2079
927,470,370,100,45,69,63,48,79,166,0,1104,470
928,1064,811,253,12,61,168,91,230,502,0,3027,1064
929,0,0,0,0,0,0,0,0,0,3412,0,3412
930,1500,1168,332,17,76,232,116,342,717,13,4031,1513
931,590,538,52,79,80,81,71,81,198,23,1197,613
932,590,481,109,40,55,88,72,105,230,22,1552,612
933,1487,1126,361,26,77,219,147,318,700,13,4024,1500
934,1122,876,246,16,52,175,84,255,540,0,2970,1122
935,1004,844,160,28,78,160,97,193,448,0,2530,1004
936,1486,1144,342,31,106,237,145,300,667,9,3852,1495
937,1197,874,323,44,83,144,144,252,530,0,3067,1197
938,909,705,204,10,50,138,80,215,416,0,2484,909
939,0,0,0,0,0,0,0,0,0,0,0,0
940,959,922,37,19,61,189,88,192,410,404,2562,1363
941,3021,2486,535,40,152,471,290,679,1389,143,7143,3164
942,1600,1299,301,259,359,166,135,220,461,12,4109,1612
943,1055,878,177,75,100,136,130,217,397,0,2316,1055
944,1018,802,216,131,175,123,108,156,325,0,2063,1018
945,4064,3560,504,995,1645,209,308,289,618,26,8523,4090
946,778,665,113,66,88,96,111,134,283,0,1511,778
947,756,663,93,107,125,76,103,111,234,0,1426,756
948,2613,2181,432,429,402,314,233,389,846,20,5613,2633
949,856,750,106,121,142,86,116,125,266,0,2003,856
950,1027,857,170,169,158,123,92,153,332,0,3250,1027
951,1283,1124,159,181,213,129,174,188,398,0,2317,1283
952,3154,2975,179,609,662,305,355,414,809,78,5448,3232
953,0,0,0,0,0,0,0,0,0,0,0,0
954,0,0,0,0,0,0,0,0,0,0,0,0
955,5436,5406,30,1255,615,488,382,597,2099,23,7109,5459
956,1579,1208,371,32,83,251,153,320,740,7,4237,1586
957,1356,1279,77,262,285,131,152,178,348,7,2454,1363
958,336,263,73,30,45,46,37,55,123,0,714,336
959,1064,881,183,152,210,115,100,153,334,0,2141,1064
960,989,919,70,118,125,168,141,188,249,2175,2073,3164
961,593,494,99,42,56,76,73,122,224,0,1552,593
962,624,474,150,36,53,83,58,125,269,0,1511,624
963,718,593,125,28,84,128,66,131,281,1,1906,719
964,832,675,157,91,128,96,98,145,274,0,1853,832
965,971,787,184,107,149,112,115,169,319,0,2412,971
966,584,473,111,64,90,67,69,102,192,13,1479,597
967,692,533,159,14,50,111,67,140,310,0,1540,692
968,679,547,132,89,107,73,67,116,227,0,1687,679
969,1106,923,183,182,170,133,99,165,357,0,2225,1106
970,554,451,103,37,52,83,67,99,216,0,1286,554
971,1306,1038,268,110,186,143,131,232,504,7,2514,1313
972,122,104,18,10,14,15,17,21,45,1,254,123
973,545,466,79,46,61,67,78,94,199,0,1169,545
974,942,742,200,121,162,114,100,145,300,0,2233,942
975,340,298,42,83,138,18,26,24,51,0,712,340
976,1071,894,177,176,165,129,96,160,345,0,2628,1071
977,3017,2376,641,387,520,366,321,463,960,36,6943,3053
978,183,167,16,24,25,25,22,25,62,0,283,183
979,558,469,89,16,43,89,54,107,249,8,1365,566
980,759,693,66,102,103,105,91,104,254,0,1471,759
981,621,567,54,83,85,86,75,85,207,0,1156,621
982,533,436,97,36,65,73,58,102,199,0,1035,533
983,355,290,65,24,43,49,39,68,132,0,904,355
984,1672,1475,197,279,343,149,168,218,515,0,3063,1672
985,924,755,169,62,112,127,101,176,346,0,1966,924
986,1188,1048,140,198,243,106,120,155,366,0,1582,1188
987,1726,1392,334,227,272,185,170,294,578,0,3696,1726
988,1296,1143,153,216,266,115,130,169,400,0,2767,1296
989,859,758,101,143,176,76,86,112,266,2,1885,861
990,368,301,67,25,45,51,40,70,137,21,1075,389
991,0,0,0,0,0,0,0,0,0,0,0,0
992,816,596,220,30,56,98,98,172,362,6,1883,822
993,512,424,88,73,101,55,48,74,161,0,1258,512
994,415,318,97,18,36,59,37,76,189,0,1014,415
995,481,369,112,21,42,69,43,88,218,0,1233,481
996,251,192,59,11,22,36,22,46,114,0,610,251
997,244,187,57,11,21,35,22,45,110,0,604,244
998,688,649,39,133,144,67,77,90,177,25,1849,713
999,482,405,77,13,37,77,46,92,217,0,1222,482
1000,0,0,0,0,0,0,0,0,0,0,0,0
1001,1126,932,194,161,222,122,106,162,353,0,1919,1126
1002,385,295,90,8,20,61,37,78,181,0,1117,385
1003,464,353,111,5,27,73,40,100,219,0,1341,464
1004,423,322,101,5,24,67,36,91,200,16,1261,439
1005,1409,1115,294,60,150,176,118,263,642,0,3491,1409
1006,568,432,136,33,49,76,53,114,243,0,1493,568
1007,706,537,169,41,60,94,66,141,304,93,1741,799
1008,524,412,112,51,77,71,54,88,183,0,1170,524
1009,451,329,122,16,31,54,54,95,201,0,1179,451
1010,1534,1273,261,203,459,133,76,162,501,5,3792,1539
1011,1454,1446,8,336,165,130,102,160,561,0,3257,1454
1012,0,0,0,0,0,0,0,0,0,0,0,0
1013,3431,2649,782,211,218,453,481,606,1462,30,9115,3461
1014,1438,1085,353,41,58,182,249,227,681,0,3709,1438
1015,2018,1504,514,167,97,273,322,320,839,4,5275,2022
1016,1297,953,344,129,52,187,218,197,514,0,3328,1297
1017,942,726,216,52,40,142,164,130,414,11,2295,953
1018,177,139,38,20,16,24,25,25,67,0,497,177
1019,1336,1049,287,153,120,185,190,187,501,0,3412,1336
1020,3243,2752,491,667,449,537,359,435,796,21,7628,3264
1021,4121,3625,496,393,648,485,440,706,1449,9,8200,4130
1022,8557,6188,2369,947,1311,1186,1031,1374,2708,0,18889,8557
1023,4309,3735,574,776,697,775,566,539,956,0,9177,4309
1024,878,501,377,48,91,176,74,171,318,55,3099,933
1025,1802,1287,515,140,231,245,211,336,639,13,4598,1815
1026,873,635,238,52,107,140,117,149,308,2,2443,875
1027,2559,1991,568,208,358,387,299,487,820,0,5841,2559
1028,3664,2728,936,263,490,512,466,688,1245,13,8905,3677
1029,1377,903,474,91,120,283,156,243,484,0,3677,1377
1030,1342,1092,250,121,128,220,162,226,485,43,2976,1385
1031,1825,1387,438,205,238,289,236,321,536,0,4287,1825
1032,3269,2352,917,570,425,507,371,474,922,72,8064,3341
1033,2656,2110,546,159,158,408,437,438,1056,28,6737,2684
1034,1086,902,184,47,62,160,168,192,457,26,2772,1112
1035,4470,3839,631,1255,1054,435,361,443,922,11,11441,4481
1036,968,810,158,121,101,145,121,156,324,0,1815,968
1037,604,480,124,48,43,94,75,102,242,0,1205,604
1038,1658,1088,570,99,128,306,202,317,606,0,4619,1658
1039,1852,1561,291,964,759,35,26,13,55,0,10776,1852
1040,1631,1129,502,127,213,240,190,285,576,0,3394,1631
1041,17525,14020,3505,2424,2164,1756,1248,2580,7353,19,31410,17544
1042,514,430,84,46,37,60,55,100,216,0,1095,514
1043,4769,3355,1414,1978,1643,294,102,212,540,0,11462,4769
1044,1287,922,365,540,191,137,93,150,176,0,2477,1287
1045,2377,1447,930,727,1144,47,167,101,191,0,5713,2377
1046,31833,28914,2919,4027,5507,2747,2566,4998,11988,47,60072,31880
1047,4174,2822,1352,634,899,436,397,576,1232,0,13722,4174
1048,299,220,79,62,117,19,15,29,57,6,814,305
1049,907,665,242,98,89,141,122,160,297,19,3112,926
1050,0,0,0,0,0,0,0,0,0,0,0,0
1051,8523,7478,1045,1005,1454,544,710,1242,3568,0,18266,8523
1052,4126,2589,1537,1234,2049,437,179,189,38,0,7547,4126
1053,4,4,0,0,1,2,0,0,1,0,8,4
1054,4678,2804,1874,831,994,311,286,607,1649,0,11244,4678
1055,5119,3744,1375,627,801,940,627,766,1358,0,11252,5119
1056,2120,1274,846,127,216,180,268,443,886,0,7341,2120
1057,2504,2213,291,420,536,331,309,298,610,0,5851,2504
1058,976,630,346,51,131,166,121,184,323,606,3444,1582
1059,240,154,86,21,40,36,31,41,71,0,735,240
1060,2070,1418,652,161,256,324,261,417,651,0,5301,2070
1061,1378,1033,345,66,110,176,153,277,596,0,3161,1378
1062,1935,1465,470,146,283,257,240,347,662,30,4815,1965
1063,1837,1472,365,107,211,256,221,349,693,49,4538,1886
1064,1627,1263,364,192,165,232,203,281,554,0,3144,1627
1065,1147,891,256,135,117,164,143,198,390,0,3097,1147
1066,2832,1760,1072,389,574,198,126,418,1127,0,3430,2832
1067,37,25,12,6,8,4,4,5,10,0,76,37
1068,7790,5267,2523,1183,1679,814,741,1075,2298,0,13206,7790
1069,2163,1690,473,233,311,329,255,343,692,0,4611,2163
1070,6490,4388,2102,985,1399,678,617,896,1915,0,23782,6490
1071,1249,890,359,114,187,134,127,192,495,0,3643,1249
1072,717,511,206,65,107,77,73,110,285,0,1420,717
1073,1298,1122,176,182,126,185,190,190,425,0,1743,1298
1074,498,373,125,24,40,64,55,100,215,9,1182,507
1075,733,549,184,35,58,94,82,147,317,17,1907,750
1076,341,256,85,16,27,44,38,69,147,0,918,341
1077,2390,1942,448,1046,1195,50,0,16,83,0,5433,2390
1078,232,210,22,24,23,31,32,40,82,0,397,232
1079,305,222,83,18,37,49,41,52,108,0,911,305
1080,602,490,112,54,57,99,73,101,218,4,1554,606
1081,1574,1374,200,235,291,143,132,249,524,0,3537,1574
1082,414,266,148,37,69,62,54,71,121,0,1225,414
1083,225,145,80,20,37,34,29,38,67,0,604,225
1084,735,631,104,206,173,72,59,73,152,0,1594,735
1085,536,352,184,35,47,110,61,94,189,77,1565,613
1086,567,372,195,37,50,116,64,100,200,0,1715,567
1087,774,566,208,80,103,124,96,129,242,0,1608,774
1088,1106,879,227,88,78,173,138,187,442,0,2577,1106
1089,522,415,107,41,37,81,65,88,210,0,1166,522
1090,693,507,186,71,92,111,86,115,218,26,1826,719
1091,614,488,126,49,43,96,77,104,245,0,1447,614
1092,361,325,36,101,80,34,30,33,83,0,833,361
1093,4381,3153,1228,1589,2402,118,81,105,86,0,17799,4381
1094,942,671,271,86,141,101,96,145,373,0,2290,942
1095,4095,3372,723,574,523,596,665,743,994,26,9402,4121
1096,1274,1012,262,101,90,199,159,215,510,0,2411,1274
1097,823,742,81,230,183,78,68,76,188,9,2031,832
1098,3319,2991,328,927,736,315,274,307,760,0,6042,3319
1099,635,507,128,111,146,77,47,73,181,228,1748,863
1100,551,440,111,96,127,67,41,63,157,0,1406,551
1101,1139,910,229,199,262,139,84,130,325,0,2583,1139
1102,500,418,82,62,52,75,62,80,169,0,1171,500
1103,309,240,69,36,31,44,38,53,107,0,811,309
1104,565,473,92,71,59,84,71,91,189,0,1533,565
1105,994,688,306,77,130,146,116,173,352,19,2327,1013
1106,554,464,90,50,40,65,59,107,233,0,1261,554
1107,277,232,45,25,20,33,29,54,116,0,477,277
1108,125,106,19,26,17,21,14,17,30,0,262,125
1109,1091,856,235,125,98,151,155,153,409,15,2669,1106
1110,1722,881,841,79,104,398,196,303,642,17,5434,1739
1111,598,521,77,66,75,88,80,94,195,185,1139,783
1112,5,5,0,1,0,1,0,1,2,0,10,5
1113,18952,13960,4992,3900,7408,1207,961,1869,3607,0,59723,18952
1114,1394,897,497,124,231,209,181,237,412,13,4036,1407
1115,441,342,99,52,45,63,55,76,150,0,1081,441
1116,0,0,0,0,0,0,0,0,0,0,0,0
1117,885,765,120,124,86,126,130,130,289,15,1346,900
1118,1551,1340,211,217,151,221,227,227,508,0,3922,1551
1119,2212,1666,546,162,130,275,309,449,887,43,5503,2255
1120,2237,1442,795,170,300,230,301,422,814,0,6321,2237
1121,1127,739,388,20,66,175,199,209,458,0,2999,1127
1122,1439,938,501,30,95,191,230,233,660,26,4140,1465
1123,4648,3348,1300,785,581,413,461,780,1628,34,12683,4682
1124,1204,995,209,154,137,164,154,158,437,0,2321,1204
1125,3078,2269,809,247,295,426,455,504,1151,0,7985,3078
1126,2443,1561,882,315,417,380,357,357,617,47,6081,2490
1127,2201,1669,532,285,399,332,324,305,556,202,5165,2403
1128,3638,3128,510,653,432,518,532,508,995,17,7391,3655
1129,2481,2025,456,442,467,363,409,275,525,0,5502,2481
1130,1395,969,426,85,153,206,239,210,502,0,3743,1395
1131,7116,4903,2213,1010,1778,832,1025,711,1760,60,18702,7176
1132,1602,1048,554,124,144,224,269,268,573,0,4393,1602
1133,2235,1527,708,188,159,328,340,379,841,60,6555,2295
1134,2958,2225,733,138,154,356,427,614,1269,34,7354,2992
1135,1928,1456,472,27,149,269,256,460,767,73,5111,2001
1136,1403,1073,330,15,93,199,193,353,550,0,3581,1403
1137,2760,2101,659,77,176,360,415,605,1127,0,7507,2760
1138,3211,2797,414,181,124,429,413,712,1352,365,6707,3576
1139,1152,885,267,34,68,151,158,291,450,378,2993,1530
1140,1272,1011,261,78,74,170,166,307,477,0,2996,1272
1141,990,736,254,28,62,131,124,225,420,0,2454,990
1142,2753,2194,559,156,289,357,358,529,1064,43,6732,2796
1143,1168,923,245,26,74,147,169,247,505,0,3136,1168
1144,1497,1167,330,96,128,181,224,295,573,103,3804,1600
1145,1988,1497,491,49,112,241,268,453,865,0,5197,1988
1146,1151,816,335,43,82,118,156,260,492,0,2869,1151
1147,2068,1398,670,52,102,224,282,459,949,0,5603,2068
1148,3090,2354,736,124,229,372,432,625,1308,69,8275,3159
1149,2981,1928,1053,356,148,306,354,568,1249,0,8543,2981
1150,1784,1150,634,39,88,166,279,402,810,0,4877,1784
1151,1609,1079,530,54,84,222,270,249,730,0,4553,1609
1152,2273,1588,685,185,118,331,410,334,895,0,6218,2273
1153,4150,3133,1017,485,288,456,457,789,1675,60,9981,4210
1154,2842,1911,931,177,265,301,418,601,1080,150,8172,2992
1155,3950,3103,847,884,601,255,267,515,1428,9,9554,3959
1156,3524,2893,631,331,490,510,407,631,1155,34,7211,3558
1157,1861,1483,378,107,225,263,225,390,651,95,4397,1956
1158,2894,2367,527,268,450,384,322,559,911,0,6693,2894
1159,2536,1913,623,184,297,381,392,411,871,17,6465,2553
1160,8686,6549,2137,1414,1444,947,1399,835,2647,0,22311,8686
1161,2667,2021,646,296,245,411,369,412,934,0,5949,2667
1162,1084,828,256,132,155,145,126,169,357,99,2035,1183
1163,2371,1509,862,359,399,386,347,310,570,0,6612,2371
1164,5549,4020,1529,828,1348,466,570,606,1731,0,13990,5549
1165,1546,1093,453,134,85,257,255,258,557,47,3761,1593
1166,1619,1162,457,128,209,256,275,258,493,0,4162,1619
1167,1491,1148,343,144,186,208,240,222,491,56,3921,1547
1168,2366,1661,705,54,157,347,323,557,928,137,6611,2503
1169,1216,1023,193,75,54,169,170,256,492,4,2459,1220
1170,1965,1658,307,122,102,276,238,445,782,0,4496,1965
1171,1958,1449,509,37,121,213,278,446,863,26,5344,1984
1172,2038,1465,573,43,107,216,300,489,883,4,5275,2042
1173,1672,1283,389,72,68,201,222,417,692,86,4272,1758
1174,2320,1844,476,345,394,317,315,344,605,73,5300,2393
1175,3281,2503,778,107,279,466,441,742,1246,133,7297,3414
1176,2904,2332,572,261,337,295,360,407,1244,43,6974,2947
1177,1729,1300,429,82,164,256,213,335,679,133,4041,1862
1178,1691,1210,481,110,215,262,209,315,580,176,4625,1867
1179,2117,1467,650,148,219,331,358,324,737,47,5402,2164
1180,1779,1198,581,41,127,234,231,399,747,0,5001,1779
1181,58,51,7,7,13,11,7,8,12,0,155,58
1182,867,504,363,51,75,109,143,183,306,43,3200,910
1183,846,324,522,55,81,123,147,159,281,11,4145,857
1184,1095,607,488,69,125,185,178,154,384,58,3974,1153
1185,518,283,235,31,59,95,81,87,165,48,2191,566
1186,725,436,289,148,233,108,76,68,92,114,2054,839
1187,2330,1560,770,324,470,388,348,351,449,87,6704,2417
1188,245,227,18,32,42,46,38,30,57,90,687,335
1189,764,548,216,137,152,137,114,103,121,27,2201,791
1190,3477,2490,987,448,530,562,405,547,985,100,8875,3577
1191,1520,1315,205,149,180,245,195,257,494,0,2949,1520
1192,1194,1063,131,53,85,192,151,245,468,9,2555,1203
1193,2227,1710,517,145,254,364,303,393,768,40,5463,2267
1194,646,375,271,138,142,100,74,75,117,53,1898,699
1195,3602,2221,1381,527,969,507,339,470,790,36,8876,3638
1196,581,256,325,40,50,71,112,103,205,22,2307,603
1197,3075,1780,1295,446,729,501,402,390,607,138,10132,3213
1198,1029,839,190,214,248,135,118,128,186,4,1632,1033
1199,2025,1617,408,240,347,342,197,315,584,58,4761,2083
1200,3349,2767,582,502,763,492,404,451,737,0,7046,3349
1201,2553,2127,426,212,341,362,328,447,863,15,5610,2568
1202,621,506,115,39,64,96,85,114,223,2,1458,623
1203,2055,1682,373,130,186,327,282,384,746,24,5080,2079
1204,5871,5100,771,865,1006,655,621,899,1825,30,11456,5901
1205,1089,886,203,110,173,173,118,198,317,0,2605,1089
1206,572,266,306,79,96,100,95,79,123,7,2158,579
1207,2021,1534,487,251,346,339,271,309,505,11,4922,2032
1208,3147,2401,746,175,299,461,404,614,1194,47,7919,3194
1209,1949,1596,353,113,170,317,272,375,702,12,4861,1961
1210,1617,1362,255,103,159,303,205,262,585,30,3631,1647
1211,2542,1346,1196,281,428,418,336,408,671,0,8268,2542
1212,1046,389,657,168,304,154,116,118,186,0,4366,1046
1213,1065,459,606,86,148,195,173,151,312,85,4778,1150
1214,1009,928,81,154,205,153,113,159,225,191,2467,1200
1215,558,454,104,35,57,86,77,102,201,15,1315,573
1216,953,702,251,244,309,91,77,82,150,79,1606,1032
1217,1792,1320,472,459,582,170,145,155,281,575,5420,2367
1218,1623,806,817,287,417,284,227,192,216,0,4384,1623
1219,775,652,123,116,132,100,98,110,219,0,1972,775
1220,2626,2210,416,394,447,340,331,373,741,0,5090,2626
1221,253,207,46,51,50,49,36,34,33,4426,714,4679
1222,1558,1403,155,534,718,100,63,58,85,78,2842,1636
1223,2385,2117,268,269,548,462,295,323,488,0,4983,2385
1224,2137,1890,247,557,383,303,260,247,387,24,7817,2161
1225,453,309,144,47,68,78,56,71,133,0,1490,453
1226,459,313,146,47,69,79,56,72,136,104,1462,563
1227,1995,1765,230,520,357,283,243,231,361,4,3055,1999
1228,861,663,198,133,158,139,124,122,185,24,1949,885
1229,2133,1571,562,546,692,203,173,184,335,1,5162,2134
1230,920,454,466,143,237,146,109,105,180,0,3035,920
1231,2115,1325,790,356,424,336,319,263,417,36,6372,2151
1232,497,333,164,69,100,83,74,75,96,0,1634,497
1233,787,640,147,79,125,125,85,143,230,0,1764,787
1234,1192,614,578,212,256,162,194,154,214,0,4103,1192
1235,409,203,206,72,105,71,57,48,56,315,1448,724
1236,3138,2813,325,760,715,464,433,339,427,67,6755,3205
1237,340,278,62,68,67,66,49,45,45,0,853,340
1238,390,280,110,70,78,70,58,52,62,32,861,422
1239,1166,897,269,181,214,189,168,165,249,1,3370,1167
1240,2811,1692,1119,704,1079,282,268,192,286,58,9084,2869
1241,469,345,124,120,152,45,38,41,73,413,1198,882
1242,412,337,75,26,37,66,56,77,150,0,1014,412
1243,1965,1679,286,287,433,233,194,297,521,2005,4724,3970
1244,517,421,96,32,53,80,71,95,186,0,1172,517
1245,427,348,79,27,44,66,59,78,153,0,1027,427
1246,445,362,83,28,46,69,61,82,159,0,977,445
1247,514,439,75,75,113,61,51,78,136,2,1136,516
1248,297,242,55,18,30,46,41,54,108,0,714,297
1249,497,219,278,34,43,61,96,88,175,10,2073,507
1250,1043,850,193,217,251,136,120,130,189,0,2719,1043
1251,421,287,134,43,63,72,52,66,125,0,1025,421
1252,261,242,19,34,45,49,40,32,61,591,714,852
1253,427,292,135,44,64,73,52,67,127,0,1068,427
1254,493,245,248,87,127,86,69,58,66,31,1871,524
1255,300,149,151,57,92,24,41,33,53,0,1408,300
1256,1891,1138,753,387,609,282,199,178,236,53,6788,1944
1257,243,78,165,28,40,33,34,39,69,9,963,252
1258,400,128,272,46,65,54,56,65,114,0,1524,400
1259,1808,1526,282,287,347,259,178,264,473,67,3138,1875
1260,231,115,116,41,59,40,32,27,32,0,899,231
1261,824,591,233,148,164,147,123,111,131,156,2237,980
1262,562,403,159,101,112,101,84,76,88,129,1603,691
1263,1178,845,333,211,235,211,176,159,186,0,3905,1178
1264,532,248,284,74,89,93,89,74,113,56,1891,588
1265,723,435,288,181,277,73,69,49,74,0,2293,723
1266,1190,716,474,298,457,119,114,81,121,0,3817,1190
1267,759,435,324,109,149,142,102,96,161,20,3299,779
1268,603,192,411,69,99,81,85,98,171,0,2520,603
1269,1002,575,427,144,197,188,135,127,211,0,3113,1002
1270,453,368,85,46,72,72,49,82,132,0,1137,453
1271,623,526,97,99,119,89,61,91,164,14,1323,637
1272,600,495,105,69,69,104,76,103,179,64,1267,664
1273,528,489,39,69,91,99,82,65,122,411,1540,939
1274,546,360,186,87,99,90,74,75,121,0,1697,546
1275,296,274,22,39,51,56,46,36,68,32,810,328
1276,399,263,136,64,73,66,54,55,87,0,1036,399
1277,188,124,64,30,34,31,26,26,41,11,614,199
1278,1226,944,282,190,225,198,176,173,264,363,2587,1589
1279,446,294,152,71,81,73,61,61,99,5,1423,451
1280,407,245,162,102,156,41,39,28,41,0,1099,407
1281,605,422,183,109,179,79,64,72,102,0,1725,605
1282,556,274,282,86,143,88,66,64,109,133,2124,689
1283,1002,699,303,180,296,132,107,119,168,0,2147,1002
1284,591,530,61,143,135,87,82,64,80,0,1478,591
1285,0,0,0,0,0,0,0,0,0,0,0,0
1286,1056,947,109,256,241,156,146,114,143,196,2472,1252
1287,478,388,90,113,117,83,55,52,58,36,986,514
1288,595,458,137,92,109,96,86,84,128,9,1667,604
1289,2240,1816,424,529,549,389,259,244,270,69,4514,2309
1290,979,794,185,231,240,170,113,107,118,1,1530,980
1291,443,359,84,105,109,77,51,48,53,0,777,443
1292,553,448,105,131,136,96,64,60,66,12,1298,565
1293,2555,2370,185,644,673,384,298,275,281,26,4201,2581
1294,1092,1013,79,275,288,164,127,118,120,119,2111,1211
1295,553,467,86,88,106,79,55,81,144,0,1160,553
1296,504,383,121,117,205,39,41,41,61,125,1057,629
1297,416,344,72,48,48,72,52,71,125,59,998,475
1298,195,112,83,28,38,37,26,25,41,0,757,195
1299,601,496,105,52,84,98,77,115,175,0,1490,601
1300,781,645,136,67,110,127,100,149,228,69,2458,850
1301,495,409,86,43,70,81,64,95,142,0,1206,495
1302,275,158,117,39,54,52,37,35,58,2,929,277
1303,794,394,400,151,245,62,109,86,141,16,2856,810
1304,423,349,74,36,59,69,54,81,124,0,1173,423
1305,412,379,33,63,84,62,46,65,92,1367,842,1779
1306,151,134,17,17,35,29,19,20,31,0,402,151
1307,1317,1169,148,149,302,255,163,178,270,0,2971,1317
1308,3678,3253,425,959,658,522,447,425,667,0,3689,3678
1309,5623,3082,2541,1026,995,950,762,765,1125,72,21801,5695
1310,6855,3372,3483,984,1290,836,858,902,1985,36,29638,6891
1311,1050,723,327,28,43,133,204,201,441,9,3581,1059
1312,3120,1632,1488,143,252,389,499,708,1129,52,12779,3172
1313,1777,839,938,57,98,243,316,395,668,243,6725,2020
1314,3221,1642,1579,59,139,462,505,736,1320,94,12005,3315
1315,1086,590,496,32,87,148,165,213,441,56,4624,1142
1316,1012,591,421,21,52,136,169,221,413,97,3970,1109
1317,883,510,373,18,48,119,166,190,342,29,3336,912
1318,1059,483,576,28,67,127,158,269,410,56,3999,1115
1319,1920,1212,708,242,298,228,228,333,591,18,6220,1938
1320,1496,886,610,43,63,198,172,342,678,43,5110,1539
1321,686,527,159,65,62,69,98,132,260,0,1686,686
1322,3299,2133,1166,221,312,340,247,689,1490,13,11134,3312
1323,490,303,187,16,27,70,50,112,215,0,1530,490
1324,748,430,318,25,36,92,89,176,330,0,2616,748
1325,1255,645,610,58,70,184,155,275,513,23,4641,1278
1326,1397,867,530,70,78,183,148,309,609,14,4310,1411
1327,1220,730,490,182,120,158,127,188,445,23,4359,1243
1328,1677,1066,611,166,172,238,169,313,619,18,5663,1695
1329,286,224,62,62,107,15,18,23,61,0,741,286
1330,3622,2791,831,637,1201,183,281,359,961,0,10099,3622
1331,1948,1086,862,276,261,379,253,280,499,41,6975,1989
1332,1260,774,486,37,55,171,213,283,501,0,4214,1260
1333,3886,3494,392,140,245,642,586,865,1408,13,8418,3899
1334,1180,666,514,22,48,170,188,258,494,87,4547,1267
1335,920,309,611,89,89,176,115,169,282,9,4349,929
1336,1139,526,613,267,304,151,133,92,192,14,5406,1153
1337,1164,393,771,101,118,189,194,207,355,11,5890,1175
1338,410,130,280,47,30,75,60,60,138,20,2660,430
1339,865,386,479,24,43,138,109,201,350,0,3820,865
1340,873,433,440,51,86,141,120,180,295,0,3707,873
1341,1627,795,832,299,345,312,185,177,309,20,7098,1647
1342,434,221,213,54,87,98,51,62,82,0,1787,434
1343,1850,1313,537,122,178,266,259,328,697,54,5944,1904
1344,1367,661,706,231,203,240,152,198,343,0,6173,1367
1345,1794,1282,512,96,141,268,296,320,673,43,5284,1837
1346,579,399,180,46,61,77,55,114,226,0,1698,579
1347,1263,747,516,46,69,193,146,283,526,56,4574,1319
1348,840,541,299,57,72,138,94,178,301,61,2772,901
1349,1798,857,941,33,85,250,268,450,712,0,7029,1798
1350,1427,853,574,45,66,210,197,337,572,38,4736,1465
1351,4079,2266,1813,95,215,562,662,938,1607,50,13472,4129
1352,1215,461,754,199,179,199,167,167,304,20,5806,1235
1353,1250,500,750,58,82,246,144,275,445,13,6178,1263
1354,1249,562,687,101,158,213,146,228,403,41,5362,1290
1355,213,121,92,35,33,44,24,26,51,4,862,217
1356,861,307,554,140,111,154,107,129,220,0,3718,861
1357,2412,1667,745,555,417,462,243,296,439,0,6444,2412
1358,202,118,84,35,28,35,27,24,53,0,728,202
1359,2226,1473,753,106,187,375,386,407,765,128,7849,2354
1360,1353,864,489,69,118,161,250,260,495,29,4403,1382
1361,2341,1418,923,164,258,393,372,408,746,94,8391,2435
1362,1491,785,706,120,232,261,197,256,425,0,5938,1491
1363,1017,566,451,67,79,180,135,193,363,705,3958,1722
1364,1301,662,639,57,110,227,200,239,468,13,5711,1314
1365,1677,1334,343,58,77,221,284,361,676,41,4880,1718
1366,1519,1149,370,42,70,217,266,319,605,40,4684,1559
1367,1484,1128,356,75,96,244,231,282,556,4,4069,1488
1368,744,522,222,105,180,75,69,99,216,0,1755,744
1369,1978,1200,778,60,117,286,223,487,805,40,6209,2018
1370,714,452,262,54,54,97,83,141,285,27,2396,741
1371,1243,620,623,48,59,196,139,268,533,0,4573,1243
1372,1506,923,583,50,85,198,131,379,663,4,5119,1510
1373,1367,822,545,133,101,188,162,245,538,11,4971,1378
1374,2346,1720,626,223,208,288,282,450,895,0,7189,2346
1375,2259,1586,673,320,546,228,210,301,654,0,6549,2259
1376,315,210,105,46,56,32,44,53,84,0,1078,315
1377,252,160,92,31,28,25,18,41,109,16,808,268
1378,586,286,300,108,124,112,67,64,111,151,2101,737
1379,100,54,46,25,37,14,6,9,9,2,294,102
1380,96,52,44,24,36,13,6,9,8,0,262,96
1381,1795,1260,535,254,434,181,167,239,520,0,5426,1795
1382,686,430,256,55,63,100,79,140,249,31,2672,717
1383,2879,2021,858,407,696,290,268,383,835,0,6817,2879
1384,507,311,196,51,59,63,57,101,176,0,1690,507
1385,3288,2534,754,578,1090,166,255,326,873,40,7832,3328
1386,572,326,246,95,89,119,63,71,135,0,1958,572
1387,1878,1014,864,466,703,254,117,174,164,0,6391,1878
1388,517,301,216,91,72,89,70,62,133,14,1762,531
1389,1353,688,665,167,273,304,159,193,257,169,5517,1522
1390,453,258,195,75,70,94,50,56,108,0,1721,453
1391,337,171,166,42,68,76,39,48,64,0,1213,337
1392,799,542,257,158,205,127,74,93,142,54,2596,853
1393,349,237,112,69,89,56,33,40,62,189,1070,538
1394,581,359,222,18,31,83,60,133,256,23,1921,604
1395,695,427,268,70,81,87,79,139,239,18,2476,713
1396,594,399,195,82,123,114,65,100,110,54,1979,648
1397,5921,3977,1944,816,1223,1138,645,999,1100,0,18762,5921
1398,633,408,225,71,122,102,92,122,124,34,2025,667
1399,549,344,205,44,51,80,63,112,199,27,1987,576
1400,244,154,90,18,18,33,28,48,99,0,797,244
1401,4903,3117,1786,599,540,485,355,800,2124,0,14149,4903
1402,432,273,159,33,33,58,50,85,173,18,1598,450
1403,787,552,235,111,190,79,73,105,229,94,2524,881
1404,1703,1175,528,136,179,225,161,336,666,2,5062,1705
1405,802,510,292,98,88,79,58,131,348,13,2416,815
1406,1048,704,344,144,217,201,114,177,195,11,3571,1059
1407,298,199,99,43,53,31,41,50,80,0,858,298
1408,868,599,269,69,91,115,82,171,340,0,2015,868
1409,189,148,41,41,70,10,12,15,41,0,660,189
1410,3165,2439,726,557,1050,160,246,314,838,0,7862,3165
1411,2680,1767,913,216,308,421,421,458,856,43,6986,2723
1412,1218,873,345,32,54,184,211,233,504,0,3343,1218
1413,2864,1940,924,66,112,457,586,482,1161,0,7730,2864
1414,1948,1420,528,133,176,323,280,349,687,10,4656,1958
1415,1751,1142,609,35,69,275,351,319,702,3,4931,1754
1416,2093,1552,541,55,94,314,354,385,891,36,5748,2129
1417,1101,610,491,46,79,161,172,250,393,0,2817,1101
1418,1089,818,271,29,42,184,194,221,419,0,2977,1089
1419,928,705,223,20,40,163,151,176,378,0,2603,928
1420,1443,1036,407,33,59,217,267,259,608,17,4014,1460
1421,3239,2090,1149,359,1031,324,278,477,770,40,9215,3279
1422,1853,1209,644,133,200,262,226,385,647,50,5760,1903
1423,755,363,392,102,158,96,119,114,166,1,2681,756
1424,1990,1290,700,95,281,279,292,373,670,40,5640,2030
1425,1826,1100,726,148,263,291,234,314,576,15,4819,1841
1426,1472,1003,469,81,150,228,198,310,505,0,4169,1472
1427,401,269,132,23,39,71,53,82,133,25,1162,426
1428,984,649,335,52,88,150,170,154,370,0,2647,984
1429,702,417,285,57,91,112,101,141,200,10,2300,712
1430,1148,790,358,198,365,106,114,126,239,32,2882,1180
1431,1393,892,501,125,153,197,209,238,471,0,4153,1393
1432,1869,1243,626,118,178,250,295,349,679,43,5457,1912
1433,4955,3723,1232,744,1124,585,800,547,1155,104,12728,5059
1434,1562,851,711,137,209,198,266,292,460,26,5957,1588
1435,746,513,233,57,129,95,95,151,219,0,2194,746
1436,2144,1474,670,225,563,273,273,310,500,40,5753,2184
1437,935,636,299,28,93,135,119,217,343,25,2653,960
1438,7803,5844,1959,1287,1645,991,1044,838,1998,0,21014,7803
1439,2523,1649,874,261,461,300,342,408,751,26,7686,2549
1440,948,580,368,60,75,146,119,198,350,0,2756,948
1441,1382,856,526,61,112,200,202,320,487,14,4088,1396
1442,1637,1123,514,59,155,239,243,347,594,31,4332,1668
1443,2028,1534,494,102,184,311,275,448,708,10,4821,2038
1444,1309,1010,299,52,80,213,189,257,518,92,3497,1401
1445,1333,971,362,26,91,174,164,327,551,126,3468,1459
1446,2317,1658,659,49,162,337,326,548,895,47,6423,2364
1447,1532,1168,364,90,170,263,206,291,512,14,3440,1546
1448,1798,1254,544,38,125,264,224,441,706,0,4888,1798
1449,553,306,247,23,40,81,86,125,198,18,1962,571
1450,265,147,118,11,19,39,41,60,95,1,828,266
1451,430,238,192,18,31,63,67,98,153,0,1511,430
1452,339,233,106,26,58,43,43,69,100,14,1042,353
1453,1545,742,803,209,323,197,243,233,340,15,5789,1560
1454,4206,2893,1313,727,1337,387,416,461,878,0,13731,4206
1455,304,224,80,29,54,41,36,59,85,18,1169,322
1456,1357,1001,356,131,239,184,161,264,378,0,3396,1357
1457,1800,1028,772,28,101,210,272,445,744,33,5554,1833
1458,800,475,325,64,104,127,116,160,229,10,2394,810
1459,357,239,118,21,34,63,47,73,119,0,585,357
1460,452,303,149,26,44,80,60,92,150,38,1354,490
1461,1699,1110,589,176,310,202,230,275,506,29,4299,1728
1462,478,320,158,28,46,84,63,97,160,10,1340,488
1463,703,519,184,68,124,95,83,137,196,72,1957,775
1464,580,316,264,51,78,73,99,109,170,14,2196,594
1465,534,367,167,41,92,68,68,108,157,0,1219,534
1466,600,388,212,28,67,90,86,136,193,25,2021,625
1467,1018,658,360,47,114,153,146,231,327,28,2796,1046
1468,309,200,109,14,34,46,44,70,101,33,899,342
1469,1413,993,420,88,129,206,234,281,475,3,3889,1416
1470,2077,1162,915,146,274,362,347,397,551,184,7158,2261
1471,547,331,216,49,33,90,68,118,189,66,1667,613
1472,1450,957,493,89,143,222,227,292,477,3,4206,1453
1473,1433,1082,351,44,104,214,222,288,561,0,3570,1433
1474,2899,1890,1009,95,239,401,495,606,1063,95,9040,2994
1475,323,215,108,33,34,45,45,70,96,15,1016,338
1476,2604,1500,1104,56,193,375,500,579,901,0,8062,2604
1477,1340,757,583,215,300,208,170,194,253,596,4802,1936
1478,3710,2299,1411,249,375,620,542,748,1176,47,10261,3757
1479,550,331,219,25,42,92,78,130,183,0,1658,550
1480,1832,1221,611,78,114,280,280,402,678,0,5236,1832
1481,798,561,237,73,85,123,119,154,244,26,2680,824
1482,548,376,172,47,63,93,81,105,159,10,1532,558
1483,432,339,93,26,32,68,57,79,170,19,956,451
1484,1138,697,441,165,252,124,163,154,280,0,3094,1138
1485,650,422,228,88,123,99,89,98,153,0,1882,650
1486,940,575,365,136,208,103,134,128,231,60,2768,1000
1487,254,155,99,37,56,28,36,34,63,15,888,269
1488,247,160,87,33,47,38,34,37,58,10,754,257
1489,825,535,290,111,156,125,113,124,196,0,2572,825
1490,637,413,224,86,120,97,87,96,151,27,1651,664
1491,682,480,202,63,72,105,101,132,209,221,2284,903
1492,2297,1406,891,333,509,251,328,312,564,0,6170,2297
1493,198,90,108,48,60,23,26,21,20,81,584,279
1494,625,387,238,42,63,104,91,126,199,8,2024,633
1495,436,198,238,106,132,51,56,46,45,18,1801,454
1496,188,85,103,46,57,22,24,20,19,0,551,188
1497,688,313,375,167,208,80,89,73,71,16,2857,704
1498,356,214,142,16,27,60,51,84,118,3,1191,359
1499,1404,934,470,141,146,197,196,304,420,11,4893,1415
1500,1330,935,395,83,122,194,220,265,446,0,3423,1330
1501,324,210,114,44,61,49,44,49,77,27,1099,351
1502,2842,1292,1550,689,859,330,367,303,294,31,11268,2873
1503,527,362,165,45,61,89,78,101,153,18,1787,545
1504,799,518,281,108,151,121,109,120,190,108,2148,907
1505,610,345,265,98,137,95,78,89,113,191,2093,801
1506,792,544,248,68,92,134,117,152,229,37,2458,829
1507,305,139,166,74,92,35,39,32,33,10,1126,315
1508,559,384,175,48,65,94,83,108,161,0,1458,559
1509,1004,830,174,128,114,137,128,132,365,52,2469,1056
1510,1316,1088,228,168,149,180,168,173,478,0,2444,1316
1511,625,517,108,80,71,85,80,82,227,0,1434,625
1512,2821,2156,665,342,403,378,327,439,932,0,6572,2821
1513,444,356,88,40,51,45,55,62,191,0,1073,444
1514,349,280,69,31,40,35,43,49,151,0,888,349
1515,416,334,82,37,48,42,52,58,179,0,903,416
1516,1137,800,337,472,392,70,24,50,129,0,2733,1137
1517,9114,6162,2952,1384,1964,952,867,1258,2689,0,13545,9114
1518,63,31,32,11,16,11,9,7,9,1,118,64
1519,3018,2669,349,787,540,428,367,349,547,1,6206,3019
1520,93,84,9,32,43,6,4,3,5,2,232,95
1521,2095,1594,501,488,854,164,172,170,247,166,4687,2261
1522,1689,1521,168,579,779,108,68,63,92,5,6162,1694
1523,3080,2511,569,639,742,403,354,383,559,2,5551,3082
1524,644,525,119,134,155,84,74,80,117,0,2349,644
1525,0,0,0,0,0,0,0,0,0,0,0,0
1526,1064,867,197,221,256,139,122,132,194,0,1764,1064
1527,1893,1486,407,412,706,102,120,149,404,0,6320,1893
1528,1559,1224,335,339,581,84,99,123,333,0,2610,1559
1529,2194,1395,799,268,242,217,159,358,950,0,9502,2194
1530,2395,2038,357,834,485,417,297,188,174,2,2996,2397
1531,1933,1551,382,336,560,173,233,231,400,0,4402,1933
1532,648,443,205,45,75,75,94,130,229,18,1634,666
1533,309,196,113,40,84,25,46,47,67,0,862,309
1534,843,534,309,108,228,67,125,127,188,35,2436,878
1535,1659,1160,499,95,159,145,225,371,664,177,4485,1836
1536,1115,705,410,53,73,104,149,240,496,38,3318,1153
1537,4,2,2,0,0,0,1,1,2,0,9,4
1538,308,182,126,12,20,33,46,69,128,0,809,308
1539,932,550,382,37,60,100,139,209,387,0,2847,932
1540,1975,1309,666,106,156,226,267,406,814,0,5428,1975
1541,7902,5817,2085,712,1254,777,1232,1368,2559,0,22586,7902
1542,3037,2041,996,528,936,199,374,356,644,32,8361,3069
1543,2711,2016,695,204,315,328,396,524,944,0,6798,2711
1544,1331,911,420,17,59,145,203,318,589,35,3660,1366
1545,1055,677,378,112,191,106,153,183,310,41,2859,1096
1546,1177,768,409,83,143,149,183,226,393,71,3161,1248
1547,1095,861,234,112,163,142,158,196,324,0,3134,1095
1548,391,273,118,34,49,49,55,68,136,21,976,412
1549,1521,1215,306,178,212,178,194,260,499,24,3609,1545
1550,2918,2012,906,114,142,337,471,622,1232,0,7973,2918
1551,0,0,0,0,0,0,0,0,0,0,0,0
1552,328,219,109,27,47,37,52,63,102,9,975,337
1553,1172,858,314,28,54,132,163,296,499,0,3271,1172
1554,415,314,101,12,18,45,59,88,193,0,908,415
1555,1797,1257,540,286,442,130,195,261,483,18,5483,1815
1556,619,461,158,27,46,66,88,126,266,12,1386,631
1557,330,210,120,20,41,35,49,71,114,0,956,330
1558,849,541,308,53,106,89,126,182,293,0,2509,849
1559,2773,1872,901,203,273,330,396,586,985,41,7009,2814
1560,1198,762,436,125,164,115,161,210,423,24,3172,1222
1561,1081,783,298,47,83,134,157,252,408,416,2840,1497
1562,1297,846,451,91,157,164,201,249,435,15,3546,1312
1563,386,245,141,40,53,37,52,68,136,0,1134,386
1564,997,754,243,30,44,107,141,212,463,0,2707,997
1565,1218,879,339,82,131,147,173,236,449,35,3188,1253
1566,5376,3759,1617,857,1324,388,583,780,1444,0,11205,5376
1567,638,468,170,78,122,72,86,97,183,0,1528,638
1568,319,238,81,14,24,34,45,65,137,35,882,354
1569,982,720,262,88,128,108,136,179,343,86,2126,1068
1570,509,348,161,35,59,59,74,102,180,41,1386,550
1571,602,402,200,65,109,76,109,98,145,0,1680,602
1572,793,573,220,53,86,96,112,153,293,32,1695,825
1573,1747,1396,351,205,244,205,223,299,571,0,3030,1747
1574,7006,6153,853,1230,2023,280,673,626,2174,0,18096,7006
1575,666,489,177,81,127,75,89,101,193,30,1776,696
1576,3000,1926,1074,320,543,300,434,520,883,0,6778,3000
1577,25,16,9,2,3,3,4,5,8,0,53,25
1578,1199,765,434,74,149,126,178,256,416,0,3459,1199
1579,848,536,312,40,56,79,114,183,376,0,2142,848
1580,574,459,115,67,80,67,73,98,189,0,1141,574
1581,468,305,163,33,57,59,73,90,156,0,1542,468
1582,6005,4007,1998,650,1087,762,1085,974,1447,0,17315,6005
1583,1163,686,477,46,75,124,174,260,484,0,3247,1163
1584,1445,1210,235,190,266,166,200,215,408,0,2898,1445
1585,267,186,81,23,34,34,37,47,92,0,667,267
1586,10,9,1,2,3,0,1,1,3,0,26,10
1587,744,520,224,119,183,54,81,108,199,0,1943,744
1588,1669,1223,446,150,217,183,231,304,584,0,4381,1669
1589,667,524,143,68,100,87,96,119,197,80,1376,747
1590,719,602,117,95,132,82,100,107,203,348,1806,1067
1591,1928,1693,235,338,557,77,185,172,599,0,5315,1928
1592,340,200,140,13,22,36,51,76,142,0,791,340
1593,1057,701,356,57,84,121,143,218,434,177,2298,1234
1594,327,217,110,18,26,37,44,67,135,0,837,327
1595,442,282,160,27,55,46,66,95,153,9,1145,451
1596,6919,4400,2519,724,948,661,928,1215,2443,0,18016,6919
1597,668,425,243,70,92,64,90,117,235,0,1820,668
1598,685,502,183,17,32,77,95,173,291,0,1623,685
1599,737,540,197,18,34,83,102,186,314,24,1848,761
1600,6287,4225,2062,1094,1938,412,773,736,1334,0,18679,6287
1601,0,0,0,0,0,0,0,0,0,0,0,0
1602,352,230,122,25,43,44,55,68,117,0,895,352
1603,246,171,75,22,31,31,34,43,85,12,679,258
1604,1419,899,520,181,385,113,210,214,316,38,4173,1457
1605,434,323,111,19,32,47,61,88,187,0,1092,434
1606,1041,696,345,86,150,116,166,199,324,83,2671,1124
1607,990,661,329,107,179,126,179,161,238,0,2758,990
1608,746,547,199,91,142,84,100,113,216,0,1702,746
1609,786,576,210,71,102,86,109,143,275,195,1857,981
1610,2638,1803,835,182,306,307,382,530,931,71,7448,2709
1611,1315,917,398,116,166,165,184,230,454,30,3633,1345
1612,1440,1060,380,130,229,142,224,249,466,0,2731,1440
1613,24,21,3,4,7,1,2,2,8,0,103,24
1614,0,0,0,0,0,0,0,0,0,0,0,0
1615,487,326,161,40,70,54,78,93,152,24,1332,511
1616,246,180,66,6,11,28,34,62,105,0,671,246
1617,3360,2166,1194,119,241,410,396,716,1478,0,9928,3360
1618,741,436,305,18,33,104,89,145,352,90,2831,831
1619,549,404,145,21,35,77,67,122,227,0,1356,549
1620,1104,779,325,50,91,149,112,218,484,25,3219,1129
1621,856,454,402,17,32,122,107,173,405,51,2894,907
1622,525,313,212,21,27,68,75,101,233,18,1730,543
1623,2616,2014,602,274,308,385,364,517,768,0,7086,2616
1624,547,329,218,17,34,85,70,114,227,12,1663,559
1625,760,526,234,52,71,97,82,148,310,49,2143,809
1626,950,608,342,34,62,137,89,211,417,39,2867,989
1627,1373,847,526,54,99,207,154,309,550,23,4403,1396
1628,1280,759,521,48,82,171,137,288,554,0,3981,1280
1629,2117,1550,567,77,121,270,265,484,900,14,6313,2131
1630,1910,1049,861,59,101,221,240,336,953,27,5930,1937
1631,103,73,30,17,15,12,12,17,30,0,336,103
1632,1100,660,440,25,60,159,116,258,482,25,3220,1125
1633,730,475,255,27,46,92,90,168,307,0,2177,730
1634,707,476,231,135,254,63,34,75,146,0,2155,707
1635,2304,1453,851,102,181,308,292,484,937,35,7272,2339
1636,1088,804,284,27,83,146,107,233,492,16,2936,1104
1637,1970,1245,725,59,129,302,224,426,830,29,6190,1999
1638,2378,1483,895,91,143,283,300,550,1011,139,6877,2517
1639,1212,651,561,25,55,149,141,304,538,156,3582,1368
1640,1212,755,457,31,62,153,132,295,539,0,3685,1212
1641,576,401,175,35,40,69,65,99,268,0,1842,576
1642,3325,1793,1532,258,285,340,382,571,1489,66,10996,3391
1643,1671,899,772,57,74,202,224,347,767,94,5476,1765
1644,11347,7680,3667,868,916,1088,1169,2011,5295,25,33640,11372
1645,1904,1133,771,142,149,228,230,320,835,94,5997,1998
1646,1105,847,258,140,129,145,118,150,423,113,2907,1218
1647,1691,1216,475,56,150,265,175,354,691,4,4080,1695
1648,2356,1604,752,75,142,315,270,508,1046,47,7341,2403
1649,1748,1162,586,83,128,220,195,372,750,35,5284,1783
1650,2292,1345,947,101,109,281,287,485,1029,21,7438,2313
1651,1496,998,498,37,85,223,168,309,674,41,4817,1537
1652,351,164,187,14,18,43,43,70,163,0,1327,351
1653,284,167,117,7,13,40,34,56,134,31,1031,315
1654,1005,746,259,32,56,125,139,174,479,0,2231,1005
1655,1785,1388,397,331,198,198,165,397,496,0,3835,1785
1656,1255,981,274,156,166,181,128,211,413,0,2916,1255
1657,294,175,119,6,15,37,36,68,132,0,857,294
1658,343,242,101,58,49,40,41,55,100,0,869,343
1659,897,553,344,35,65,135,101,202,359,23,3080,920
1660,668,384,284,27,40,78,85,126,312,0,2349,668
1661,813,457,356,22,33,131,121,179,327,16,2558,829
1662,1011,784,227,95,103,128,123,197,365,4,2530,1015
1663,439,252,187,18,27,51,56,83,204,10,1563,449
1664,385,287,98,45,52,54,43,66,125,0,1179,385
1665,844,521,323,54,59,122,104,182,323,14,2266,858
1666,850,589,261,149,142,112,103,114,230,41,2462,891
1667,1444,1020,424,243,205,170,174,231,421,82,4210,1526
1668,2140,1512,628,361,305,253,258,343,620,203,4608,2343
1669,521,243,278,20,27,63,63,104,244,0,1908,521
1670,199,113,86,13,15,21,20,33,97,2,832,201
1671,636,361,275,40,48,68,64,107,309,59,2289,695
1672,695,395,300,44,52,74,70,117,338,68,2480,763
1673,1983,1284,699,309,371,156,163,270,714,0,7179,1983
1674,3841,2487,1354,599,719,303,316,524,1380,0,9991,3841
1675,351,209,142,7,18,45,43,81,157,0,1022,351
1676,447,276,171,28,31,64,55,97,172,16,1665,463
1677,864,497,367,35,52,101,110,163,403,27,2997,891
1678,973,716,257,38,62,136,118,216,403,70,3088,1043
1679,442,263,179,8,23,56,54,102,199,8,1306,450
1680,1378,958,420,83,97,166,154,238,640,23,4090,1401
1681,670,400,270,27,35,87,95,129,297,8,2283,678
1682,1078,804,274,125,147,151,120,186,349,45,3051,1123
1683,628,357,271,40,47,67,63,106,305,0,2197,628
1684,7,5,2,0,1,1,1,1,3,57,20,64
1685,837,579,258,57,79,107,90,163,341,0,2404,837
1686,333,248,85,39,45,47,37,57,108,0,1092,333
1687,4042,3221,821,777,1072,450,348,486,909,0,10984,4042
1688,849,676,173,163,225,94,73,102,192,0,1974,849
1689,1288,1026,262,248,341,143,111,155,290,0,3388,1288
1690,708,564,144,136,188,79,61,85,159,0,1776,708
1691,475,329,146,83,79,62,58,64,129,25,1509,500
1692,362,187,175,36,41,47,45,59,134,0,1136,362
1693,360,199,161,33,32,48,45,59,143,0,1326,360
1694,426,301,125,19,35,58,43,84,187,27,1126,453
1695,2445,1948,497,470,648,272,210,294,551,0,6715,2445
1696,1374,1095,279,264,364,153,118,165,310,0,2721,1374
1697,491,318,173,77,92,39,40,67,176,0,1306,491
1698,487,315,172,76,91,38,40,66,176,53,1456,540
1699,353,131,222,19,25,46,55,62,146,33,1380,386
1700,690,531,159,72,81,101,96,136,204,4,1506,694
1701,955,622,333,36,60,121,118,219,401,0,2862,955
1702,520,358,162,79,78,67,59,85,152,201,1367,721
1703,1084,747,337,166,163,140,122,177,316,18,2682,1102
1704,609,420,189,93,92,79,69,100,176,0,1569,609
1705,606,474,132,75,80,87,62,102,200,0,1218,606
1706,629,423,206,120,226,56,30,67,130,0,1897,629
1707,2732,1703,1029,105,164,325,344,631,1163,0,7941,2732
1708,523,289,234,48,46,69,66,86,208,8,1889,531
1709,574,398,176,101,96,75,70,77,155,23,1505,597
1710,387,231,156,16,20,50,55,75,171,16,1254,403
1711,409,152,257,22,29,53,63,72,170,0,1502,409
1712,370,175,195,23,28,49,49,73,148,39,1355,409
1713,743,512,231,113,112,96,84,121,217,0,1930,743
1714,929,643,286,64,87,119,100,181,378,242,2676,1171
1715,664,458,206,101,100,86,75,108,194,12,1998,676
1716,1036,714,322,158,156,134,117,169,302,16,3093,1052
1717,522,361,161,36,49,67,56,101,213,0,1545,522
1718,964,601,363,37,58,115,121,223,410,0,2684,964
1719,823,572,251,50,58,99,92,142,382,10,1928,833
1720,582,314,268,45,50,60,67,100,260,0,1847,582
1721,732,395,337,57,63,75,84,126,327,16,2324,748
1722,397,239,158,13,25,62,51,82,164,0,1241,397
1723,645,495,150,82,76,85,69,87,246,6,1535,651
1724,205,122,83,15,16,24,25,35,90,23,606,228
1725,377,266,111,17,31,51,38,74,166,12,1227,389
1726,349,220,129,16,27,52,37,75,142,0,1220,349
1727,2318,1812,506,288,306,334,236,390,764,4,6619,2322
1728,1189,875,314,46,76,167,145,264,491,2,2647,1191
1729,608,314,294,61,69,78,75,99,226,0,2098,608
1730,391,276,115,66,56,46,47,63,113,0,1310,391
1731,109,70,39,4,8,13,13,23,48,0,352,109
1732,495,298,197,16,31,77,63,103,205,0,1458,495
1733,485,292,193,15,30,76,62,101,201,0,1563,485
1734,539,363,176,103,193,48,26,57,112,0,1593,539
1735,749,354,395,46,57,100,99,147,300,25,2837,774
1736,892,473,419,17,34,127,111,180,423,51,3117,943
1737,724,502,222,127,121,95,88,97,196,0,2122,724
1738,389,144,245,21,27,51,60,68,162,18,1438,407
1739,373,138,235,20,26,48,58,65,156,0,1384,373
1740,722,455,267,34,55,107,76,155,295,39,2197,761
1741,210,132,78,10,16,31,22,45,86,27,675,237
1742,994,626,368,46,76,147,105,214,406,0,3293,994
1743,458,253,205,42,41,61,57,76,181,29,1672,487
1744,432,257,175,8,22,55,53,99,195,10,1334,442
1745,1096,817,279,127,149,153,122,189,356,6,3369,1102
1746,0,0,0,0,0,0,0,0,0,0,0,0
1747,635,409,226,23,46,78,75,135,278,0,1818,635
1748,982,558,424,62,74,105,99,165,477,0,2930,982
1749,442,286,156,69,83,35,36,60,159,39,1311,481
1750,222,144,78,35,42,17,18,30,80,25,703,247
1751,82,65,17,16,22,9,7,10,18,8,244,90
1752,560,396,164,94,80,66,68,90,162,0,1406,560
1753,94,60,34,25,36,5,2,7,19,0,393,94
1754,3672,2346,1326,964,1392,204,97,276,739,0,5689,3672
1755,800,511,289,210,303,44,21,60,162,0,2387,800
1756,1522,972,550,400,577,85,40,114,306,10,3236,1532
1757,483,325,158,92,173,43,23,51,101,0,1441,483
1758,1040,870,170,89,121,114,173,158,385,7,2640,1047
1759,1035,829,206,37,67,128,146,217,440,0,3042,1035
1760,505,346,159,53,78,79,77,67,151,5,1624,510
1761,1408,979,429,47,69,192,192,298,610,152,3940,1560
1762,2865,2111,754,50,89,387,355,651,1333,47,7782,2912
1763,2487,1836,651,64,109,335,285,568,1126,85,6048,2572
1764,749,597,152,24,18,90,99,159,359,0,2023,749
1765,1045,683,362,54,75,168,137,191,420,0,2604,1045
1766,1502,1161,341,49,72,211,155,344,671,35,3863,1537
1767,1719,1307,412,45,84,236,206,362,786,5,4718,1724
1768,1663,1103,560,139,208,275,227,270,544,528,4841,2191
1769,1786,1195,591,136,220,276,246,284,624,45,5516,1831
1770,1432,1009,423,50,63,223,170,302,624,65,4100,1497
1771,1763,1263,500,200,264,264,221,261,553,10,5398,1773
1772,1158,900,258,120,155,173,153,180,377,67,2858,1225
1773,1021,855,166,34,53,140,111,242,441,35,2449,1056
1774,1773,1197,576,156,239,311,256,281,530,20,4983,1793
1775,1074,661,413,122,217,132,117,129,357,32,3425,1106
1776,806,568,238,61,102,109,100,126,308,12,2230,818
1777,948,606,342,24,40,132,115,179,458,15,3123,963
1778,301,140,161,23,36,49,42,51,100,0,1005,301
1779,1182,892,290,31,49,172,144,242,544,77,3787,1259
1780,1101,656,445,30,67,142,130,192,540,25,4182,1126
1781,741,544,197,45,73,91,94,147,291,17,2333,758
1782,706,523,183,23,32,111,79,139,322,0,1944,706
1783,1491,1115,376,136,187,217,195,233,523,17,3436,1508
1784,1142,963,179,82,125,155,147,207,426,5,2790,1147
1785,1439,1219,220,59,105,203,188,307,577,25,3648,1464
1786,1133,920,213,189,248,167,129,141,259,0,2302,1133
1787,1326,982,344,44,92,187,176,252,575,12,4193,1338
1788,1348,1032,316,42,119,196,214,226,551,25,3970,1373
1789,1080,814,266,94,134,137,142,201,372,0,2811,1080
1790,835,562,273,146,183,125,102,98,181,20,2210,855
1791,2537,1790,747,314,536,204,208,322,953,32,7567,2569
1792,1590,1466,124,82,95,216,205,291,701,2706,4250,4296
1793,446,323,123,37,48,70,55,69,167,0,1121,446
1794,1082,781,301,66,95,189,149,184,399,32,3312,1114
1795,1644,1242,402,62,70,246,172,369,725,15,5086,1659
1796,721,532,189,76,91,102,90,100,262,0,2080,721
1797,564,332,232,42,83,88,76,86,189,0,2047,564
1798,1363,1036,327,89,126,180,161,217,590,52,3608,1415
1799,1020,792,228,56,81,156,117,159,451,57,3295,1077
1800,1165,552,613,63,117,197,167,213,408,77,4100,1242
1801,947,641,306,78,121,144,128,137,339,7,3404,954
1802,1715,1105,610,51,89,218,206,326,825,70,5689,1785
1803,934,504,430,52,75,136,112,165,394,105,3802,1039
1804,415,318,97,31,46,70,58,68,142,0,1074,415
1805,681,401,280,101,141,109,96,79,155,25,1921,706
1806,383,314,69,53,57,53,51,53,116,17,988,400
1807,514,401,113,78,106,70,69,63,128,0,1346,514
1808,419,359,60,101,128,43,41,38,68,0,1027,419
1809,325,253,72,49,67,44,44,40,81,0,684,325
1810,534,441,93,67,73,65,72,83,174,0,1469,534
1811,861,639,222,88,112,131,112,128,290,15,2330,876
1812,403,271,132,70,88,60,49,47,89,0,1236,403
1813,443,355,88,16,29,55,63,93,187,10,1130,453
1814,1019,874,145,245,310,105,100,93,166,10,2107,1029
1815,515,381,134,17,36,73,68,98,223,0,1618,515
1816,441,358,83,73,97,65,50,55,101,7,797,448
1817,402,349,53,48,60,68,47,59,120,0,916,402
1818,974,846,128,116,146,164,113,144,291,10,1956,984
1819,568,469,99,71,78,70,76,88,185,125,1745,693
1820,1249,974,275,190,257,169,167,154,312,0,3361,1249
1821,658,512,146,68,88,98,87,102,215,22,1570,680
1822,738,572,166,62,77,130,92,128,249,92,1744,830
1823,999,690,309,90,156,152,120,158,323,32,3055,1031
1824,472,383,89,79,103,69,54,59,108,0,1007,472
1825,357,290,67,59,78,53,41,44,82,0,701,357
1826,886,719,167,148,194,130,101,110,203,0,1798,886
1827,282,209,73,9,20,40,37,54,122,45,907,327
1828,5285,3729,1556,654,1116,425,433,671,1986,0,10302,5285
1829,269,209,60,28,36,40,36,42,87,10,760,279
1830,1474,1038,436,111,187,200,183,230,563,0,4500,1474
1831,474,334,140,36,60,64,59,74,181,0,1623,474
1832,841,653,188,46,67,129,96,131,372,75,2395,916
1833,213,147,66,19,33,32,26,34,69,0,602,213
1834,482,333,149,43,75,73,58,76,157,0,1586,482
1835,841,581,260,75,132,128,101,133,272,0,2516,841
1836,550,380,170,49,86,84,66,87,178,0,1532,550
1837,1041,859,182,131,143,127,140,162,338,40,2303,1081
1838,341,264,77,29,36,60,43,59,114,12,806,353
1839,533,395,138,54,70,81,69,79,180,15,1688,548
1840,716,564,152,29,35,120,84,146,302,42,1541,758
1841,508,368,140,42,55,80,63,79,189,47,1304,555
1842,764,601,163,31,37,128,90,156,322,12,1742,776
1843,991,806,185,216,273,123,92,112,175,0,2302,991
1844,653,484,169,22,30,103,73,129,296,90,1708,743
1845,171,80,91,13,21,28,24,29,56,80,609,251
1846,614,286,328,46,74,101,85,103,205,0,2395,614
1847,713,557,156,35,48,95,94,122,319,130,2147,843
1848,636,496,140,31,43,85,84,109,284,55,1827,691
1849,677,559,118,85,93,83,91,105,220,0,1249,677
1850,3056,2156,900,378,645,246,250,388,1149,0,7955,3056
1851,285,201,84,35,60,23,23,36,108,12,744,297
1852,999,663,336,83,125,165,136,162,328,127,3172,1126
1853,374,263,111,28,48,51,46,58,143,42,1361,416
1854,375,221,154,56,78,60,53,44,84,0,1116,375
1855,711,418,293,106,148,114,101,83,159,17,2104,728
1856,457,366,91,16,30,57,65,96,193,0,1109,457
1857,1100,955,145,131,165,186,128,163,327,20,2186,1120
1858,187,132,55,14,24,25,23,29,72,0,704,187
1859,302,213,89,23,38,41,38,47,115,12,1036,314
1860,616,287,329,46,74,101,86,104,205,0,2063,616
1861,574,381,193,48,72,95,78,93,188,0,1587,574
1862,778,476,302,160,139,109,92,86,192,15,2427,793
1863,758,592,166,37,51,101,100,130,339,17,2255,775
1864,365,207,158,35,67,54,41,53,115,0,1183,365
1865,678,384,294,64,124,101,77,99,213,10,2176,688
1866,396,184,212,30,48,65,55,67,131,0,1467,396
1867,421,258,163,87,75,59,50,47,103,20,1070,441
1868,632,427,205,47,89,90,69,93,244,0,1716,632
1869,1071,889,182,203,241,162,121,120,224,25,2642,1096
1870,530,411,119,29,42,81,61,83,234,20,1643,550
1871,654,511,143,32,44,87,86,112,293,32,2012,686
1872,235,183,52,12,16,31,31,40,105,0,599,235
1873,403,313,90,22,32,62,46,63,178,0,1390,403
1874,614,415,199,46,86,87,67,90,238,60,1879,674
1875,1509,1294,215,363,459,156,148,138,245,0,3499,1509
1876,2529,2168,361,608,770,261,248,231,411,105,4247,2634
1877,646,554,92,155,197,67,63,59,105,147,1310,793
1878,354,216,138,26,39,48,34,52,155,0,1347,354
1879,269,175,94,11,14,34,37,52,121,0,934,269
1880,609,371,238,44,67,83,58,90,267,0,1966,609
1881,1188,732,456,156,295,172,139,137,289,12,2883,1200
1882,743,458,285,97,185,108,87,86,180,100,2252,843
1883,859,529,330,113,213,125,101,99,208,147,2881,1006
1884,1127,735,392,47,61,142,155,220,502,97,3403,1224
1885,215,172,43,8,14,27,30,45,91,0,365,215
1886,265,182,83,28,41,41,40,35,80,187,861,452
1887,642,432,210,112,140,96,79,75,140,0,1595,642
1888,390,298,92,61,74,64,52,48,91,15,915,405
1889,404,307,97,10,20,56,48,85,185,0,1052,404
1890,1088,885,203,237,300,135,101,123,192,0,2532,1088
1891,631,357,274,60,115,94,71,92,199,0,2298,631
1892,376,271,105,23,33,66,52,64,138,0,1214,376
1893,963,567,396,72,142,150,130,147,322,27,3029,990
1894,244,167,77,25,38,38,37,32,74,2,772,246
1895,639,412,227,19,33,81,77,121,308,0,2283,639
1896,942,616,326,49,67,152,124,172,378,77,2325,1019
1897,922,707,215,70,102,156,130,151,313,192,2219,1114
1898,360,283,77,14,17,60,42,74,153,0,892,360
1899,326,257,69,13,16,55,38,67,137,0,764,326
1900,1283,896,387,283,553,86,101,91,169,0,4203,1283
1901,756,547,209,63,82,119,93,118,281,50,1813,806
1902,433,255,178,32,64,67,58,66,146,12,1549,445
1903,686,479,207,151,296,46,54,49,90,0,1993,686
1904,444,261,183,66,92,71,63,52,100,7,1108,451
1905,412,338,74,57,61,57,55,57,125,17,944,429
1906,296,182,114,39,74,43,35,34,71,0,825,296
1907,947,698,249,99,120,134,118,131,345,0,2235,947
1908,548,418,130,86,104,90,73,67,128,37,1372,585
1909,832,647,185,86,111,124,110,129,272,20,1607,852
1910,202,114,88,19,37,30,23,29,64,0,658,202
1911,518,394,124,34,48,69,61,82,224,35,1231,553
1912,569,388,181,20,44,93,68,111,233,0,1727,569
1913,760,518,242,27,58,124,90,148,313,12,2360,772
1914,470,320,150,17,36,77,56,92,192,0,1632,470
1915,775,587,188,137,235,86,92,85,140,27,2368,802
1916,1371,1038,333,242,415,153,163,151,247,0,3636,1371
1917,324,271,53,28,38,36,54,49,119,0,829,324
1918,932,703,229,81,115,119,123,173,321,0,2037,932
1919,990,812,178,137,147,137,132,136,301,20,2102,1010
1920,1313,1089,224,248,295,198,149,148,275,194,2689,1507
1921,1951,1619,332,369,438,294,221,219,410,55,4800,2006
1922,656,500,156,103,124,108,87,80,154,40,1640,696
1923,649,453,196,143,280,44,51,46,85,0,1740,649
1924,227,158,69,50,98,15,18,16,30,0,611,227
1925,315,218,97,28,49,48,38,50,102,0,921,315
1926,89,67,22,16,27,10,11,10,15,0,284,89
1927,8991,6804,2187,1587,2721,1001,1068,988,1626,0,24974,8991
1928,113,82,31,7,10,20,16,19,41,0,458,113
1929,559,428,131,42,62,95,79,91,190,0,1340,559
1930,284,247,37,34,43,48,33,42,84,0,555,284
1931,77,60,17,6,8,14,10,13,26,0,191,77
1932,169,131,38,14,18,30,21,29,57,0,375,169
1933,215,151,64,16,27,29,27,33,83,0,784,215
1934,0,0,0,0,0,0,0,0,0,0,0,0
1935,925,562,363,233,377,81,68,65,101,69,3041,994
1936,665,651,14,137,100,99,77,88,164,0,1183,665
1937,2398,2122,276,91,53,313,246,488,1207,0,5154,2398
1938,780,675,105,48,34,104,71,142,381,2,1856,782
1939,312,269,43,32,22,42,37,54,125,0,655,312
1940,1407,1212,195,33,38,174,156,287,719,30,3141,1437
1941,213,194,19,9,11,32,23,38,100,0,279,213
1942,964,879,85,43,50,143,105,171,452,15,2487,979
1943,696,604,92,38,42,96,66,117,337,0,1720,696
1944,2443,2165,278,96,76,317,271,532,1151,11,5155,2454
1945,1922,1668,254,59,41,260,193,427,942,0,4541,1922
1946,503,325,178,80,67,93,60,59,144,60,1510,563
1947,1056,1020,36,58,70,176,111,186,455,649,2261,1705
1948,1359,1176,183,61,61,188,160,274,615,0,3007,1359
1949,259,206,53,30,23,33,42,44,87,19,649,278
1950,1153,987,166,56,79,174,136,212,496,0,3143,1153
1951,45,28,17,5,6,8,5,7,14,0,134,45
1952,1573,1197,376,40,47,186,159,289,852,6,4132,1579
1953,368,310,58,44,54,59,48,55,108,0,947,368
1954,1654,1046,608,210,357,265,189,230,403,0,4634,1654
1955,788,680,108,65,106,118,106,123,270,0,1386,788
1956,1567,1353,214,129,211,236,211,245,535,17,3483,1584
1957,748,620,128,110,149,73,97,103,216,0,1775,748
1958,3111,2488,623,253,374,283,427,534,1240,0,7970,3111
1959,5742,4291,1451,801,1090,493,602,914,1842,4,15079,5746
1960,67,47,20,2,3,8,7,12,35,0,143,67
1961,928,765,163,134,167,141,123,121,242,0,2033,928
1962,365,330,35,32,37,49,49,58,140,0,577,365
1963,241,195,46,23,27,37,29,38,87,0,617,241
1964,435,403,32,43,41,74,46,71,160,1273,1026,1708
1965,547,441,106,52,48,81,63,98,205,0,1246,547
1966,494,285,209,77,75,107,54,66,115,58,1517,552
1967,278,161,117,43,42,60,30,37,66,11,876,289
1968,430,327,103,31,27,59,60,84,169,0,1019,430
1969,598,493,105,86,107,91,79,78,157,0,1466,598
1970,668,560,108,155,96,150,83,66,118,0,1576,668
1971,260,137,123,39,42,47,30,36,66,0,868,260
1972,594,490,104,85,107,90,78,77,157,0,1445,594
1973,444,372,72,103,64,100,55,44,78,17,970,461
1974,571,478,93,133,82,128,71,57,100,0,1187,571
1975,1898,1838,60,777,417,291,168,111,134,0,2843,1898
1976,475,336,139,207,129,58,42,19,20,0,1066,475
1977,240,169,71,90,51,42,26,14,17,7,519,247
1978,2015,1950,65,1053,359,329,118,76,80,0,2536,2015
1979,0,0,0,0,0,0,0,0,0,158,0,158
1980,2070,1503,567,472,546,377,304,164,207,28,4078,2098
1981,429,344,85,56,72,63,52,60,126,0,967,429
1982,2205,1876,329,768,447,384,273,173,160,0,5424,2205
1983,1759,1489,270,185,259,224,251,257,583,0,3981,1759
1984,533,427,106,69,90,79,65,75,155,0,1137,533
1985,710,379,331,176,177,115,86,65,91,86,2015,796
1986,527,456,71,84,99,80,66,69,129,0,1149,527
1987,582,483,99,85,116,57,76,80,168,0,1402,582
1988,431,339,92,68,43,71,59,68,122,0,1020,431
1989,535,256,279,89,95,95,57,66,133,0,1878,535
1990,477,275,202,74,72,103,52,64,112,62,1280,539
1991,712,461,251,112,121,120,74,92,193,9,2060,721
1992,318,152,166,53,57,57,34,39,78,0,1155,318
1993,617,382,235,64,78,112,75,92,196,19,1692,636
1994,1537,1504,33,317,231,228,178,203,380,7,2582,1544
1995,960,892,68,316,158,167,111,87,121,0,1805,960
1996,636,448,188,170,105,116,91,62,92,0,1692,636
1997,2944,1984,960,1272,1138,196,206,79,53,7,6307,2951
1998,1309,1217,92,431,215,227,151,118,167,0,2139,1309
1999,1246,1158,88,410,205,216,144,113,158,0,1928,1246
2000,648,456,192,174,107,119,93,63,92,0,1375,648
2001,575,405,170,154,95,105,82,56,83,0,1329,575
2002,401,282,119,107,66,73,57,39,59,13,957,414
2003,275,209,66,7,8,32,28,51,149,0,721,275
2004,2726,2655,71,1024,657,405,304,185,151,26,5278,2752
2005,1374,1338,36,516,331,204,153,93,77,213,2567,1587
2006,535,428,107,155,100,110,58,42,70,766,1265,1301
2007,738,697,41,147,65,123,105,109,189,0,1586,738
2008,707,592,115,164,101,159,87,70,126,43,1523,750
2009,886,560,326,273,202,154,111,62,84,777,1926,1663
2010,1046,861,185,106,119,110,151,151,409,0,2470,1046
2011,421,340,81,58,49,60,56,57,141,0,994,421
2012,699,564,135,96,81,99,92,95,236,9,1705,708
2013,456,291,165,82,88,90,48,54,94,28,1173,484
2014,418,270,148,66,56,77,50,49,120,0,1180,418
2015,386,250,136,61,66,65,40,50,104,0,1139,386
2016,334,207,127,34,42,61,41,50,106,0,855,334
2017,448,248,200,96,81,83,70,43,75,15,1585,463
2018,594,329,265,128,107,110,93,56,100,9,2028,603
2019,372,184,188,81,99,64,46,27,55,24,1459,396
2020,342,288,54,115,69,80,36,17,25,15,746,357
2021,398,289,109,91,105,73,59,31,39,0,946,398
2022,373,322,51,32,41,53,54,61,132,0,742,373
2023,699,631,68,61,71,93,93,111,270,7,1437,706
2024,437,308,129,117,72,80,62,42,64,0,909,437
2025,477,264,213,102,86,88,75,45,81,22,1728,499
2026,297,165,132,64,54,55,47,28,49,17,1044,314
2027,719,454,265,126,113,145,81,86,168,0,1983,719
2028,452,286,166,79,71,91,51,54,106,140,1296,592
2029,320,216,104,50,42,54,42,39,93,17,1037,337
2030,550,371,179,86,72,93,72,68,159,0,1563,550
2031,599,404,195,94,79,101,78,74,173,0,1528,599
2032,336,226,110,53,44,57,44,41,97,0,825,336
2033,482,325,157,76,63,81,63,59,140,62,1284,544
2034,435,293,142,68,57,73,57,53,127,0,1298,435
2035,391,318,73,21,21,51,36,70,192,0,1010,391
2036,1383,1300,83,375,233,222,156,174,223,69,2775,1452
2037,704,665,39,140,62,118,100,104,180,0,1290,704
2038,597,377,220,184,136,104,75,42,56,15,1342,612
2039,579,547,32,115,51,97,82,86,148,0,974,579
2040,1284,1251,33,272,172,227,176,173,264,0,2193,1284
2041,797,749,48,216,135,128,90,101,127,203,1565,1000
2042,2087,1214,873,802,734,219,146,92,94,0,6661,2087
2043,702,403,299,33,68,147,74,117,263,110,2327,812
2044,606,329,277,111,102,118,61,77,137,60,1940,666
2045,393,254,139,62,52,72,47,46,114,0,962,393
2046,398,254,144,71,76,79,42,47,83,0,1251,398
2047,376,304,72,52,44,53,50,51,126,0,891,376
2048,527,312,215,111,93,103,49,60,111,0,1457,527
2049,835,486,349,321,294,87,59,37,37,0,2382,835
2050,356,219,137,80,73,65,37,34,67,140,1284,496
2051,934,567,367,235,380,82,68,66,103,28,3017,962
2052,1079,787,292,296,411,82,65,81,144,378,2563,1457
2053,620,373,247,112,120,115,63,67,143,0,2035,620
2054,460,277,183,83,89,85,46,50,107,0,1219,460
2055,562,338,224,102,109,104,57,61,129,0,1575,562
2056,257,155,102,47,50,48,26,28,58,0,813,257
2057,270,163,107,49,52,50,27,29,63,0,904,270
2058,289,174,115,52,56,54,29,31,67,0,827,289
2059,299,148,151,65,79,52,37,22,44,7,1141,306
2060,148,94,54,19,32,24,17,21,35,0,421,148
2061,559,359,200,195,128,88,60,34,54,2,1374,561
2062,404,259,145,141,92,63,43,25,40,0,911,404
2063,720,455,265,222,164,125,91,50,68,7235,1789,7955
2064,326,172,154,48,52,59,38,45,84,0,1030,326
2065,1062,651,411,220,243,202,113,114,170,54,3281,1116
2066,512,314,198,106,117,97,54,55,83,6,1725,518
2067,1611,1594,17,908,355,176,82,50,40,520,2260,2131
2068,1106,803,303,252,292,202,163,87,110,11,2055,1117
2069,697,548,149,110,69,115,95,109,199,0,1733,697
2070,342,218,124,61,66,68,36,40,71,0,1135,342
2071,448,259,189,70,68,97,49,60,104,0,1213,448
2072,410,243,167,62,68,88,46,52,94,4,1340,414
2073,489,296,193,105,72,89,52,62,109,0,1262,489
2074,338,205,133,73,50,62,36,43,74,0,971,338
2075,304,153,151,47,48,61,35,40,73,0,1212,304
2076,675,651,24,101,50,104,67,113,240,11,1032,686
2077,754,634,120,91,110,120,99,113,221,52,1781,806
2078,774,615,159,294,173,138,84,36,49,21,1890,795
2079,507,334,173,190,116,80,53,33,35,9,1158,516
2080,756,498,258,283,173,120,80,49,51,97,1775,853
2081,292,233,59,33,26,37,47,49,100,0,718,292
2082,455,229,226,71,71,91,53,59,110,2,1787,457
2083,707,355,352,110,111,141,83,92,170,9,2691,716
2084,909,449,460,197,241,157,113,67,134,0,3075,909
2085,305,161,144,45,49,55,35,42,79,0,965,305
2086,386,208,178,46,46,78,46,56,114,73,1293,459
2087,347,264,83,25,22,47,49,68,136,24,1049,371
2088,910,778,132,147,178,117,120,111,237,13,1926,923
2089,1496,1336,160,707,391,166,134,57,41,4,2953,1500
2090,479,464,15,196,105,73,42,28,35,26,702,505
2091,0,0,0,0,0,0,0,0,0,142,0,142
2092,620,334,286,74,75,125,75,90,181,0,2081,620
2093,249,240,9,37,19,39,25,42,87,0,595,249
2094,257,123,134,43,46,46,27,32,63,0,897,257
2095,439,310,129,10,17,52,46,82,232,0,1187,439
2096,320,190,130,48,53,69,36,41,73,0,1042,320
2097,336,256,80,24,21,46,47,66,132,0,892,336
2098,910,602,308,330,265,89,99,57,70,58,3021,968
2099,249,203,46,13,13,33,23,45,122,0,578,249
2100,922,867,55,250,156,148,104,116,148,0,1557,922
2101,586,551,35,159,99,94,66,74,94,0,1124,586
2102,2822,2731,91,1475,503,461,165,106,112,145,4962,2967
2103,790,771,19,131,77,138,103,122,219,9,1277,799
2104,384,273,111,57,54,55,48,55,115,0,953,384
2105,333,197,136,70,59,65,31,38,70,0,1048,333
2106,2042,1989,53,767,492,303,228,139,113,15,3317,2057
2107,536,445,91,79,107,52,70,73,155,0,1098,536
2108,821,695,126,86,121,105,117,120,272,0,1677,821
2109,827,686,141,121,165,80,108,113,240,0,1748,827
2110,366,226,140,38,46,67,44,54,117,0,960,366
2111,501,334,167,153,130,79,67,30,42,0,1392,501
2112,383,255,128,117,99,61,51,23,32,21,1196,404
2113,383,343,40,44,39,58,37,56,149,0,815,383
2114,352,308,44,27,31,53,34,60,147,0,907,352
2115,1235,832,403,534,477,82,87,33,22,0,2933,1235
2116,2492,1349,1143,850,247,316,282,306,491,0,6063,2492
2117,670,537,133,87,113,99,82,94,195,0,1665,670
2118,523,431,92,53,60,55,76,76,203,0,1158,523
2119,1491,1369,122,560,458,207,126,67,73,2,3937,1493
2120,852,845,7,384,221,104,71,39,33,246,886,1098
2121,407,325,82,118,76,84,44,32,53,0,937,407
2122,463,370,93,134,86,95,50,36,62,0,1076,463
2123,399,349,50,31,35,60,38,68,167,0,964,399
2124,678,581,97,180,99,117,80,67,135,0,1200,678
2125,269,259,10,130,56,40,27,11,5,32,449,301
2126,481,477,4,195,125,71,43,27,20,71,580,552
2127,721,624,97,115,136,110,90,94,176,0,1655,721
2128,396,343,53,63,75,60,49,51,98,0,794,396
2129,1349,1120,229,241,331,178,148,143,308,0,2486,1349
2130,822,702,120,133,161,105,109,100,214,0,1639,822
2131,732,625,107,118,143,94,97,89,191,0,1547,732
2132,604,508,96,73,88,96,79,91,177,0,1557,604
2133,583,471,112,136,77,131,72,63,104,0,1146,583
2134,418,335,83,54,70,62,51,59,122,50,984,468
2135,1095,946,149,94,119,156,158,180,388,9,2139,1104
2136,347,286,61,50,62,53,46,45,91,0,897,347
2137,574,514,60,66,59,88,56,83,222,0,1282,574
2138,446,390,56,35,39,67,43,76,186,0,982,446
2139,389,257,132,141,113,38,42,24,31,0,797,389
2140,1097,1069,28,233,147,194,151,148,224,0,1771,1097
2141,854,834,20,141,84,150,111,132,236,22,1417,876
2142,389,375,14,58,29,60,39,65,138,19,589,408
2143,599,563,36,122,78,128,76,66,129,0,1146,599
2144,379,306,73,89,50,85,47,41,67,26,993,405
2145,345,279,66,81,45,77,43,37,62,0,860,345
2146,288,171,117,54,44,58,43,30,59,0,919,288
2147,396,322,74,21,21,52,36,71,195,0,1009,396
2148,294,232,62,43,35,50,49,32,85,0,784,294
2149,397,235,162,74,61,80,60,41,81,0,1269,397
2150,470,316,154,69,71,84,51,56,139,43,1165,513
2151,507,403,104,192,113,90,55,24,33,0,1033,507
2152,441,233,208,66,71,80,51,61,112,0,1435,441
2153,4595,4545,50,2591,1012,502,233,142,115,58,7250,4653
2154,4151,3933,218,1548,836,683,467,303,314,48,6253,4199
2155,645,557,88,97,74,79,77,92,226,4,1266,649
2156,564,487,77,58,40,76,67,98,225,19,1252,583
2157,350,302,48,36,25,47,42,61,139,0,735,350
2158,389,315,74,37,44,60,46,61,141,0,900,389
2159,277,239,38,29,19,37,33,48,111,0,570,277
2160,424,355,69,98,61,95,52,42,76,0,982,424
2161,469,393,76,109,67,106,58,47,82,0,1092,469
2162,1704,1615,89,635,343,280,192,124,130,34,2824,1738
2163,408,387,21,152,82,67,46,30,31,0,726,408
2164,485,460,25,181,98,80,55,35,36,0,715,485
2165,638,605,33,238,128,105,72,47,48,45,1040,683
2166,1916,1827,89,526,319,346,251,194,280,86,3339,2002
2167,602,589,13,191,114,107,72,49,69,34,925,636
2168,1064,1042,22,338,202,188,126,87,123,0,1590,1064
2169,649,636,13,206,123,115,77,53,75,0,1162,649
2170,921,902,19,293,175,163,109,76,105,0,1386,921
2171,1267,1240,27,262,190,188,147,167,313,0,1667,1267
2172,574,562,12,118,86,85,67,76,142,0,776,574
2173,762,485,277,158,199,128,98,79,100,4,2296,766
2174,432,265,167,97,89,78,45,41,82,0,1655,432
2175,292,222,70,21,19,40,41,57,114,11,820,303
2176,765,617,148,73,66,114,89,137,286,15,1834,780
2177,431,328,103,31,27,59,60,84,170,0,1090,431
2178,789,681,108,81,55,107,94,137,315,0,1669,789
2179,456,295,161,73,61,84,55,54,129,0,1040,456
2180,783,702,81,90,81,119,77,114,302,4,1643,787
2181,412,244,168,77,64,83,62,43,83,0,1187,412
2182,644,614,30,177,107,116,84,65,95,0,1223,644
2183,244,145,99,46,38,49,37,25,49,0,755,244
2184,749,696,53,247,123,130,86,68,95,2,1239,751
2185,471,261,210,101,85,87,74,45,79,0,1527,471
2186,627,335,292,156,156,102,76,58,79,0,2125,627
2187,271,165,106,52,50,51,40,26,52,17,974,288
2188,540,341,199,94,85,109,60,65,127,0,1587,540
2189,2529,1536,993,636,1030,223,185,179,276,0,6007,2529
2190,366,195,171,21,32,75,36,71,131,7,1421,373
2191,270,219,51,26,31,42,32,42,97,0,654,270
2192,391,327,64,42,39,56,44,63,147,47,925,438
2193,425,345,80,41,48,66,51,67,152,0,1039,425
2194,311,251,60,30,27,46,36,56,116,0,765,311
2195,511,428,83,55,51,73,57,82,193,0,1206,511
2196,293,245,48,32,29,42,33,47,110,7,736,300
2197,594,493,101,106,146,79,65,63,135,0,1183,594
2198,320,297,23,32,30,54,34,52,118,0,719,320
2199,490,266,224,90,83,95,49,62,111,17,1763,507
2200,363,293,70,50,42,51,48,49,123,0,840,363
2201,1853,1179,674,385,485,310,239,191,243,4,5457,1857
2202,549,337,212,113,126,104,58,59,89,26,1903,575
2203,313,170,143,57,53,61,32,40,70,17,1057,330
2204,491,314,177,88,94,97,52,58,102,0,1702,491
2205,456,265,191,175,160,48,32,20,21,0,1027,456
2206,670,397,273,141,118,131,63,77,140,0,2114,670
2207,633,497,136,100,63,105,86,99,180,0,1464,633
2208,1502,1300,202,67,67,207,176,303,682,0,3243,1502
2209,2670,1640,1030,599,551,484,281,253,502,0,8239,2670
2210,455,321,134,199,124,56,41,19,16,4,1096,459
2211,381,205,176,46,46,77,46,56,110,0,1063,381
2212,259,153,106,39,43,56,29,33,59,0,826,259
2213,369,356,13,55,27,57,37,62,131,0,562,369
2214,254,150,104,38,42,55,28,32,59,0,893,254
2215,383,206,177,46,46,77,46,56,112,0,1172,383
2216,5247,4817,430,1971,1613,727,442,235,259,86,9003,5333
2217,656,403,253,147,135,119,69,62,124,0,2036,656
2218,462,280,182,99,68,84,49,58,104,0,1325,462
2219,363,215,148,55,60,78,41,46,83,0,1162,363
2220,448,290,158,71,76,76,46,58,121,0,1149,448
2221,687,405,282,187,172,118,71,50,89,216,2079,903
2222,388,248,140,70,74,77,41,46,80,0,1199,388
2223,463,296,167,83,89,92,49,55,95,0,1314,463
2224,432,406,26,88,56,92,55,48,93,22,895,454
2225,466,438,28,95,60,99,59,52,101,0,992,466
2226,3066,3003,63,1468,668,434,253,158,85,0,8158,3066
2227,523,371,152,78,73,75,66,75,156,19,1301,542
2228,653,614,39,133,85,139,83,72,141,0,1082,653
2229,324,264,60,17,18,42,30,58,159,0,824,324
2230,533,451,82,56,78,68,76,78,177,0,1299,533
2231,392,298,94,10,12,46,40,72,212,0,1043,392
2232,850,501,349,232,213,145,88,62,110,9,2469,859
2233,406,396,10,67,40,71,53,63,112,32,708,438
2234,263,127,136,60,55,46,33,25,44,0,736,263
2235,665,469,196,249,142,116,71,40,47,0,1590,665
2236,606,538,68,90,85,86,68,84,193,0,1139,606
2237,566,302,264,33,49,116,56,109,203,0,1873,566
2238,265,216,49,14,14,35,24,48,130,0,652,265
2239,457,406,51,68,64,65,52,63,145,0,867,457
2240,351,185,166,52,56,63,41,49,90,15,1043,366
2241,543,490,53,47,55,73,73,86,209,7,1024,550
2242,490,424,66,78,93,75,61,64,119,0,1121,490
2243,537,465,72,86,101,82,67,70,131,147,1064,684
2244,547,436,111,62,49,70,88,92,186,235,1372,782
2245,293,251,42,78,43,51,35,29,57,0,699,293
2246,487,362,125,97,59,93,66,57,115,0,1309,487
2247,267,216,51,63,35,60,33,29,47,0,766,267
2248,1658,1097,561,601,483,162,180,103,129,13,5238,1671
2249,446,382,64,119,65,77,53,44,88,0,1110,446
2250,472,351,121,94,57,90,64,55,112,28,1027,500
2251,389,289,100,78,47,74,53,46,91,0,1079,389
2252,538,478,60,80,76,77,61,75,169,0,1107,538
2253,598,531,67,88,84,85,67,83,191,0,1161,598
2254,505,399,106,73,59,86,85,55,147,69,1255,574
2255,393,190,203,90,82,69,49,38,65,0,1249,393
2256,338,238,100,8,13,40,35,63,179,0,844,338
2257,582,410,172,14,23,69,61,108,307,0,1627,582
2258,1926,1274,652,698,561,188,209,120,150,7,5531,1933
2259,636,550,86,95,73,78,76,91,223,0,1345,636
2260,507,245,262,116,106,89,63,49,84,0,1318,507
2261,379,183,196,87,79,67,47,36,63,0,1211,379
2262,340,181,159,84,85,55,41,31,44,0,1058,340
2263,318,194,124,61,59,59,47,30,62,71,1080,389
2264,396,241,155,76,73,74,59,38,76,0,1020,396
2265,431,289,142,64,66,77,47,51,126,0,1094,431
2266,305,186,119,59,56,57,45,29,59,0,983,305
2267,251,159,92,44,39,50,28,30,60,0,783,251
2268,492,330,162,73,75,88,54,58,144,0,1386,492
2269,467,302,165,74,62,86,56,55,134,32,1230,499
2270,497,334,163,73,76,89,54,59,146,0,1471,497
2271,332,223,109,49,50,59,36,39,99,7,893,339
2272,1701,990,711,654,598,178,119,75,77,0,4457,1701
2273,521,319,202,108,119,99,55,56,84,0,1930,521
2274,122,111,11,5,6,18,13,22,58,278,175,400
2275,99,90,9,4,5,15,11,18,46,0,219,99
2276,1163,1154,9,524,302,142,97,53,45,97,2145,1260
2277,2606,2553,53,1247,568,368,215,134,74,76,2974,2682
2278,237,230,7,97,52,36,21,14,17,88,337,325
2279,402,290,112,196,114,44,24,14,10,67,1041,469
2280,606,438,168,296,172,66,36,21,15,9,1220,615
2281,57,48,9,6,6,8,6,9,22,11,150,68
2282,403,267,136,146,117,39,44,25,32,6,1036,409
2283,910,838,72,16,25,102,125,193,449,0,1874,910
2284,871,837,34,27,25,84,115,154,466,0,1881,871
2285,1255,1209,46,64,47,126,183,221,614,0,2693,1255
2286,667,643,24,64,50,75,79,107,292,0,1557,667
2287,1645,1590,55,67,50,183,205,294,846,32,3480,1677
2288,989,961,28,79,61,131,123,168,427,0,2030,989
2289,544,515,29,136,97,75,74,51,111,0,1082,544
2290,870,841,29,140,115,118,100,109,288,49,1784,919
2291,15,11,4,2,2,3,2,3,3,1626,35,1641
2292,242,233,9,45,33,37,33,28,66,1516,510,1758
2293,666,632,34,133,89,101,112,83,148,1486,1542,2152
2294,313,297,16,62,42,47,52,39,71,863,892,1176
2295,3249,3223,26,1071,574,430,463,255,456,154,7036,3403
2296,307,278,29,76,39,55,38,34,65,8,643,315
2297,763,738,25,144,86,105,93,111,224,27,1626,790
2298,383,359,24,100,67,52,53,38,73,0,705,383
2299,828,821,7,273,146,110,118,65,116,3,1651,831
2300,17,16,1,5,3,3,2,2,2,0,17,17
2301,511,480,31,148,95,82,56,47,83,0,682,511
2302,1616,1519,97,468,301,260,177,150,260,0,1920,1616
2303,4378,4114,264,1267,814,705,481,407,704,0,6004,4378
2304,620,589,31,108,44,85,93,71,219,0,1445,620
2305,404,382,22,101,72,56,55,38,82,0,910,404
2306,812,781,31,196,130,123,110,89,164,0,1681,812
2307,458,436,22,114,80,61,62,44,97,0,933,458
2308,482,456,26,121,86,67,65,45,98,10,1238,492
2309,476,448,28,91,66,76,74,47,122,0,1147,476
2310,346,332,14,121,92,33,28,22,50,11,605,357
2311,775,733,42,194,138,107,105,73,158,129,1925,904
2312,470,449,21,105,47,83,60,55,120,0,1099,470
2313,428,409,19,96,43,75,55,50,109,0,882,428
2314,1769,1662,107,512,329,285,194,164,285,0,2357,1769
2315,1159,1089,70,335,216,187,127,108,186,0,2107,1159
2316,1668,1567,101,483,310,269,183,155,268,3,2708,1671
2317,2085,1959,126,603,388,336,229,194,335,0,3389,2085
2318,961,943,18,223,106,164,175,97,196,1,2112,962
2319,831,786,45,171,87,112,87,125,249,0,1708,831
2320,307,282,25,67,60,30,19,41,90,0,655,307
2321,1413,1336,77,291,148,190,148,213,423,52,2444,1465
2322,1401,1337,64,314,140,247,178,165,357,170,2896,1571
2323,707,683,24,140,101,95,82,88,201,16,1293,723
2324,588,568,20,116,84,79,69,73,167,0,1099,588
2325,507,489,18,77,47,55,68,72,188,0,1089,507
2326,705,648,57,136,59,111,84,86,229,18,1405,723
2327,521,458,63,117,48,114,65,58,119,3,1008,524
2328,2356,2214,142,682,438,380,259,219,378,82,3293,2438
2329,276,248,28,58,30,59,34,28,67,0,604,276
2330,476,427,49,101,52,101,59,48,115,218,1137,694
2331,670,634,36,145,89,92,103,80,161,0,1408,670
2332,447,400,47,110,50,89,55,47,96,184,959,631
2333,356,320,36,75,39,76,44,36,86,19,817,375
2334,500,475,25,65,28,56,75,76,200,5,1170,505
2335,614,551,63,130,67,131,76,62,148,0,1410,614
2336,458,415,43,113,58,82,56,51,98,0,961,458
2337,781,751,30,131,91,123,122,85,229,4,1645,785
2338,878,862,16,204,97,150,160,89,178,93,1863,971
2339,1073,961,112,265,119,215,133,112,229,0,2112,1073
2340,557,514,43,102,74,85,90,63,143,95,1428,652
2341,426,400,26,111,74,58,59,42,82,0,1022,426
2342,430,423,7,78,55,65,59,55,118,809,899,1239
2343,1072,1054,18,286,219,143,116,101,207,0,2127,1072
2344,965,949,16,257,197,129,105,91,186,0,1669,965
2345,0,0,0,0,0,0,0,0,0,4,0,4
2346,767,704,63,148,65,121,91,93,249,0,1553,767
2347,798,783,15,185,88,136,145,81,163,4,1536,802
2348,362,352,10,29,22,48,45,61,157,11,665,373
2349,636,612,24,107,74,101,99,70,185,16,1264,652
2350,400,393,7,72,51,60,55,51,111,44,902,444
2351,1038,953,85,200,88,164,123,126,337,0,2006,1038
2352,649,596,53,142,128,62,40,86,191,96,1366,745
2353,782,754,28,119,73,84,105,110,291,0,1521,782
2354,1187,1176,11,383,238,180,148,102,136,5363,2398,6550
2355,1382,1315,67,255,178,224,184,166,375,0,3089,1382
2356,334,306,28,79,62,48,47,34,64,0,895,334
2357,768,737,31,133,70,76,75,113,301,0,1652,768
2358,400,380,20,52,23,45,60,61,159,0,988,400
2359,492,450,42,117,92,71,70,50,92,52,1250,544
2360,329,317,12,63,37,39,38,43,109,0,744,329
2361,362,344,18,62,19,43,52,52,134,0,880,362
2362,539,515,24,83,58,78,67,67,186,3,1094,542
2363,574,549,25,88,61,83,72,72,198,0,1271,574
2364,461,444,17,89,52,55,54,60,151,0,1039,461
2365,460,437,23,80,33,63,69,53,162,0,1104,460
2366,621,590,31,81,35,70,93,94,248,7,1566,628
2367,445,429,16,23,17,45,65,78,217,0,912,445
2368,614,591,23,119,69,73,72,80,201,7,1422,621
2369,927,890,37,161,85,92,91,136,362,0,2009,927
2370,742,717,25,119,98,101,86,93,245,1,1441,743
2371,317,299,18,43,34,41,43,43,113,0,705,317
2372,556,533,23,114,87,73,68,66,148,0,1145,556
2373,598,575,23,112,81,92,81,70,162,29,1157,627
2374,839,804,35,172,131,110,103,99,224,3,1736,842
2375,1792,1763,29,478,365,240,194,168,347,7,2887,1799
2376,268,256,12,41,29,39,33,33,93,0,552,268
2377,649,627,22,230,143,55,53,53,115,0,1179,649
2378,1289,1227,62,321,226,171,176,123,272,5,2138,1294
2379,362,345,17,90,64,48,49,35,76,34,835,396
2380,460,438,22,114,81,61,63,44,97,0,949,460
2381,325,308,17,65,44,49,54,40,73,284,733,609
2382,672,640,32,124,86,109,90,81,182,0,1416,672
2383,654,603,51,120,87,100,105,74,168,0,1578,654
2384,506,489,17,81,67,69,58,64,167,15,922,521
2385,1089,1047,42,263,174,165,148,119,220,21,2170,1110
2386,407,389,18,62,44,59,51,51,140,0,830,407
2387,243,234,9,37,23,26,33,34,90,0,531,243
2388,626,605,21,222,138,53,51,51,111,81,1244,707
2389,1485,1426,59,520,396,142,119,94,214,133,3019,1618
2390,272,243,29,67,30,54,34,29,58,25,661,297
2391,454,416,38,108,85,66,64,46,85,0,1169,454
2392,407,396,11,103,80,67,47,45,65,16,824,423
2393,348,338,10,88,69,57,40,39,55,40,789,388
2394,487,428,59,109,44,106,60,54,114,0,1059,487
2395,1162,1117,45,280,186,176,157,127,236,167,2240,1329
2396,337,318,19,46,36,43,45,46,121,0,699,337
2397,724,694,30,149,113,95,89,86,192,0,1304,724
2398,573,563,10,103,73,86,78,73,160,0,1329,573
2399,497,493,4,161,100,75,62,43,56,1880,795,2377
2400,300,285,15,51,16,35,43,43,112,0,771,300
2401,1019,1010,9,329,204,154,127,88,117,634,2158,1653
2402,954,918,36,178,129,147,129,112,259,797,1611,1751
2403,1890,1826,64,670,417,159,153,153,338,8,3933,1898
2404,902,877,25,229,178,148,104,100,143,1,1618,903
2405,592,558,34,114,82,94,92,58,152,0,1334,592
2406,550,503,47,131,103,80,78,56,102,111,1344,661
2407,998,966,32,189,112,137,122,146,292,0,2231,998
2408,376,365,11,30,23,50,47,64,162,0,762,376
2409,655,629,26,114,60,65,64,96,256,0,1472,655
2410,455,433,22,77,24,54,66,66,168,0,1120,455
2411,526,509,17,99,59,72,64,77,155,1,1229,527
2412,1154,1092,62,251,154,158,177,137,277,0,2353,1154
2413,10,9,1,3,2,1,1,1,2,0,15,10
2414,505,465,40,9,14,57,69,107,249,3,1108,508
2415,0,0,0,0,0,0,0,0,0,0,0,0
2416,197,186,11,27,21,25,26,27,71,0,421,197
2417,220,208,12,30,24,28,30,30,78,0,488,220
2418,253,242,11,39,27,37,32,32,86,4,484,257
2419,719,675,44,187,125,98,99,70,140,0,1231,719
2420,446,419,27,116,78,61,62,44,85,0,774,446
2421,0,0,0,0,0,0,0,0,0,10,0,10
2422,988,928,60,286,184,159,108,92,159,0,1085,988
2423,527,523,4,174,93,70,75,41,74,0,1158,527
2424,335,332,3,110,59,44,48,26,48,3,768,338
2425,567,562,5,187,100,75,81,44,80,176,1450,743
2426,396,392,4,128,79,60,49,34,46,0,870,396
2427,348,338,10,88,69,57,40,39,55,80,676,428
2428,376,366,10,95,74,62,43,42,60,0,734,376
2429,104,101,3,26,21,17,12,12,16,0,205,104
2430,166,161,5,42,33,27,19,18,27,0,237,166
2431,249,242,7,63,49,41,29,28,39,0,487,249
2432,526,497,29,132,94,73,71,49,107,29,1231,555
2433,124,114,10,29,23,18,18,13,23,0,311,124
2434,309,297,12,108,82,30,25,20,44,0,634,309
2435,147,141,6,51,39,14,12,9,22,0,276,147
2436,129,118,11,31,24,19,18,13,24,15,255,144
2437,96,86,10,20,10,20,12,10,24,0,254,96
2438,109,98,11,23,12,23,13,11,27,0,246,109
2439,103,92,11,22,11,22,13,10,25,0,265,103
2440,124,111,13,26,13,26,15,13,31,0,284,124
2441,530,486,44,116,104,51,32,70,157,0,1047,530
2442,435,411,24,90,46,58,45,66,130,0,888,435
2443,1219,1152,67,251,128,164,127,184,365,0,2274,1219
2444,350,331,19,72,37,47,37,53,104,147,623,497
2445,368,268,100,101,140,28,22,28,49,0,874,368
2446,0,0,0,0,0,0,0,0,0,0,0,0
2447,0,0,0,0,0,0,0,0,0,0,0,0
2448,754,408,346,257,75,96,85,93,148,0,2160,754
2449,0,0,0,0,0,0,0,0,0,0,0,0
2450,330,278,52,40,48,53,43,49,97,0,1117,330
2451,309,260,49,37,45,49,40,46,92,0,828,309
2452,1198,1008,190,144,175,191,157,180,351,0,2656,1198
2453,332,319,13,161,69,50,33,14,5,0,789,332
2454,177,170,7,86,37,26,18,8,2,0,325,177
2455,2784,2761,23,1127,725,412,251,153,116,7,10598,2791
2456,140,119,21,49,28,24,17,11,11,0,332,140
2457,865,736,129,301,175,151,107,68,63,9,2411,874
2458,148,147,1,60,39,22,13,8,6,4,352,152
2459,461,392,69,160,93,80,57,36,35,0,776,461
2460,476,472,4,193,124,70,43,26,20,0,1130,476
2461,400,397,3,162,104,59,36,22,17,6,502,406
2462,46,43,3,12,8,6,6,5,9,403,142,449
2463,220,206,14,57,38,30,30,22,43,0,822,220
2464,422,396,26,110,74,57,58,41,82,1,605,423
2465,1053,760,293,128,97,172,229,118,309,49,2626,1102
2466,540,439,101,47,46,78,63,95,211,0,1301,540
2467,1435,951,484,147,165,256,206,217,444,0,4172,1435
2468,824,483,341,201,228,130,86,66,113,0,2069,824
2469,1088,938,150,18,61,111,134,204,560,0,2360,1088
2470,891,638,253,34,40,107,143,201,366,0,2238,891
2471,2660,1829,831,290,372,452,389,413,744,14,6922,2674
2472,1484,1062,422,114,139,151,229,289,562,10,3393,1494
2473,1991,1431,560,183,236,234,311,360,667,31,5419,2022
2474,1554,1317,237,70,111,205,225,299,644,0,3040,1554
2475,4105,3027,1078,103,225,469,603,908,1797,85,10497,4190
2476,1589,1200,389,69,127,181,243,301,668,50,4013,1639
2477,1319,970,349,70,104,138,200,263,544,14,3136,1333
2478,4168,3161,1007,126,250,466,532,912,1882,91,10878,4259
2479,1734,1288,446,82,124,198,242,323,765,10,4518,1744
2480,1126,948,178,38,53,101,191,231,512,0,2712,1126
2481,1015,657,358,94,123,136,140,177,345,12,2827,1027
2482,621,473,148,120,134,95,68,72,132,29,1493,650
2483,1129,893,236,106,108,198,144,190,383,6,2693,1135
2484,1631,1208,423,160,190,283,204,251,543,6,4684,1637
2485,1533,1439,94,154,116,245,195,266,557,4,2472,1537
2486,1667,1360,307,251,189,321,191,223,492,0,2690,1667
2487,587,519,68,16,43,64,82,117,265,0,1342,587
2488,376,327,49,4,25,36,54,80,177,0,839,376
2489,412,263,149,14,19,54,53,98,174,0,1350,412
2490,701,411,290,171,194,111,73,56,96,399,2252,1100
2491,679,411,268,117,122,141,85,75,139,29,2302,708
2492,1745,1249,496,134,163,178,270,340,660,0,4718,1745
2493,430,308,122,33,40,44,66,84,163,0,1090,430
2494,445,284,161,15,21,58,57,106,188,0,1463,445
2495,621,437,184,44,53,72,98,116,238,0,1553,621
2496,390,275,115,28,33,45,61,73,150,0,1063,390
2497,431,246,185,57,66,66,59,58,125,0,1367,431
2498,531,303,228,71,82,81,72,72,153,12,1787,543
2499,357,204,153,48,55,55,49,48,102,0,1059,357
2500,887,486,401,96,116,159,124,131,261,0,3084,887
2501,408,290,118,100,89,61,38,44,76,10,1073,418
2502,1216,864,352,299,264,180,115,131,227,0,3158,1216
2503,878,756,122,138,136,128,94,125,257,0,1921,878
2504,1076,927,149,169,167,157,116,153,314,10,2352,1086
2505,470,401,69,18,47,52,68,78,207,0,1136,470
2506,479,409,70,19,48,53,70,80,209,0,1052,479
2507,567,367,200,52,69,76,78,99,193,12,2107,579
2508,971,695,276,75,91,99,150,189,367,0,1912,971
2509,534,261,273,74,94,108,69,66,123,257,2039,791
2510,344,305,39,9,23,30,57,64,161,0,857,344
2511,2481,1776,705,191,232,253,383,484,938,0,8202,2481
2512,365,326,39,19,33,36,54,61,162,0,778,365
2513,327,279,48,13,33,36,48,54,143,4,696,331
2514,505,431,74,20,51,56,73,84,221,0,1132,505
2515,1400,1239,161,38,103,152,195,279,633,0,3389,1400
2516,573,496,77,139,159,35,59,55,126,0,1648,573
2517,260,229,31,15,23,29,40,47,106,0,583,260
2518,743,646,97,73,88,65,130,106,281,0,1689,743
2519,496,405,91,75,56,95,57,66,147,4,1401,500
2520,837,616,221,44,66,88,127,167,345,21,2082,858
2521,1269,967,302,245,273,193,139,146,273,12,3371,1281
2522,761,714,47,77,57,122,97,132,276,2,1280,763
2523,743,426,317,183,180,128,81,66,105,0,2452,743
2524,328,289,39,20,29,37,51,59,132,0,659,328
2525,2345,2030,315,568,652,145,242,224,514,0,5344,2345
2526,771,667,104,187,214,48,80,74,168,10,1490,781
2527,309,268,41,75,86,19,32,29,68,0,662,309
2528,386,336,50,36,54,38,51,62,145,12,1002,398
2529,290,253,37,27,41,28,39,46,109,19,768,309
2530,641,559,82,60,90,62,85,102,242,0,1463,641
2531,580,505,75,57,69,51,101,82,220,25,1281,605
2532,455,347,108,88,98,69,50,53,97,0,917,455
2533,303,217,86,12,14,36,49,68,124,0,670,303
2534,1670,1369,301,251,234,286,193,227,479,33,5466,1703
2535,633,496,137,101,100,111,71,84,166,0,1061,633
2536,282,231,51,42,40,48,33,38,81,0,446,282
2537,1627,1334,293,245,228,278,188,221,467,0,3547,1627
2538,224,158,66,16,19,26,35,42,86,0,665,224
2539,671,473,198,47,57,78,106,125,258,0,1911,671
2540,288,184,104,10,13,37,37,69,122,17,909,305
2541,711,618,93,8,47,68,102,151,335,0,1556,711
2542,2041,1417,624,230,242,298,288,328,655,37,5722,2078
2543,1232,1010,222,185,173,211,142,168,353,0,3274,1232
2544,316,248,68,50,50,55,36,42,83,8,829,324
2545,396,310,86,63,63,70,45,53,102,29,990,425
2546,607,292,315,87,80,121,75,78,166,0,1936,607
2547,213,102,111,30,28,43,26,27,59,0,718,213
2548,439,211,228,63,58,88,54,56,120,89,1348,528
2549,479,230,249,68,63,96,59,62,131,0,1648,479
2550,380,281,99,37,44,66,47,58,128,0,1093,380
2551,281,186,95,29,32,50,40,42,88,6,964,287
2552,407,270,137,42,47,73,58,61,126,0,1315,407
2553,323,214,109,33,37,58,46,49,100,46,1022,369
2554,384,212,172,31,34,86,56,61,116,0,1367,384
2555,287,158,129,23,25,64,42,45,88,0,1032,287
2556,465,257,208,38,41,104,68,74,140,0,1678,465
2557,547,431,116,106,94,100,63,64,120,0,1486,547
2558,393,310,83,76,67,72,45,46,87,0,897,393
2559,516,407,109,100,89,95,59,61,112,10,1156,526
2560,509,401,108,99,87,93,58,60,112,35,1231,544
2561,333,158,175,74,105,46,33,28,47,0,1269,333
2562,600,285,315,134,189,83,60,51,83,12,2350,612
2563,1174,557,617,262,369,163,117,100,163,0,4246,1174
2564,441,253,188,109,107,76,48,39,62,0,1393,441
2565,529,304,225,130,128,91,57,47,76,0,1622,529
2566,849,487,362,209,206,146,92,75,121,14,2082,863
2567,911,534,377,222,252,144,95,73,125,0,2844,911
2568,484,284,200,118,134,76,51,39,66,0,1475,484
2569,374,219,155,91,104,59,39,30,51,12,1170,386
2570,446,270,176,77,80,93,56,49,91,0,1415,446
2571,461,279,182,79,83,96,58,51,94,12,1385,473
2572,616,373,243,106,111,128,77,68,126,0,1917,616
2573,1106,902,204,166,126,213,126,148,327,2,2799,1108
2574,872,579,293,157,184,127,104,101,199,364,2612,1236
2575,769,510,259,139,162,112,91,89,176,46,2354,815
2576,487,323,164,88,103,71,58,56,111,17,1427,504
2577,948,629,319,171,200,138,113,110,216,6,2766,954
2578,968,688,280,238,210,144,91,104,181,23,2779,991
2579,653,464,189,161,142,97,62,70,121,46,1619,699
2580,597,514,83,94,93,87,64,85,174,0,1221,597
2581,759,494,265,121,176,117,107,104,134,66,2451,825
2582,452,311,141,49,63,77,66,70,127,0,1104,452
2583,549,377,172,60,77,93,80,85,154,14,1578,563
2584,910,499,411,99,119,163,128,135,266,0,2956,910
2585,791,693,98,193,181,41,95,78,203,0,1659,791
2586,1411,1236,175,344,322,73,169,140,363,2,3073,1413
2587,587,531,56,94,85,82,60,74,192,0,1365,587
2588,670,606,64,107,97,94,69,84,219,4,1495,674
2589,296,142,154,42,39,59,37,38,81,0,1037,296
2590,308,148,160,44,41,62,38,40,83,0,1042,308
2591,376,286,90,73,81,57,41,43,81,6,1270,382
2592,2084,1355,729,332,482,323,293,286,368,0,6286,2084
2593,247,174,73,17,21,29,39,46,95,0,735,247
2594,563,275,288,78,99,114,73,70,129,0,1916,563
2595,561,274,287,78,99,113,73,70,128,0,2018,561
2596,659,517,142,105,104,116,74,87,173,0,1820,659
2597,308,273,35,8,21,27,51,57,144,4,733,312
2598,308,273,35,8,21,27,51,57,144,0,758,308
2599,448,401,47,23,41,44,66,75,199,25,931,473
2600,530,308,222,59,68,98,65,76,164,0,1769,530
2601,867,504,363,97,111,160,106,124,269,4,2348,871
2602,269,156,113,30,34,50,33,38,84,0,906,269
2603,765,563,202,41,61,80,116,152,315,12,1717,777
2604,290,236,54,25,25,42,34,51,113,0,674,290
2605,377,306,71,32,32,55,44,66,148,19,883,396
2606,983,671,312,58,74,107,74,107,563,0,2767,983
2607,775,680,95,56,40,95,132,135,317,47,1729,822
2608,1885,1524,361,77,71,238,271,406,822,30,4658,1915
2609,1420,1151,269,30,50,194,169,293,684,30,3398,1450
2610,2913,2160,753,90,133,498,295,638,1259,33,7544,2946
2611,1278,854,424,29,40,214,116,306,573,0,3442,1278
2612,399,296,103,8,14,74,30,86,187,0,867,399
2613,1882,1549,333,121,115,319,223,365,739,22,4583,1904
2614,1853,1345,508,62,147,258,246,396,744,8,4415,1861
2615,250,204,46,13,12,38,41,51,95,85,572,335
2616,1193,999,194,44,34,138,154,280,543,14,2742,1207
2617,891,730,161,29,29,108,117,203,405,0,1914,891
2618,2626,2192,434,76,113,346,324,592,1175,30,6045,2656
2619,1606,1500,106,202,250,176,182,241,555,5,3378,1611
2620,1673,1317,356,42,109,208,216,366,732,244,3950,1917
2621,1459,1134,325,74,127,232,185,304,537,49,3968,1508
2622,595,467,128,53,53,96,61,111,221,0,1311,595
2623,223,175,48,20,20,36,23,42,82,5,511,228
2624,2710,2050,660,93,130,462,257,640,1128,0,7080,2710
2625,2038,1577,461,65,109,366,184,490,824,123,4895,2161
2626,1521,1221,300,91,102,286,115,320,607,11,3770,1532
2627,3049,2379,670,222,247,499,322,580,1179,36,6886,3085
2628,2678,1536,1142,205,384,487,266,485,851,22,8395,2700
2629,541,409,132,15,21,94,62,122,227,19,1436,560
2630,987,648,339,26,57,150,130,228,396,0,2536,987
2631,421,303,118,18,17,63,49,100,174,0,1098,421
2632,3432,2612,820,201,219,540,303,794,1375,30,8465,3462
2633,1485,1162,323,25,49,158,211,336,706,30,3535,1515
2634,3167,2309,858,132,156,549,289,721,1320,25,8152,3192
2635,1474,1142,332,45,75,258,125,370,601,0,3815,1474
2636,996,776,220,39,51,108,110,171,517,0,2505,996
2637,547,425,122,28,48,87,69,114,201,208,2537,755
2638,3652,2494,1158,214,276,398,276,396,2092,0,11346,3652
2639,1169,1157,12,413,355,55,151,76,119,161,1910,1330
2640,463,438,25,48,81,65,69,81,119,397,858,860
2641,1217,1137,80,153,189,134,138,183,420,22,2474,1239
2642,690,505,185,43,45,112,73,147,270,5,1697,695
2643,757,550,207,25,60,105,100,162,305,0,1874,757
2644,378,328,50,18,33,61,54,76,136,0,805,378
2645,611,579,32,63,106,86,92,106,158,3,1241,614
2646,608,528,80,29,54,98,87,122,218,0,1368,608
2647,714,539,175,16,32,100,93,167,306,0,1630,714
2648,535,404,131,12,24,75,70,125,229,3,1193,538
2649,517,390,127,12,23,73,68,121,220,0,1347,517
2650,786,613,173,30,40,85,87,135,409,0,1478,786
2651,669,462,207,87,117,149,70,107,139,0,1476,669
2652,574,536,38,72,89,63,65,86,199,0,1396,574
2653,1541,1439,102,194,240,169,174,231,533,0,2465,1541
2654,1894,1769,125,238,295,208,214,284,655,22,2974,1916
2655,1021,634,387,226,359,157,62,91,126,0,3220,1021
2656,10380,6368,4012,1773,2969,1137,600,1263,2638,0,34958,10380
2657,6567,4029,2538,1122,1878,719,380,799,1669,0,21644,6567
2658,805,656,149,43,39,121,133,165,304,0,1761,805
2659,1073,941,132,77,56,131,182,187,440,77,2241,1150
2660,417,288,129,55,73,93,44,67,85,0,1056,417
2661,552,430,122,21,28,60,61,95,287,0,1272,552
2662,843,660,183,14,28,90,120,191,400,14,2050,857
2663,721,544,177,17,32,101,94,168,309,52,1750,773
2664,799,669,130,29,23,92,103,188,364,0,1867,799
2665,250,205,45,8,8,30,33,57,114,0,578,250
2666,586,514,72,42,30,72,100,102,240,0,1374,586
2667,1078,838,240,55,94,172,137,225,395,0,2097,1078
2668,4193,4024,169,1347,1126,694,275,376,375,3,7637,4196
2669,2426,2328,98,779,651,402,159,217,218,98,3689,2524
2670,590,432,158,40,40,116,57,122,215,82,1402,672
2671,474,347,127,32,32,93,46,98,173,14,1182,488
2672,552,433,119,49,49,89,56,103,206,25,1335,577
2673,562,441,121,50,50,91,57,105,209,55,1194,617
2674,454,356,98,40,41,73,46,85,169,16,1100,470
2675,615,484,131,15,40,77,80,134,269,0,1301,615
2676,612,423,189,80,107,136,64,98,127,0,1769,612
2677,780,484,296,172,274,120,47,69,98,0,2296,780
2678,705,487,218,92,124,157,74,113,145,0,1750,705
2679,855,667,188,140,178,116,57,131,233,52,2207,907
2680,477,372,105,78,99,65,32,73,130,0,1189,477
2681,550,478,72,26,49,89,78,110,198,5,1256,555
2682,299,196,103,8,17,45,39,69,121,227,732,526
2683,766,624,142,41,37,115,126,157,290,3,1984,769
2684,720,587,133,39,35,109,119,148,270,0,1864,720
2685,466,363,103,76,97,63,31,72,127,30,1151,496
2686,504,381,123,14,19,88,58,114,211,25,1281,529
2687,125,103,22,8,8,21,15,24,49,0,252,125
2688,76,63,13,5,5,13,9,15,29,38,170,114
2689,1208,994,214,77,74,205,143,234,475,137,2566,1345
2690,375,306,69,20,18,57,62,77,141,0,800,375
2691,287,234,53,15,14,43,47,59,109,5,654,292
2692,3119,2431,688,121,161,337,343,536,1621,200,7567,3319
2693,593,497,96,22,17,68,77,139,270,14,1522,607
2694,668,548,120,22,22,81,88,152,303,25,1527,693
2695,437,317,120,15,35,61,58,93,175,49,942,486
2696,595,435,160,40,41,117,57,123,217,27,1640,622
2697,636,465,171,43,43,125,61,131,233,5,1692,641
2698,387,283,104,24,25,63,41,82,152,8,1095,395
2699,590,432,158,37,39,96,63,126,229,36,1679,626
2700,374,274,100,23,24,61,40,80,146,5,994,379
2701,630,494,136,56,56,102,64,117,235,0,1263,630
2702,1120,1034,86,181,258,87,98,132,364,0,1860,1120
2703,2329,1996,333,110,160,345,298,452,964,60,5441,2389
2704,2279,1801,478,46,79,298,327,476,1053,20,5383,2299
2705,1196,972,224,32,52,144,133,285,550,12,2841,1208
2706,2178,1740,438,38,69,251,271,510,1039,54,5735,2232
2707,1646,1391,255,61,90,195,227,309,764,38,3429,1684
2708,1345,1117,228,43,68,190,186,272,586,22,3190,1367
2709,590,502,88,59,66,72,72,103,218,4,1424,594
2710,1488,1185,303,37,62,200,228,296,665,14,3608,1502
2711,6554,6552,2,416,608,1112,676,1157,2585,0,7751,6554
2712,1098,961,137,57,57,104,143,270,467,2162,2599,3260
2713,574,480,94,87,137,77,76,64,133,0,1576,574
2714,181,151,30,27,43,24,24,20,43,0,542,181
2715,753,566,187,10,23,96,105,181,338,0,2009,753
2716,1885,1628,257,79,92,193,243,453,825,1271,4869,3156
2717,3635,2965,670,191,230,413,429,782,1590,0,8471,3635
2718,1579,1393,186,87,134,205,194,295,664,0,3568,1579
2719,498,387,111,34,37,56,68,97,206,0,1324,498
2720,1306,1064,242,290,293,81,108,179,355,0,3345,1306
2721,1221,895,326,22,33,122,184,286,574,14,3194,1235
2722,275,220,55,9,12,33,34,65,122,0,697,275
2723,721,585,136,13,24,81,107,169,327,0,1881,721
2724,1197,1096,101,141,179,108,131,149,489,0,2662,1197
2725,2008,1780,228,85,138,296,262,387,840,60,4627,2068
2726,1213,943,270,84,91,137,167,237,497,0,3232,1213
2727,3675,3391,284,595,847,284,322,433,1194,54,6250,3729
2728,1490,1373,117,267,350,155,161,148,409,14,2702,1504
2729,4861,4479,382,873,1141,507,525,482,1333,0,9621,4861
2730,657,603,54,30,42,86,84,126,289,0,1200,657
2731,434,398,36,20,28,57,55,83,191,0,1049,434
2732,939,861,78,43,61,123,120,180,412,2,1727,941
2733,2982,2748,234,535,700,311,322,296,818,62,4718,3044
2734,1910,1749,161,224,286,172,209,237,782,0,3984,1910
2735,1442,1195,247,113,138,188,199,218,586,6,3152,1448
2736,576,487,89,21,31,68,79,108,269,0,1432,576
2737,404,371,33,18,26,53,51,77,179,2,752,406
2738,632,582,50,113,148,66,68,63,174,0,1211,632
2739,2450,1882,568,525,696,158,198,296,577,4,6386,2454
2740,282,225,57,9,13,34,35,67,124,0,728,282
2741,464,371,93,15,21,56,58,110,204,0,1220,464
2742,272,225,47,21,26,35,38,41,111,0,696,272
2743,528,438,90,41,50,69,73,80,215,0,1267,528
2744,680,564,116,53,65,89,94,103,276,24,1585,704
2745,1148,977,171,114,128,140,141,200,425,4,2168,1152
2746,794,659,135,65,63,78,91,167,330,50,1922,844
2747,2730,2265,465,224,216,270,314,575,1131,14,6651,2744
2748,1627,1490,137,191,244,146,178,202,666,0,2832,1627
2749,271,229,42,10,15,32,37,51,126,20,674,291
2750,803,679,124,30,44,95,111,151,372,0,1974,803
2751,848,704,144,27,43,120,117,171,370,14,1712,862
2752,349,299,50,17,24,52,45,68,143,12,1007,361
2753,642,546,96,64,72,78,79,112,237,0,1441,642
2754,637,518,119,54,78,74,81,107,243,0,1666,637
2755,1349,1129,220,204,322,180,180,151,312,0,3091,1349
2756,730,561,169,156,207,47,59,88,173,32,1937,762
2757,860,700,160,73,105,99,109,145,329,14,1883,874
2758,1271,1034,237,109,155,147,162,214,484,0,3066,1271
2759,2320,1941,379,351,554,309,309,260,537,0,4364,2320
2760,440,331,109,6,13,56,62,106,197,0,1202,440
2761,877,660,217,12,27,112,123,211,392,0,2308,877
2762,563,450,113,18,26,68,70,133,248,6,1504,569
2763,3024,2463,561,673,677,187,251,414,822,14,5817,3038
2764,609,496,113,135,136,38,51,83,166,0,1547,609
2765,817,658,159,75,91,103,84,169,295,0,2090,817
2766,2476,1740,736,76,107,314,353,514,1112,49,7326,2525
2767,3001,2136,865,106,154,393,384,656,1308,82,8239,3083
2768,385,250,135,6,14,47,60,85,173,0,1121,385
2769,2036,1500,536,93,129,304,301,383,826,46,5273,2082
2770,1313,1032,281,35,48,142,194,309,585,0,3134,1313
2771,15131,9923,5208,561,1198,1692,2348,3314,6018,352,44318,15483
2772,4023,2998,1025,67,104,505,579,918,1850,18,9993,4041
2773,2549,2152,397,135,141,206,375,494,1198,0,5328,2549
2774,3243,2407,836,141,147,320,446,645,1544,0,9234,3243
2775,6357,5021,1336,352,498,878,828,1238,2563,44,15672,6401
2776,2011,1621,390,101,138,198,273,388,913,0,4369,2011
2777,1972,1435,537,29,66,278,248,454,897,54,5282,2026
2778,2810,2099,711,40,96,409,422,607,1236,10,6655,2820
2779,4077,2797,1280,82,153,517,613,945,1767,15,10552,4092
2780,1367,822,545,38,70,154,203,281,621,0,4114,1367
2781,1266,1021,245,63,87,125,172,244,575,0,3332,1266
2782,242,180,62,11,11,24,33,48,115,0,710,242
2783,548,329,219,15,28,62,82,113,248,0,1474,548
2784,489,294,195,14,25,55,73,100,222,18,1416,507
2785,1446,1166,280,72,99,142,197,279,657,0,2638,1446
2786,586,352,234,16,30,66,87,120,267,8,1545,594
2787,362,235,127,5,13,44,57,80,163,3,1046,365
2788,540,350,190,8,20,66,84,119,243,10,1582,550
2789,4008,3383,625,212,222,325,590,776,1883,0,9696,4008
2790,1283,952,331,56,58,127,177,255,610,0,2793,1283
2791,3259,2419,840,142,148,322,448,649,1550,0,8961,3259
2792,1799,1339,460,52,100,311,260,439,637,49,5166,1848
2793,1527,1153,374,171,228,255,212,226,435,8,4435,1535
2794,1090,711,379,180,193,177,151,137,252,133,3184,1223
2795,1379,867,512,295,263,255,148,149,269,2,3573,1381
2796,448,309,139,28,43,71,56,93,157,0,1314,448
2797,1306,934,372,101,122,254,211,225,393,35,3224,1341
2798,335,201,134,16,30,69,46,55,119,6,1110,341
2799,1334,1176,158,114,140,243,177,243,417,31,2830,1365
2800,1328,707,621,46,88,223,184,310,477,23,4555,1351
2801,1997,1191,806,159,242,289,273,395,639,0,6636,1997
2802,2178,1421,757,104,162,339,298,481,794,0,7152,2178
2803,1486,1070,416,108,152,253,276,215,482,0,4449,1486
2804,1301,877,424,42,93,218,207,223,518,12,4046,1313
2805,2372,1599,773,77,170,398,377,407,943,21,6165,2393
2806,635,490,145,138,171,80,81,65,100,16,1862,651
2807,2988,2179,809,155,225,516,507,547,1038,57,8680,3045
2808,1246,821,425,149,193,184,169,193,358,31,3473,1277
2809,198,131,67,24,31,29,27,31,56,0,625,198
2810,1633,877,756,80,154,302,242,299,556,8,5952,1641
2811,7422,4161,3261,277,345,1194,894,1716,2996,135,23578,7557
2812,2057,1190,867,49,105,308,289,504,802,0,6515,2057
2813,1437,831,606,34,73,215,202,352,561,6,4262,1443
2814,5945,4424,1521,173,332,1028,861,1451,2100,164,16061,6109
2815,228,170,58,7,13,39,33,56,80,0,611,228
2816,371,191,180,19,40,71,49,64,128,4,1348,375
2817,952,557,395,45,80,140,137,200,350,6,2909,958
2818,225,148,77,27,35,33,31,35,64,0,751,225
2819,988,594,394,48,89,203,134,161,353,0,3114,988
2820,435,256,179,36,45,71,60,86,137,88,1342,523
2821,123,81,42,15,19,18,17,19,35,0,367,123
2822,837,499,338,67,101,121,114,166,268,0,2475,837
2823,1930,1129,801,91,163,284,278,405,709,0,6744,1930
2824,692,408,284,57,72,113,95,137,218,14,1436,706
2825,866,510,356,71,90,141,119,172,273,2,2634,868
2826,584,344,240,48,61,95,80,116,184,6,1750,590
2827,1117,594,523,38,74,187,155,260,403,2,3581,1119
2828,890,474,416,31,59,149,123,208,320,0,2797,890
2829,772,455,317,63,80,126,106,153,244,27,2161,799
2830,1378,1063,315,300,372,175,176,140,215,0,3671,1378
2831,725,419,306,17,37,109,102,178,282,12,2196,737
2832,898,620,278,56,86,143,112,186,315,21,2713,919
2833,539,381,158,79,80,94,84,67,135,80,1270,619
2834,1051,836,215,173,219,152,149,143,215,59,2604,1110
2835,2692,1575,1117,128,227,397,388,565,987,0,9071,2692
2836,442,260,182,36,46,72,61,88,139,0,1318,442
2837,3277,1874,1403,727,1212,281,128,355,574,0,9743,3277
2838,1117,639,478,248,413,96,44,121,195,6,3226,1123
2839,1020,590,430,24,52,153,143,250,398,0,3509,1020
2840,565,372,193,68,87,83,77,87,163,59,1776,624
2841,205,132,73,39,47,37,22,21,39,0,614,205
2842,517,333,184,99,117,93,55,52,101,4,1690,521
2843,613,341,272,63,83,121,85,93,168,0,2074,613
2844,759,537,222,111,112,132,118,95,191,18,1869,777
2845,458,324,134,67,68,80,71,57,115,199,1118,657
2846,364,258,106,53,54,63,56,45,93,55,986,419
2847,580,431,149,51,66,97,83,108,175,33,1551,613
2848,509,378,131,45,58,85,73,95,153,8,1383,517
2849,850,631,219,75,97,142,122,158,256,84,2460,934
2850,726,539,187,64,83,121,104,135,219,0,2170,726
2851,2010,1475,535,204,261,293,231,371,650,0,5361,2010
2852,232,167,65,17,24,39,43,34,75,0,666,232
2853,535,369,166,34,51,85,67,111,187,0,1537,535
2854,1124,776,348,71,108,178,141,233,393,0,3053,1124
2855,444,242,202,43,53,90,63,70,125,0,1409,444
2856,387,211,176,38,47,79,55,61,107,0,1193,387
2857,981,572,409,171,279,163,102,85,181,59,3147,1040
2858,625,364,261,109,178,104,65,54,115,0,2270,625
2859,361,210,151,63,103,60,37,31,67,0,1073,361
2860,931,616,315,174,218,183,104,89,163,0,2426,931
2861,480,370,110,104,129,61,61,49,76,2,1146,482
2862,1745,1346,399,380,470,221,222,177,275,0,3860,1745
2863,442,227,215,22,48,85,58,76,153,6,1447,448
2864,849,441,408,128,180,144,127,105,165,0,3018,849
2865,682,450,232,82,106,101,92,105,196,0,2121,682
2866,393,236,157,19,35,81,53,64,141,0,1202,393
2867,657,465,192,96,97,115,102,82,165,0,1825,657
2868,1705,998,707,81,144,251,246,358,625,2,5305,1707
2869,401,223,178,41,54,79,56,61,110,23,1400,424
2870,917,509,408,94,124,181,127,140,251,0,2873,917
2871,401,258,143,77,91,72,43,40,78,0,1284,401
2872,1556,1002,554,299,353,280,165,156,303,8,4423,1564
2873,458,340,118,40,52,76,66,85,139,0,1298,458
2874,1319,968,351,134,171,192,151,244,427,2,4125,1321
2875,527,419,108,87,110,76,75,72,107,0,1382,527
2876,1054,575,479,103,127,214,150,166,294,0,3926,1054
2877,665,438,227,80,103,98,90,103,191,0,1842,665
2878,487,251,236,25,53,94,64,84,167,0,1604,487
2879,11,7,4,1,1,2,2,2,3,66,30,77
2880,1200,716,484,96,145,173,164,238,384,0,3765,1200
2881,2403,1433,970,192,291,347,328,476,769,6,7205,2409
2882,1380,823,557,110,167,199,189,273,442,174,3702,1554
2883,1433,855,578,114,174,207,196,284,458,4,4197,1437
2884,830,541,289,40,62,129,113,183,303,14,2627,844
2885,466,304,162,22,35,73,64,103,169,0,1490,466
2886,646,421,225,31,48,101,88,143,235,0,1921,646
2887,546,356,190,26,41,85,75,121,198,0,1585,546
2888,612,399,213,29,45,95,84,135,224,4,1593,616
2889,782,510,272,37,58,122,107,173,285,6,2088,788
2890,1479,965,514,71,110,230,202,327,539,23,4650,1502
2891,2028,1323,705,97,151,316,277,448,739,0,3699,2028
2892,859,560,299,41,64,134,117,190,313,4,2767,863
2893,3536,2307,1229,169,263,550,483,781,1290,25,10240,3561
2894,4479,2922,1557,215,333,697,612,989,1633,55,14729,4534
2895,784,511,273,38,58,122,107,173,286,10,2666,794
2896,2907,1547,1360,100,193,488,402,678,1046,16,9924,2923
2897,63,47,16,2,4,11,9,15,22,0,176,63
2898,4390,3868,522,377,461,801,581,801,1369,0,13016,4390
2899,3699,2455,1244,124,199,542,586,776,1472,41,11111,3740
2900,1165,869,296,43,71,214,174,246,417,24,3258,1189
2901,1234,956,278,56,76,212,172,265,453,17,3001,1251
2902,1127,873,254,29,59,173,159,265,442,48,3451,1175
2903,1426,861,565,56,83,255,238,275,519,29,4681,1455
2904,3072,2173,899,78,139,445,454,727,1229,29,7975,3101
2905,1154,839,315,156,152,197,150,185,314,725,2592,1879
2906,281,208,73,32,14,40,50,53,92,0,823,281
2907,782,629,153,30,52,133,113,171,283,0,2049,782
2908,2372,1845,527,81,126,376,345,528,916,56,6601,2428
2909,1760,1332,428,127,161,304,264,311,593,15,4471,1775
2910,781,581,200,25,42,123,110,168,313,53,2131,834
2911,622,426,196,130,163,81,66,72,110,19,1798,641
2912,884,570,314,53,61,172,165,164,269,0,2330,884
2913,329,204,125,9,15,52,51,73,129,27,1174,356
2914,1621,982,639,37,68,265,263,375,613,36,5240,1657
2915,1286,932,354,37,52,183,198,292,524,0,3147,1286
2916,1347,1044,303,50,58,229,209,318,483,0,3231,1347
2917,269,196,73,19,25,48,38,50,89,114,538,383
2918,1956,1789,167,102,94,343,244,428,745,10,3713,1966
2919,1675,1291,384,71,80,242,230,390,662,29,4099,1704
2920,1625,1204,421,54,78,244,241,352,656,29,4150,1654
2921,1982,1165,817,43,73,300,326,472,768,17,5660,1999
2922,1665,1307,358,54,79,252,223,393,664,0,4112,1665
2923,1221,937,284,92,104,185,190,240,410,12,2718,1233
2924,803,507,296,100,126,150,121,108,198,24,2107,827
2925,865,622,243,64,62,162,156,153,268,0,1972,865
2926,349,216,133,10,16,55,54,78,136,17,1210,366
2927,439,286,153,12,25,70,64,94,174,0,1511,439
2928,956,655,301,201,250,125,101,110,169,2,2738,958
2929,601,471,130,241,205,48,41,28,38,7,1122,608
2930,995,780,215,399,340,80,68,46,62,261,1882,1256
2931,381,296,85,61,54,70,65,46,85,0,925,381
2932,431,354,77,15,27,69,64,96,160,0,924,431
2933,417,324,93,66,59,76,71,51,94,0,968,417
2934,405,315,90,64,57,74,69,49,92,0,1050,405
2935,347,219,128,43,55,65,52,47,85,0,822,347
2936,320,226,94,13,20,61,45,61,120,10,783,330
2937,317,224,93,13,20,60,44,61,119,19,855,336
2938,507,359,148,21,31,97,71,97,190,0,1369,507
2939,466,382,84,16,29,74,69,103,175,0,1023,466
2940,326,267,59,11,20,52,48,72,123,0,732,326
2941,597,480,117,23,40,102,86,130,216,0,1557,597
2942,335,232,103,27,29,67,56,57,99,0,1001,335
2943,490,340,150,40,42,98,81,84,145,5,1445,495
2944,788,563,225,95,95,149,126,126,197,0,1694,788
2945,300,214,86,36,36,57,48,48,75,17,714,317
2946,575,413,162,43,41,108,104,101,178,87,1496,662
2947,342,223,119,9,19,55,50,73,136,39,1219,381
2948,382,249,133,10,22,61,56,82,151,39,1411,421
2949,822,598,224,59,77,145,115,153,273,94,2038,916
2950,649,472,177,46,61,115,91,121,215,36,1451,685
2951,292,173,119,9,17,49,46,67,104,12,873,304
2952,515,306,209,16,30,86,82,118,183,0,1699,515
2953,233,138,95,7,14,39,37,53,83,12,853,245
2954,558,331,227,18,33,94,89,128,196,29,1943,587
2955,573,397,176,46,49,114,95,98,171,0,1623,573
2956,1334,1172,162,310,309,178,135,141,261,75,2649,1409
2957,323,200,123,9,15,51,50,72,126,31,1113,354
2958,252,164,88,7,14,40,37,54,100,7,738,259
2959,858,690,168,33,57,146,123,187,312,5,2076,863
2960,12,8,4,1,2,2,2,2,3,0,14,12
2961,381,216,165,53,122,37,45,48,76,0,1089,381
2962,1787,1008,779,48,111,297,302,394,635,5,5529,1792
2963,740,331,409,56,111,115,115,152,191,2000,2255,2740
2964,5648,3487,2161,242,543,864,925,1246,1828,0,16377,5648
2965,1187,794,393,48,113,186,174,243,423,0,3506,1187
2966,1,0,1,0,0,0,0,0,1,0,3,1
2967,605,431,174,69,113,96,88,105,134,0,1780,605
2968,1182,822,360,54,105,196,180,253,394,0,3060,1182
2969,2076,1634,442,88,144,331,323,459,731,0,4937,2076
2970,7764,6232,1532,446,757,1564,995,1623,2379,5,15455,7769
2971,1264,942,322,31,63,183,199,328,460,0,3075,1264
2972,3343,2683,660,219,322,557,528,621,1096,93,8477,3436
2973,431,263,168,16,31,79,77,82,146,0,1213,431
2974,1203,767,436,106,181,230,205,175,306,41,3316,1244
2975,792,591,201,21,39,114,117,193,308,0,1796,792
2976,662,345,317,20,48,96,102,157,239,0,2008,662
2977,2535,1880,655,137,232,338,404,529,895,11,6947,2546
2978,4288,3168,1120,114,261,613,639,978,1683,68,10625,4356
2979,6107,3905,2202,384,673,830,948,1163,2109,14,18225,6121
2980,1748,1103,645,160,237,306,294,286,465,183,5067,1931
2981,1646,1115,531,195,266,285,265,256,379,55,5219,1701
2982,1185,737,448,133,188,200,185,198,281,14,3552,1199
2983,2072,1332,740,131,203,371,345,371,651,44,5918,2116
2984,1624,985,639,79,131,262,252,341,559,16,4596,1640
2985,1193,646,547,35,73,183,204,283,415,0,3431,1193
2986,1662,1187,475,124,180,281,305,282,490,0,5000,1662
2987,2563,2109,454,142,225,442,365,530,859,0,4727,2563
2988,1581,1251,330,35,105,246,234,391,570,16,3798,1597
2989,6018,4747,1271,308,648,754,772,1188,2348,35,14731,6053
2990,1045,673,372,19,69,175,168,242,372,0,2838,1045
2991,1926,1220,706,55,128,280,318,422,723,16,5243,1942
2992,472,381,91,19,41,74,71,97,170,5,1077,477
2993,2309,1610,699,126,261,431,332,412,747,0,5524,2309
2994,1439,1240,199,78,89,263,199,302,508,8,3987,1447
2995,4191,2541,1650,177,384,652,655,873,1450,11,12023,4202
2996,1499,1084,415,95,175,268,216,289,456,0,3690,1499
2997,775,550,225,34,68,125,113,170,265,35,2300,810
2998,949,579,370,36,67,175,170,182,319,16,2936,965
2999,1074,608,466,150,345,103,126,136,214,0,3407,1074
3000,492,316,176,21,47,81,83,102,158,0,1436,492
3001,984,631,353,43,95,162,166,205,313,3,2954,987
3002,399,256,143,17,38,66,67,83,128,0,991,399
3003,673,447,226,55,110,102,103,119,184,0,1950,673
3004,654,420,234,28,63,107,111,136,209,0,2080,654
3005,0,0,0,0,0,0,0,0,0,0,0,0
3006,6063,3877,2186,381,668,824,942,1154,2094,0,20285,6063
3007,527,338,189,23,51,87,89,110,167,0,1459,527
3008,644,428,216,53,105,98,99,113,176,0,2148,644
3009,701,466,235,58,114,106,107,124,192,0,2382,701
3010,461,296,165,20,44,76,78,96,147,0,1487,461
3011,436,290,146,36,71,66,67,77,119,0,1313,436
3012,267,178,89,27,46,36,39,46,73,11,790,278
3013,32,21,11,3,6,4,5,6,8,0,67,32
3014,400,266,134,41,69,54,59,69,108,0,1027,400
3015,852,509,343,62,86,157,135,153,259,11,2462,863
3016,504,285,219,70,162,48,59,64,101,0,1447,504
3017,674,448,226,69,117,91,99,116,182,0,1458,674
3018,459,260,199,24,36,96,81,85,137,14,1565,473
3019,177,126,51,8,15,29,26,39,60,0,470,177
3020,394,235,159,29,40,73,62,71,119,3,1024,397
3021,383,304,79,78,85,48,55,47,70,49,1000,432
3022,644,463,181,70,96,120,110,104,144,46,1645,690
3023,228,164,64,25,34,42,39,37,51,22,615,250
3024,337,267,70,69,75,43,49,42,59,3,803,340
3025,530,300,230,28,42,111,93,98,158,16,1802,546
3026,406,243,163,30,41,75,64,73,123,0,1148,406
3027,1368,1021,347,37,67,197,202,334,531,8,4138,1376
3028,1373,1024,349,37,68,198,203,335,532,0,3875,1373
3029,2477,1292,1185,74,181,359,381,586,896,0,7417,2477
3030,782,408,374,23,57,113,120,185,284,8,2313,790
3031,198,160,38,8,17,31,30,41,71,19,565,217
3032,278,224,54,11,24,44,42,57,100,0,699,278
3033,974,786,188,40,84,153,146,199,352,14,2298,988
3034,431,307,124,49,81,68,63,75,95,0,959,431
3035,303,216,87,35,57,48,44,52,67,0,529,303
3036,263,187,76,30,49,42,38,45,59,0,639,263
3037,654,466,188,75,123,104,95,113,144,0,1046,654
3038,657,541,116,36,58,113,94,136,220,0,1908,657
3039,696,573,123,39,61,120,99,144,233,0,1726,696
3040,509,419,90,28,45,88,73,105,170,0,1079,509
3041,15,11,4,1,1,2,2,3,6,0,51,15
3042,1,1,0,0,0,0,0,0,1,0,2,1
3043,0,0,0,0,0,0,0,0,0,0,0,0
3044,0,0,0,0,0,0,0,0,0,0,0,0
3045,5,4,1,0,0,1,1,1,2,0,14,5
3046,1112,739,373,114,193,150,163,191,301,16,3233,1128
3047,291,194,97,15,27,45,49,53,102,0,856,291
3048,3418,2480,938,209,314,537,492,649,1217,69,8940,3487
3049,2295,1412,883,86,219,388,328,427,847,37,6468,2332
3050,1776,1380,396,63,127,295,224,372,695,112,4061,1888
3051,2685,1959,726,302,407,415,356,416,789,8,7541,2693
3052,2468,1780,688,110,189,393,327,530,919,37,5642,2505
3053,1182,887,295,37,70,198,168,239,470,3,2774,1185
3054,2299,1828,471,96,189,385,331,440,858,88,4946,2387
3055,40,40,0,7,8,5,3,8,9,124,41,164
3056,1758,1056,702,63,144,249,267,363,672,93,5997,1851
3057,3170,2396,774,280,386,542,468,603,891,0,9671,3170
3058,338,238,100,22,36,53,44,69,114,0,852,338
3059,1127,777,350,85,140,171,164,195,372,0,3252,1127
3060,798,500,298,31,77,148,111,173,258,2,2042,800
3061,420,336,84,21,33,68,56,85,157,12,1057,432
3062,628,502,126,31,50,101,83,128,235,0,1491,628
3063,570,461,109,71,101,87,75,86,150,0,1429,570
3064,268,217,51,34,47,41,35,40,71,279,507,547
3065,444,313,131,30,47,70,58,91,148,0,979,444
3066,465,327,138,31,49,73,60,95,157,30,1014,495
3067,1076,773,303,78,101,170,156,199,372,22,2748,1098
3068,480,347,133,50,71,76,59,72,152,14,1167,494
3069,505,409,96,63,89,77,67,76,133,261,832,766
3070,434,289,145,23,40,67,73,79,152,0,1396,434
3071,913,608,305,48,84,141,154,166,320,0,2454,913
3072,1004,721,283,73,94,159,145,186,347,0,2986,1004
3073,371,268,103,39,54,59,45,56,118,0,704,371
3074,849,585,264,64,105,129,123,147,281,0,2327,849
3075,1213,836,377,92,151,184,176,210,400,86,3087,1299
3076,578,462,116,29,46,93,77,117,216,0,1358,578
3077,440,316,124,32,41,69,64,81,153,0,1142,440
3078,411,295,116,30,39,65,60,76,141,149,918,560
3079,418,300,118,30,39,66,61,77,145,0,1207,418
3080,522,313,209,19,43,74,79,108,199,0,1883,522
3081,655,393,262,24,54,93,100,135,249,0,2355,655
3082,562,425,137,50,68,96,83,107,158,10,2035,572
3083,927,701,226,82,113,158,137,176,261,0,2938,927
3084,1169,1051,118,65,105,173,150,256,420,145,1935,1314
3085,2764,2180,584,188,277,478,384,545,892,234,6019,2998
3086,885,668,217,37,78,155,135,190,290,24,1873,909
3087,2131,1649,482,168,258,405,341,393,566,49,4678,2180
3088,1949,1628,321,107,149,326,267,398,702,26,4509,1975
3089,2775,2251,524,81,166,432,350,611,1135,86,6338,2861
3090,1015,821,194,43,78,195,140,210,349,37,2437,1052
3091,1917,1763,154,66,115,317,330,395,694,2399,4815,4316
3092,733,610,123,35,51,142,101,162,242,153,1487,886
3093,5,3,2,0,0,1,1,1,2,0,14,5
3094,547,328,219,20,45,78,83,113,208,0,2474,547
3095,1,1,0,0,0,0,0,0,1,0,3,1
3096,1,1,0,0,0,0,0,0,1,0,3,1
3097,0,0,0,0,0,0,0,0,0,0,0,0
3098,0,0,0,0,0,0,0,0,0,0,0,0
3099,1,1,0,0,0,0,0,0,1,0,5,1
3100,0,0,0,0,0,0,0,0,0,0,0,0
3101,301,244,57,9,18,47,38,66,123,37,788,338
3102,319,259,60,9,19,50,40,70,131,0,869,319
3103,193,157,36,6,12,30,24,42,79,18,451,211
3104,1027,874,153,43,85,223,116,211,349,5,2357,1032
3105,2283,2121,162,90,198,412,321,457,805,24,4206,2307
3106,2243,1641,602,76,182,436,282,471,796,55,5675,2298
3107,2203,1833,370,85,189,403,314,465,747,143,4510,2346
3108,3459,2593,866,171,313,591,374,673,1337,0,8815,3459
3109,1503,1112,391,70,159,232,185,304,553,0,3807,1503
3110,3026,2251,775,200,312,447,383,543,1141,69,7234,3095
3111,6232,4653,1579,684,1072,918,569,1037,1952,79,16008,6311
3112,460,372,88,62,46,92,38,80,142,0,1245,460
3113,1499,1342,157,188,147,285,122,274,483,5,3429,1504
3114,539,384,155,60,98,91,59,84,147,12,1309,551
3115,1540,1366,174,151,144,314,155,297,479,0,3188,1540
3116,451,404,47,32,58,75,52,85,149,4130,1433,4581
3117,940,753,187,91,86,191,75,176,321,0,2618,940
3118,3525,3102,423,644,918,478,235,437,813,497,7786,4022
3119,1639,1374,265,87,130,311,147,349,615,0,4092,1639
3120,763,632,131,36,76,128,108,131,284,0,1973,763
3121,487,436,51,33,23,109,37,96,189,2,882,489
3122,1061,951,110,71,49,237,80,209,415,0,2320,1061
3123,1674,1331,343,96,143,233,183,322,697,19,3979,1693
3124,1791,1459,332,66,131,366,213,340,675,801,4763,2592
3125,2500,2238,262,314,245,475,204,457,805,141,5796,2641
3126,2893,2366,527,573,653,505,290,333,539,0,6857,2893
3127,482,359,123,24,47,77,59,99,176,0,1265,482
3128,4350,3733,617,219,337,591,415,816,1972,22,9783,4372
3129,3205,2585,620,223,243,687,281,658,1113,0,7805,3205
3130,4018,3515,503,231,392,724,512,796,1363,0,8312,4018
3131,2550,2279,271,128,244,512,328,479,859,50,4756,2600
3132,3414,2278,1136,239,431,618,437,680,1009,29,9116,3443
3133,1624,1181,443,75,174,249,194,318,614,22,4951,1646
3134,1356,1105,251,52,84,249,146,324,501,118,3265,1474
3135,3968,3871,97,163,346,789,575,809,1286,0,6271,3968
3136,2119,1689,430,114,180,420,280,430,695,23,4649,2142
3137,5095,4166,929,190,360,945,594,1113,1893,67,11264,5162
3138,1369,1068,301,67,104,285,177,301,435,13,3119,1382
3139,3298,2638,660,99,250,606,432,721,1190,69,8165,3367
3140,872,712,160,86,122,155,103,141,265,14,2494,886
3141,1274,1019,255,181,295,207,91,196,304,0,3028,1274
3142,1367,1122,245,219,304,220,176,164,284,420,2912,1787
3143,1646,1321,325,171,229,315,237,270,424,92,3346,1738
3144,1681,1163,518,113,161,318,216,337,536,31,4030,1712
3145,1956,1297,659,78,146,357,284,435,656,64,5110,2020
3146,1267,987,280,229,368,183,155,149,183,31,3391,1298
3147,1325,742,583,167,268,222,192,184,292,38,4394,1363
3148,504,305,199,59,87,84,67,83,124,13,1824,517
3149,1520,834,686,145,226,267,235,260,387,51,4447,1571
3150,599,329,270,57,89,105,93,103,152,20,1738,619
3151,2601,2152,449,177,234,494,307,555,834,0,5713,2601
3152,3491,2564,927,127,285,714,472,773,1120,31,9162,3522
3153,2195,1583,612,94,160,410,275,463,793,18,5849,2213
3154,2065,1614,451,400,613,296,255,223,278,15,6045,2080
3155,991,686,305,97,141,183,133,163,274,28,2718,1019
3156,2370,1705,665,80,164,428,344,559,795,44,6625,2414
3157,2483,1910,573,176,267,475,316,468,781,38,6535,2521
3158,1202,544,658,84,105,232,209,222,350,279,4278,1481
3159,2305,1356,949,243,328,397,358,382,597,79,6648,2384
3160,756,500,256,41,71,139,107,150,248,67,2227,823
3161,1766,1464,302,82,177,303,237,348,619,38,3840,1804
3162,1715,1409,306,176,169,333,192,340,505,13,3935,1728
3163,1785,1461,324,83,117,320,210,389,666,23,4123,1808
3164,1598,1323,275,79,105,309,204,351,550,0,3732,1598
3165,2266,1878,388,120,155,436,283,520,752,187,5224,2453
3166,2708,1581,1127,247,445,498,417,441,660,54,8096,2762
3167,3740,2559,1181,372,567,712,528,634,927,59,10043,3799
3168,2881,2329,552,183,265,544,328,585,976,31,6350,2912
3169,2663,2185,478,169,247,523,315,558,851,136,5854,2799
3170,1355,1043,312,29,68,244,159,327,528,44,3181,1399
3171,1072,970,102,259,308,155,116,98,136,514,1905,1586
3172,678,598,80,94,142,112,93,94,143,87,1485,765
3173,2838,2337,501,199,316,570,321,546,886,113,6145,2951
3174,1791,1626,165,218,283,349,225,272,444,0,3336,1791
3175,1694,1487,207,83,146,338,182,364,581,133,3709,1827
3176,2401,2212,189,217,185,509,328,454,708,79,4397,2480
3177,2237,1985,252,212,179,451,311,428,656,1514,4555,3751
3178,1635,1389,246,117,101,326,208,376,507,55,3522,1690
3179,838,598,240,83,142,150,92,146,225,18,2234,856
3180,1514,1230,284,82,112,327,195,321,477,0,3574,1514
3181,1234,1070,164,61,68,214,140,296,455,134,2941,1368
3182,1509,1220,289,51,148,287,195,345,483,165,3921,1674
3183,5167,3868,1299,353,644,1001,626,1005,1538,73,13139,5240
3184,3534,3225,309,211,331,787,455,618,1132,181,6830,3715
3185,2260,1998,262,168,151,455,308,472,706,0,4333,2260
3186,2074,1775,299,131,152,422,261,462,646,6,4375,2080
3187,313,185,128,15,36,61,40,66,95,65,894,378
3188,821,553,268,28,65,143,94,188,303,31,2208,852
3189,2130,1805,325,151,281,401,262,426,609,265,4402,2395
3190,1872,1232,640,210,282,294,232,317,537,2,4623,1874
3191,221,171,50,8,19,40,27,47,80,0,441,221
3192,82,66,16,12,19,13,6,13,19,31,210,113
3193,1172,872,300,58,115,186,144,240,429,0,3069,1172
3194,272,231,41,19,36,51,33,54,79,0,622,272
3195,714,423,291,34,81,140,92,151,216,0,2359,714
3196,349,207,142,17,40,68,45,74,105,8,1230,357
3197,1160,782,378,39,92,202,133,266,428,0,3070,1160
3198,834,595,239,83,141,150,91,146,223,0,2489,834
3199,1997,1183,814,95,227,391,257,423,604,8,6488,2005
3200,1020,728,292,101,173,183,112,178,273,0,1888,1020
3201,328,234,94,33,55,59,36,57,88,6,994,334
3202,635,453,182,63,107,114,70,111,170,0,1911,635
3203,198,141,57,20,34,36,22,35,51,6,485,204
3204,325,219,106,11,26,57,37,74,120,0,885,325
3205,481,324,157,16,38,84,55,110,178,0,1054,481
3206,291,196,95,10,23,51,33,67,107,0,752,291
3207,365,246,119,12,29,64,42,84,134,0,1008,365
3208,348,269,79,12,30,62,42,74,128,49,929,397
3209,733,566,167,25,63,131,88,156,270,0,1816,733
3210,723,559,164,25,62,129,87,154,266,0,1664,723
3211,178,142,36,25,41,29,13,27,43,5,474,183
3212,379,303,76,54,88,61,27,58,91,13,958,392
3213,510,408,102,72,118,83,37,78,122,13,1174,523
3214,507,395,112,92,147,73,62,59,74,171,1438,678
3215,997,776,221,180,290,144,122,117,144,0,1826,997
3216,2517,1967,550,488,748,361,311,271,338,0,5135,2517
3217,580,453,127,112,172,83,72,63,78,0,1603,580
3218,483,292,191,57,84,80,64,80,118,61,1589,544
3219,373,226,147,44,65,62,50,61,91,3,1111,376
3220,302,183,119,35,52,50,40,50,75,0,889,302
3221,605,366,239,71,105,101,81,100,147,453,1541,1058
3222,545,493,52,131,156,79,59,50,70,33,857,578
3223,380,263,117,37,54,70,51,63,105,10,1139,390
3224,780,540,240,76,111,144,105,128,216,15,2257,795
3225,398,351,47,55,83,66,55,55,84,10,820,408
3226,422,232,190,40,63,74,65,72,108,33,1185,455
3227,298,164,134,28,44,52,46,51,77,102,929,400
3228,633,451,182,71,116,107,69,98,172,0,1744,633
3229,433,322,111,21,42,69,53,89,159,0,1098,433
3230,534,478,56,38,68,89,62,101,176,0,1380,534
3231,468,419,49,34,60,78,54,88,154,0,1173,468
3232,265,237,28,19,34,44,31,50,87,10,650,275
3233,118,95,23,16,12,24,10,21,35,0,261,118
3234,605,489,116,81,61,121,51,106,185,17,1269,622
3235,426,344,82,57,43,85,36,74,131,0,1053,426
3236,664,537,127,89,67,133,56,116,203,0,1378,664
3237,349,279,70,34,32,71,28,65,119,0,1100,349
3238,474,380,94,46,43,97,38,89,161,0,1162,474
3239,791,633,158,77,72,161,63,148,270,0,1953,791
3240,946,766,180,119,159,154,93,139,282,14,2255,960
3241,510,413,97,64,86,83,50,75,152,0,1424,510
3242,590,478,112,74,99,96,58,86,177,2,1238,592
3243,372,327,45,68,97,50,25,46,86,0,993,372
3244,369,325,44,67,96,50,25,46,85,2,688,371
3245,311,279,32,21,14,70,24,61,121,0,650,311
3246,452,374,78,22,45,76,64,78,167,0,1036,452
3247,389,322,67,19,39,65,55,67,144,0,868,389
3248,362,300,62,17,36,61,51,62,135,0,874,362
3249,408,342,66,22,32,77,36,87,154,5,885,413
3250,420,299,121,47,77,71,46,65,114,323,1212,743
3251,2925,1936,989,157,276,538,414,579,961,420,9710,3345
3252,142,96,46,5,11,25,16,33,52,0,289,142
3253,1683,1534,149,101,154,338,194,295,601,365,3270,2048
3254,3776,2980,796,337,631,510,347,549,1402,160,9971,3936
3255,3006,2610,396,365,515,418,272,406,1030,336,6744,3342
3256,700,617,83,29,37,90,66,143,335,5,1586,705
3257,873,682,191,65,144,109,81,132,342,0,2006,873
3258,2968,2323,645,148,346,406,297,556,1215,52,7484,3020
3259,3132,2550,582,198,354,456,307,586,1231,56,7577,3188
3260,2225,1751,474,115,234,349,239,401,887,23,5408,2248
3261,1563,1335,228,83,136,228,146,278,692,13,3147,1576
3262,1932,1538,394,347,643,229,147,174,392,0,4891,1932
3263,987,813,174,32,62,127,97,208,461,0,2277,987
3264,773,612,161,74,186,90,67,112,244,0,1935,773
3265,2427,1964,463,145,275,361,230,396,1020,105,6343,2532
3266,1062,961,101,100,124,150,89,174,425,22,1591,1084
3267,1808,1558,250,69,122,279,162,332,844,128,4211,1936
3268,2984,2582,402,188,289,392,249,505,1361,78,6726,3062
3269,742,659,83,91,99,89,50,99,314,39,1669,781
3270,1459,1212,247,129,169,210,171,216,564,11,3023,1470
3271,2917,2266,651,161,204,354,293,582,1323,122,6821,3039
3272,187,162,25,5,10,33,20,42,77,0,477,187
3273,1154,1013,141,70,123,246,143,205,367,11,2102,1165
3274,2418,2051,367,173,280,406,223,344,992,52,5078,2470
3275,1681,1382,299,78,192,254,203,313,641,31,3563,1712
3276,2790,2371,419,125,239,368,302,506,1250,13,5866,2803
3277,1302,1049,253,97,122,166,140,223,554,0,3032,1302
3278,3381,2842,539,427,458,383,292,489,1332,76,6662,3457
3279,873,606,267,23,32,100,111,168,439,102,2220,975
3280,2323,2025,298,194,266,304,232,379,948,0,5197,2323
3281,603,529,74,46,53,76,52,103,273,470,1173,1073
3282,2302,1939,363,89,142,291,232,423,1125,0,4795,2302
3283,2018,1788,230,298,373,228,168,244,707,104,4004,2122
3284,937,799,138,101,123,114,89,132,378,13,2232,950
3285,6671,3741,2930,1234,1680,863,446,822,1626,124,25437,6795
3286,2393,2165,228,278,314,271,176,341,1013,61,4567,2454
3287,2698,2260,438,247,304,313,210,417,1207,0,5995,2698
3288,2965,2615,350,343,348,345,246,439,1244,454,5740,3419
3289,1609,1261,348,483,460,123,93,98,352,0,3763,1609
3290,305,294,11,16,28,50,30,49,132,143,567,448
3291,3067,2446,621,189,217,319,255,520,1567,25,7432,3092
3292,2806,2435,371,147,175,312,231,497,1444,20,5642,2826
3293,1591,1268,323,179,173,180,139,252,668,0,2780,1591
3294,1343,1184,159,132,170,149,115,197,580,0,2796,1343
3295,2504,2011,493,172,207,297,206,425,1197,0,5774,2504
3296,0,0,0,0,0,0,0,0,0,0,0,0
3297,3882,3400,482,452,486,445,325,609,1565,11,8315,3893
3298,2722,2188,534,124,147,355,239,436,1421,0,6662,2722
3299,2348,2034,314,318,312,297,207,331,883,0,4784,2348
3300,2136,1798,338,121,155,288,190,342,1040,9,4212,2145
3301,2826,2325,501,127,173,341,241,492,1452,25,6097,2851
3302,2063,1696,367,103,143,248,184,363,1022,0,4850,2063
3303,5258,5040,218,602,730,682,517,701,2026,25,8508,5283
3304,249,195,54,19,41,31,23,38,97,0,500,249
3305,423,334,89,38,71,57,39,62,156,0,1319,423
3306,518,409,109,46,87,70,48,75,192,0,1107,518
3307,1273,1005,268,114,213,172,117,185,472,20,3291,1293
3308,681,539,142,65,164,79,59,99,215,2,1807,683
3309,2072,1650,422,372,690,245,158,187,420,185,4022,2257
3310,853,729,124,45,74,124,80,152,378,0,2045,853
3311,1465,1326,139,138,171,207,123,240,586,0,2668,1465
3312,6488,5767,721,793,862,777,440,869,2747,0,14661,6488
3313,960,853,107,117,127,115,65,129,407,65,1687,1025
3314,1453,1291,162,178,193,174,99,195,614,11,2802,1464
3315,206,183,23,25,27,25,14,28,87,0,517,206
3316,236,210,26,29,31,28,16,32,100,57,485,293
3317,362,312,50,14,24,56,32,67,169,15,833,377
3318,676,589,87,56,77,89,67,110,277,0,1497,676
3319,851,742,109,71,98,111,85,139,347,41,1681,892
3320,2310,2026,284,176,202,293,198,394,1047,879,4815,3189
3321,1421,797,624,263,358,184,95,175,346,76,5617,1497
3322,2313,1973,340,249,303,282,219,326,934,4,6202,2317
3323,736,666,70,86,97,83,54,105,311,0,1889,736
3324,549,497,52,64,72,62,40,78,233,0,964,549
3325,197,171,26,10,12,22,16,35,102,0,391,197
3326,293,254,39,15,18,33,24,52,151,0,703,293
3327,412,345,67,38,46,48,32,64,184,0,761,412
3328,1619,1290,329,183,176,183,142,256,679,0,4016,1619
3329,78,62,16,9,8,9,7,12,33,0,162,78
3330,1955,1732,223,288,362,221,163,237,684,559,2948,2514
3331,426,377,49,63,79,48,35,52,149,6,635,432
3332,551,470,81,59,72,67,52,78,223,0,1190,551
