TAZ,HHLESSGQ,HHCHILDNO,HHCHILDYES,HHINC1,HHINC2,HHINC3,HHINC4,HHINC5,HHINC6,HHGQYES,HHGQNO,HHBASE
1,852,825,27,85,81,70,99,165,352,4,1440,856
2,497,164,333,73,33,63,27,97,204,22,1542,519
3,2531,2338,193,744,499,248,265,360,415,20,4535,2551
4,2437,2192,245,759,490,237,224,354,373,0,4658,2437
5,3047,2979,68,945,668,270,283,379,502,7,4982,3054
6,1426,1341,85,417,289,142,141,206,231,20,2619,1446
7,532,475,57,174,108,55,54,60,81,0,1076,532
8,704,688,16,216,169,60,66,86,107,0,1163,704
9,8828,6639,2189,1307,630,682,933,1719,3557,0,29517,8828
10,4318,4160,158,1099,1102,447,388,579,703,107,7085,4425
11,856,764,92,280,174,88,87,97,130,0,1733,856
12,627,615,12,216,153,52,52,73,81,0,952,627
13,672,659,13,232,164,56,56,79,85,0,1021,672
14,1028,1005,23,441,183,110,68,112,114,342,1515,1370
15,506,494,12,217,90,54,34,55,56,0,746,506
16,1244,1216,28,533,222,133,83,135,138,281,1834,1525
17,1409,1377,32,604,252,150,94,153,156,0,2077,1409
18,979,883,96,472,131,103,54,105,114,353,1612,1332
19,1020,920,100,492,136,107,56,110,119,202,1679,1222
20,775,707,68,303,143,80,57,83,109,118,1330,893
21,1744,1712,32,420,388,202,150,240,344,191,2860,1935
22,1262,1239,23,304,281,146,108,174,249,55,2069,1317
23,5453,5253,200,1388,1391,565,490,731,888,64,8947,5517
24,900,882,18,310,219,75,74,105,117,461,1367,1361
25,1446,1418,28,498,353,121,119,169,186,0,2196,1446
26,1744,1537,207,667,404,178,121,179,195,77,2945,1821
27,1093,963,130,418,253,111,76,112,123,0,1845,1093
28,1735,1529,206,664,401,177,121,178,194,664,2931,2399
29,1087,1013,74,420,204,118,73,131,141,15,1856,1102
30,1449,1350,99,560,272,157,97,175,188,126,2473,1575
31,521,485,36,202,98,56,35,63,67,531,890,1052
32,717,674,43,210,146,72,71,104,114,0,1318,717
33,1285,1208,77,376,261,128,127,186,207,0,2361,1285
34,815,808,7,212,197,79,78,124,125,8,1295,823
35,685,597,88,220,145,65,72,89,94,0,1331,685
36,797,695,102,256,169,75,84,103,110,1,1547,798
37,863,753,110,277,183,82,91,112,118,0,1675,863
38,567,506,61,186,115,58,58,64,86,0,1148,567
39,1021,911,110,334,208,105,104,115,155,0,2067,1021
40,2089,1947,142,808,393,226,140,252,270,181,3566,2270
41,1058,986,72,409,199,115,71,128,136,44,1806,1102
42,1802,1625,177,869,241,189,99,194,210,2413,2966,4215
43,1165,1051,114,562,156,122,64,125,136,134,1918,1299
44,1142,1009,133,355,260,103,127,145,152,0,2249,1142
45,897,792,105,279,204,81,100,114,119,0,1766,897
46,861,760,101,268,196,77,96,109,115,0,1696,861
47,1120,1094,26,344,269,96,105,137,169,0,1851,1120
48,1171,1144,27,360,281,100,110,143,177,0,1935,1171
49,635,565,70,194,155,55,61,72,98,0,1243,635
50,1161,1033,128,355,283,100,112,132,179,3,2271,1164
51,1245,1108,137,381,303,107,120,142,192,11,2436,1256
52,1274,1226,48,428,299,109,120,150,168,28,2143,1302
53,1452,1397,55,488,340,125,137,170,192,0,2442,1452
54,801,771,30,269,188,69,76,94,105,4,1348,805
55,1037,993,44,350,226,95,118,115,133,0,1842,1037
56,460,440,20,155,100,42,52,51,60,3,817,463
57,858,821,37,290,187,78,97,95,111,0,1524,858
58,719,636,83,235,159,64,83,78,100,0,1488,719
59,968,857,111,316,215,87,111,105,134,0,2001,968
60,1405,1362,43,432,245,141,140,216,231,25,2235,1430
61,867,846,21,288,233,81,67,91,107,348,1278,1215
62,189,183,6,79,28,24,9,25,24,35,300,224
63,396,379,17,143,62,52,38,59,42,18,624,414
64,831,729,102,270,175,74,72,122,118,18,1787,849
65,563,539,24,224,79,63,41,70,86,472,937,1035
66,1096,1050,46,437,153,122,79,136,169,0,1823,1096
67,2011,1926,85,801,281,223,146,249,311,72,3346,2083
68,1553,1526,27,356,377,141,161,252,266,80,2583,1633
69,2015,1978,37,486,449,233,173,277,397,306,3305,2321
70,1560,1491,69,558,374,155,97,186,190,51,2312,1611
71,1439,1376,63,514,345,143,90,171,176,62,2132,1501
72,1506,1469,37,500,404,142,117,157,186,515,2220,2021
73,703,683,20,247,152,76,48,79,101,10,1129,713
74,1068,932,136,341,241,104,108,120,154,8,2340,1076
75,611,533,78,195,138,59,62,68,89,0,1340,611
76,3802,3590,212,1447,592,432,267,477,587,95,6530,3897
77,2016,1904,112,767,314,229,142,253,311,41,3462,2057
78,1226,1119,107,480,226,127,90,132,171,90,2105,1316
79,1452,1325,127,568,268,151,106,156,203,11,2494,1463
80,1474,1439,35,282,353,146,166,200,327,27,2424,1501
81,503,492,11,92,125,53,54,80,99,253,825,756
82,311,305,6,82,82,33,34,30,50,63,469,374
83,57,54,3,17,4,9,8,6,13,11,92,68
84,349,347,2,103,95,34,33,40,44,2,526,351
85,352,318,34,126,64,51,24,41,46,64,561,416
86,95,92,3,36,15,12,6,13,13,22,151,117
87,105,104,1,28,23,14,9,15,16,1,158,106
88,1384,1360,24,317,336,126,144,224,237,377,2301,1761
89,301,294,7,58,72,30,34,41,66,455,495,756
90,835,816,19,153,207,87,89,133,166,25,1370,860
91,954,933,21,175,236,100,102,152,189,15,1566,969
92,2282,2171,111,367,231,195,222,440,827,14,3808,2296
93,4092,4002,90,1016,802,351,406,615,902,113,6715,4205
94,3581,3436,145,618,429,338,333,655,1208,22,5838,3603
95,2629,2523,106,464,299,256,265,454,891,4,4590,2633
96,712,691,21,197,138,72,56,109,140,0,1202,712
97,4705,3988,717,459,426,367,445,854,2154,99,11198,4804
98,1615,1357,258,156,146,131,142,308,732,19,3932,1634
99,1698,1421,277,166,145,140,156,310,781,0,4002,1698
100,68,58,10,6,4,11,5,9,33,0,142,68
101,299,227,72,26,27,24,28,61,133,0,766,299
102,784,660,124,76,66,59,82,136,365,0,1826,784
103,848,725,123,96,83,78,82,146,363,0,1833,848
104,373,319,54,42,36,35,36,64,160,0,807,373
105,390,333,57,44,38,36,38,67,167,115,843,505
106,541,463,78,61,53,50,52,93,232,0,1168,541
107,662,555,107,65,53,61,63,128,292,0,1461,662
108,683,572,111,67,55,63,65,132,301,23,1507,706
109,598,501,97,59,48,55,57,115,264,13,1321,611
110,787,659,128,78,63,72,75,152,347,0,1737,787
111,960,804,156,97,91,73,96,175,428,14,2173,974
112,1004,841,163,101,95,77,100,183,448,28,2271,1032
113,910,762,148,92,86,70,91,166,405,0,2061,910
114,233,177,56,20,21,18,22,48,104,0,596,233
115,480,365,115,42,43,38,45,98,214,0,1228,480
116,643,537,106,71,57,51,63,117,284,0,1498,643
117,676,565,111,75,60,54,66,123,298,7,1577,683
118,985,823,162,109,88,78,97,179,434,7,2296,992
119,566,471,95,52,56,47,58,102,251,3,1346,569
120,865,721,144,80,86,72,89,156,382,0,2056,865
121,456,380,76,42,45,38,47,82,202,0,1082,456
122,475,396,79,44,47,39,49,85,211,0,1128,475
123,751,626,125,69,74,62,77,135,334,11,1783,762
124,747,621,126,68,63,64,68,145,339,3,1774,750
125,571,475,96,52,48,49,52,111,259,5,1355,576
126,501,417,84,45,42,43,45,97,229,2,1188,503
127,626,521,105,57,52,54,57,121,285,0,1487,626
128,556,467,89,51,39,40,54,105,267,0,1374,556
129,790,665,125,77,67,60,82,138,366,4,1840,794
130,574,483,91,56,49,43,60,100,266,0,1338,574
131,686,577,109,63,48,49,66,129,331,1,1696,687
132,871,738,133,85,79,68,82,158,399,10,2074,881
133,1028,945,83,238,219,112,110,151,198,38,1623,1066
134,874,604,270,73,80,48,80,175,418,6,2554,880
135,647,595,52,150,138,70,69,95,125,5,1021,652
136,1349,1240,109,312,287,147,144,198,261,12,2128,1361
137,482,405,77,44,34,34,46,91,233,0,1192,482
138,1209,1183,26,384,292,104,105,149,175,101,1936,1310
139,1655,1619,36,525,400,142,144,204,240,1,2650,1656
140,1027,1005,22,326,248,88,89,127,149,51,1644,1078
141,814,796,18,258,196,70,71,100,119,0,1304,814
142,189,160,29,38,29,18,20,34,50,0,389,189
143,944,799,145,191,145,92,101,168,247,0,1942,944
144,703,595,108,142,108,68,75,125,185,124,1446,827
145,789,668,121,160,122,77,85,141,204,54,1622,843
146,944,799,145,191,145,92,101,168,247,52,1940,996
147,1022,929,93,153,175,103,99,182,310,66,1867,1088
148,756,687,69,113,129,76,73,135,230,0,1381,756
149,1147,1042,105,172,196,116,111,204,348,0,2096,1147
150,1833,1666,167,275,313,185,178,327,555,37,3350,1870
151,732,665,67,110,125,74,71,130,222,137,1337,869
152,825,750,75,124,141,83,80,147,250,86,1508,911
153,617,541,76,60,80,57,52,122,246,0,1250,617
154,544,477,67,53,71,50,46,107,217,123,1103,667
155,779,683,96,75,101,72,66,154,311,3,1579,782
156,376,330,46,36,49,35,32,74,150,0,762,376
157,945,829,116,91,123,87,80,186,378,25,1916,970
158,608,590,18,169,118,61,48,93,119,0,1026,608
159,643,624,19,178,125,65,51,98,126,0,1085,643
160,925,897,28,257,179,93,73,142,181,0,1562,925
161,650,539,111,83,74,58,68,121,246,0,1377,650
162,712,636,76,181,109,68,71,101,182,36,1310,748
163,364,325,39,93,56,35,36,52,92,3,670,367
164,1471,1314,157,374,225,141,146,209,376,0,2705,1471
165,314,260,54,40,36,28,33,58,119,0,665,314
166,536,445,91,69,61,48,56,100,202,357,1134,893
167,266,221,45,34,30,24,28,49,101,0,563,266
168,524,435,89,67,59,47,55,97,199,0,1109,524
169,874,796,78,178,139,69,87,141,260,0,1579,874
170,880,801,79,179,140,70,87,142,262,0,1590,880
171,533,485,48,108,85,42,53,86,159,0,963,533
172,937,907,30,278,175,67,86,130,201,42,1467,979
173,1196,1158,38,354,223,85,110,165,259,0,1871,1196
174,1695,1656,39,543,447,155,151,188,211,178,2425,1873
175,752,735,17,241,198,69,67,84,93,15,1075,767
176,575,553,22,160,139,58,61,68,89,0,915,575
177,983,945,38,274,237,98,104,116,154,0,1563,983
178,1389,1336,53,387,336,139,147,164,216,0,2208,1389
179,720,673,47,114,136,79,75,111,205,0,1433,720
180,572,535,37,90,108,62,60,89,163,205,1137,777
181,648,572,76,90,80,55,66,120,237,0,1288,648
182,969,855,114,134,120,82,99,179,355,0,1925,969
183,467,412,55,65,58,40,48,86,170,0,928,467
184,1337,1180,157,185,165,113,137,247,490,0,2656,1337
185,895,790,105,124,111,76,92,165,327,13,1779,908
186,513,498,15,135,100,56,50,75,97,10,824,523
187,1503,1458,45,397,293,165,146,220,282,199,2411,1702
188,1040,1009,31,274,203,114,101,152,196,0,1669,1040
189,491,433,58,56,46,46,51,104,188,2,1055,493
190,386,340,46,44,36,36,40,82,148,14,829,400
191,664,585,79,75,62,62,69,141,255,0,1425,664
192,440,421,19,60,65,41,55,73,146,3258,931,3698
193,563,539,24,77,83,52,70,93,188,3,1191,566
194,982,940,42,134,145,91,122,163,327,21,2079,1003
195,729,698,31,99,108,68,90,121,243,11,1543,740
196,1319,1167,152,355,301,123,132,175,233,119,2475,1438
197,1494,1321,173,403,340,139,150,199,263,0,2804,1494
198,1977,1909,68,566,526,200,169,256,260,17,2984,1994
199,900,777,123,242,175,84,91,126,182,0,1758,900
200,1201,1037,164,323,233,112,121,168,244,0,2346,1201
201,645,557,88,173,125,60,65,90,132,15,1259,660
202,476,411,65,128,92,44,48,67,97,0,931,476
203,469,402,67,87,98,48,46,74,116,0,970,469
204,706,606,100,131,148,73,70,111,173,15,1460,721
205,1441,1237,204,268,302,149,142,226,354,97,2981,1538
206,861,806,55,127,162,82,89,144,257,75,1701,936
207,1273,1191,82,187,240,121,132,214,379,230,2516,1503
208,597,549,48,86,85,54,69,100,203,59,1213,656
209,671,617,54,97,95,61,78,113,227,103,1364,774
210,603,554,49,87,85,55,70,101,205,42,1224,645
211,763,701,62,110,108,69,88,128,260,281,1550,1044
212,767,709,58,88,123,80,65,139,272,10,1553,777
213,511,472,39,58,82,53,43,93,182,58,1036,569
214,629,581,48,72,101,66,53,114,223,10,1274,639
215,925,855,70,106,148,97,78,168,328,21,1873,946
216,724,659,65,82,141,69,64,137,231,26,1459,750
217,999,909,90,113,194,95,89,190,318,0,2014,999
218,990,827,163,100,88,70,87,190,455,5,2230,995
219,1033,863,170,104,92,73,91,198,475,0,2327,1033
220,547,457,90,55,49,39,48,105,251,3,1233,550
221,509,425,84,51,45,36,45,98,234,1,1146,510
222,580,485,95,59,52,41,51,111,266,1,1307,581
223,614,516,98,59,56,50,54,117,278,8,1495,622
224,798,670,128,77,72,65,70,152,362,0,1943,798
225,567,476,91,55,51,46,50,108,257,80,1382,647
226,549,500,49,62,107,52,49,104,175,94,1107,643
227,381,347,34,43,74,36,34,72,122,2,767,383
228,1448,1375,73,182,210,152,128,285,491,0,2663,1448
229,886,841,45,111,129,93,79,175,299,0,1629,886
230,1604,1532,72,153,240,176,119,303,613,0,2798,1604
231,414,395,19,39,62,45,31,78,159,0,722,414
232,633,605,28,60,95,70,47,119,242,0,1104,633
233,0,0,0,0,0,0,0,0,0,91,0,91
234,77,53,24,6,7,4,7,15,38,7,225,84
235,510,447,63,49,66,47,43,101,204,0,1034,510
236,0,0,0,0,0,0,0,0,0,0,0,0
237,50,48,2,9,7,5,4,8,17,84,65,134
238,494,473,21,67,73,46,61,82,165,85,1044,579
239,1291,1224,67,121,125,113,117,253,562,0,2220,1291
240,1572,1376,196,125,174,153,103,321,696,21,3129,1593
241,777,688,89,68,72,71,60,154,352,0,1480,777
242,1667,1187,480,152,90,149,171,318,787,70,5310,1737
243,1686,1598,88,191,156,149,140,334,716,140,3176,1826
244,1334,1141,193,114,139,115,83,270,613,0,2833,1334
245,1152,769,383,98,81,89,106,222,556,34,3971,1186
246,1331,1118,213,95,118,105,122,244,647,0,3200,1331
247,996,375,621,118,68,77,80,192,461,0,3351,996
248,950,835,115,117,121,99,85,182,346,6,1828,956
249,862,685,177,135,102,88,75,164,298,62,1730,924
250,2021,1776,245,249,258,210,182,387,735,43,3890,2064
251,1290,1216,74,115,173,141,107,267,487,14,2349,1304
252,373,351,22,33,50,41,31,77,141,3,680,376
253,762,718,44,68,102,83,63,158,288,18,1387,780
254,458,432,26,46,52,45,38,92,185,0,835,458
255,471,444,27,47,53,47,39,95,190,6,858,477
256,996,939,57,99,113,99,83,201,401,4,1815,1000
257,958,903,55,95,109,95,80,193,386,0,1746,958
258,630,566,64,55,72,66,47,128,262,3,1194,633
259,1242,1115,127,108,143,130,93,252,516,43,2354,1285
260,1768,1588,180,153,203,185,132,359,736,17,3352,1785
261,1342,1020,322,166,106,118,110,251,591,140,3419,1482
262,945,718,227,117,74,83,78,177,416,44,2406,989
263,801,609,192,99,63,71,66,150,352,0,2040,801
264,736,559,177,91,58,65,61,138,323,1,1874,737
265,532,445,87,72,11,47,58,94,250,0,1322,532
266,497,416,81,68,11,44,54,88,232,1,1236,498
267,789,660,129,107,17,70,86,139,370,1,1962,790
268,1002,838,164,136,22,89,110,177,468,89,2491,1091
269,441,378,63,36,36,36,39,88,206,191,890,632
270,1073,955,118,101,89,98,113,193,479,0,2368,1073
271,490,344,146,82,3,31,52,99,223,58,1460,548
272,657,392,265,65,48,57,63,133,291,11,2608,668
273,566,305,261,60,39,53,46,113,255,147,1985,713
274,320,105,215,47,21,40,18,63,131,0,992,320
275,689,591,98,57,57,56,62,137,320,41,1390,730
276,476,409,67,39,39,39,43,95,221,0,960,476
277,511,439,72,42,42,42,46,102,237,8,1031,519
278,411,360,51,31,45,38,29,79,189,0,854,411
279,526,460,66,39,57,48,37,101,244,0,1093,526
280,682,597,85,51,74,63,48,131,315,0,1417,682
281,569,498,71,42,62,52,40,109,264,1,1182,570
282,518,449,69,35,46,47,41,97,252,1,1050,519
283,802,695,107,54,72,72,64,150,390,0,1624,802
284,654,567,87,44,59,59,52,123,317,0,1324,654
285,620,523,97,42,52,54,49,125,298,0,1284,620
286,431,364,67,30,36,38,34,87,206,0,893,431
287,492,415,77,34,41,43,39,99,236,0,1019,492
288,527,445,82,36,44,46,42,107,252,0,1092,527
289,558,471,87,38,47,49,44,113,267,64,1156,622
290,1045,925,120,91,97,96,80,207,474,0,1990,1045
291,825,730,95,72,77,76,64,164,372,0,1570,825
292,765,681,84,72,64,70,81,138,340,0,1688,765
293,420,374,46,40,35,38,44,76,187,0,927,420
294,521,459,62,44,42,38,51,101,245,0,1130,521
295,362,319,43,31,29,27,35,70,170,0,785,362
296,591,384,207,51,44,59,57,108,272,57,2175,648
297,616,401,215,55,39,53,66,117,286,27,2249,643
298,202,107,95,19,15,20,13,36,99,172,613,374
299,6944,3634,3310,1587,1134,756,581,1198,1688,0,21168,6944
300,591,521,70,50,47,44,58,114,278,36,1283,627
301,519,457,62,44,42,38,51,100,244,0,1126,519
302,3575,3358,217,479,281,342,395,641,1437,1,6588,3576
303,2215,2080,135,297,174,212,245,397,890,5,4082,2220
304,1410,958,452,170,127,136,122,265,590,45,3839,1455
305,790,537,253,95,71,76,68,149,331,31,2150,821
306,593,525,68,54,67,57,58,115,242,66,1223,659
307,995,676,319,120,90,96,86,187,416,18,2708,1013
308,638,384,254,54,54,55,57,114,304,20,2097,658
309,1006,707,299,169,6,63,106,204,458,19,2998,1025
310,453,318,135,76,3,29,48,92,205,0,1349,453
311,454,273,181,39,38,39,41,81,216,25,1492,479
312,204,155,49,22,19,28,18,39,78,50,562,254
313,563,338,225,48,47,49,51,101,267,0,1851,563
314,448,284,164,44,34,38,28,101,203,71,1431,519
315,407,258,149,40,31,35,26,91,184,24,1300,431
316,683,408,275,68,50,59,65,138,303,38,2712,721
317,549,335,214,46,41,49,29,123,261,11,1651,560
318,488,291,197,48,36,42,47,99,216,0,1936,488
319,1035,782,253,64,93,79,99,192,508,0,2858,1035
320,395,290,105,23,43,39,23,78,189,5,1088,400
321,328,240,88,19,36,32,19,65,157,0,903,328
322,255,113,142,28,21,23,21,49,113,27,932,282
323,376,166,210,41,31,34,31,73,166,15,1375,391
324,544,423,121,36,53,48,40,111,256,60,1327,604
325,502,390,112,33,49,44,37,102,237,22,1226,524
326,366,199,167,26,38,34,38,72,158,0,1558,366
327,867,370,497,93,67,85,66,181,375,0,3308,867
328,455,194,261,49,35,45,35,95,196,0,1735,455
329,386,314,72,23,36,38,25,77,187,23,921,409
330,716,582,134,42,66,71,45,143,349,36,1709,752
331,474,385,89,28,44,47,30,94,231,32,1130,506
332,615,478,137,40,60,54,45,125,291,175,1501,790
333,2050,1549,501,128,185,157,195,381,1004,4,5659,2054
334,1799,1359,440,112,162,137,171,334,883,0,4967,1799
335,656,515,141,38,60,53,63,126,316,0,1659,656
336,691,543,148,40,64,56,66,133,332,0,1747,691
337,572,449,123,33,53,46,55,110,275,0,1446,572
338,440,346,94,26,41,36,42,85,210,3,1113,443
339,242,190,52,14,22,20,23,47,116,0,612,242
340,516,323,193,27,48,41,56,96,248,22,1910,538
341,265,166,99,14,25,21,29,49,127,0,982,265
342,414,259,155,22,39,33,45,77,198,22,1531,436
343,400,250,150,21,37,32,44,74,192,13,1481,413
344,436,273,163,23,41,35,47,81,209,59,1613,495
345,688,535,153,45,68,61,51,140,323,37,1679,725
346,867,676,191,61,91,76,56,173,410,43,2087,910
347,428,334,94,30,45,37,28,86,202,34,1030,462
348,334,260,74,23,35,29,22,67,158,17,803,351
349,321,250,71,23,34,28,21,64,151,92,773,413
350,383,281,102,23,42,37,22,76,183,5,1054,388
351,718,502,216,44,74,66,45,146,343,0,2138,718
352,691,485,206,36,56,67,52,150,330,5,1845,696
353,805,563,242,50,82,74,50,164,385,22,2395,827
354,337,237,100,18,27,33,25,73,161,0,901,337
355,602,461,141,56,35,54,61,103,293,581,1985,1183
356,455,316,139,27,46,35,39,92,216,29,1557,484
357,365,254,111,22,37,28,31,74,173,0,1248,365
358,423,294,129,25,43,32,36,86,201,0,1447,423
359,509,354,155,30,51,39,44,103,242,0,1741,509
360,353,246,107,21,35,27,30,72,168,54,1209,407
361,316,220,96,19,32,24,27,64,150,7,1081,323
362,488,328,160,32,35,52,54,94,221,6,1766,494
363,471,317,154,31,34,50,52,91,213,0,1705,471
364,349,235,114,23,25,37,39,68,157,4,1264,353
365,345,232,113,23,25,37,38,67,155,0,1249,345
366,262,176,86,19,19,25,23,48,128,28,891,290
367,388,261,127,29,28,38,34,72,187,0,1324,388
368,1226,873,353,112,66,110,125,234,579,8,3905,1234
369,381,271,110,35,21,34,39,73,179,0,1214,381
370,738,439,299,64,53,59,72,137,353,0,2796,738
371,747,483,264,60,59,62,66,148,352,0,2870,747
372,758,481,277,56,50,55,78,146,373,0,2938,758
373,513,305,208,44,37,41,50,96,245,4,1944,517
374,381,292,89,35,22,34,39,65,186,0,1254,381
375,888,643,245,57,84,65,85,175,422,7,3232,895
376,168,122,46,11,16,12,16,33,80,0,613,168
377,315,228,87,20,30,23,30,62,150,0,1146,315
378,195,141,54,13,19,14,19,39,91,0,711,195
379,597,384,213,36,57,42,53,117,292,15,2360,612
380,475,306,169,29,46,33,42,93,232,11,1877,486
381,400,257,143,24,38,28,36,79,195,0,1581,400
382,399,257,142,24,38,28,35,78,196,21,1576,420
383,402,259,143,24,39,28,36,79,196,45,1590,447
384,284,184,100,24,17,26,30,57,130,0,1059,284
385,365,236,129,29,29,30,32,72,173,15,1403,380
386,366,237,129,31,23,33,38,73,168,0,1366,366
387,363,242,121,31,26,28,34,70,174,0,1253,363
388,276,178,98,22,22,23,24,55,130,2,1060,278
389,444,287,157,37,27,40,47,88,205,0,1655,444
390,783,505,278,76,56,83,72,142,354,0,3029,783
391,506,308,198,43,45,38,43,96,241,24,2017,530
392,552,336,216,46,49,41,47,104,265,0,2198,552
393,415,367,48,32,45,40,31,79,188,40,860,455
394,612,541,71,47,66,58,46,117,278,112,1267,724
395,442,391,51,34,48,42,33,84,201,1,916,443
396,759,671,88,59,82,72,57,145,344,17,1572,776
397,2277,2051,226,211,191,174,216,420,1065,502,4654,2779
398,1893,1705,188,175,159,145,179,349,886,0,3869,1893
399,2287,2220,67,391,314,248,229,401,704,19,4205,2306
400,1815,1616,199,289,205,183,179,313,646,0,3335,1815
401,465,427,38,91,75,49,53,73,124,0,855,465
402,839,756,83,78,70,64,80,155,392,0,1714,839
403,3252,2183,1069,244,391,301,300,612,1404,0,10242,3252
404,602,404,198,45,72,56,56,113,260,0,1897,602
405,311,272,39,31,19,27,28,60,146,0,670,311
406,1518,1440,78,142,148,133,138,297,660,0,2611,1518
407,728,637,91,72,44,62,66,141,343,1248,1567,1976
408,655,579,76,59,74,62,64,127,269,0,1351,655
409,9,7,2,1,1,1,1,2,3,617,26,626
410,604,369,235,50,45,54,32,135,288,1,1814,605
411,374,229,145,31,28,33,20,84,178,46,1124,420
412,761,464,297,77,64,78,76,124,342,0,2713,761
413,432,263,169,43,36,44,43,70,196,0,1540,432
414,312,219,93,16,25,30,23,68,150,17,833,329
415,604,384,220,57,38,45,53,124,287,0,2269,604
416,746,475,271,71,47,56,66,154,352,0,2800,746
417,834,530,304,62,55,61,86,160,410,8,3234,842
418,822,536,286,74,53,70,88,156,381,72,3003,894
419,665,429,236,64,47,70,62,121,301,73,2573,738
420,418,193,225,37,35,37,37,78,194,8,1780,426
421,307,141,166,28,25,27,28,58,141,0,1310,307
422,433,191,242,47,36,39,36,84,191,115,1584,548
423,648,615,33,61,63,57,59,127,281,0,1115,648
424,491,466,25,46,48,43,44,96,214,0,844,491
425,796,755,41,74,77,70,72,156,347,1,1369,797
426,1214,1074,140,149,104,113,118,213,517,10,2362,1224
427,788,697,91,97,68,74,76,139,334,0,1534,788
428,564,366,198,48,42,57,54,103,260,23,2076,587
429,393,255,138,34,29,39,38,72,181,1,1446,394
430,393,255,138,34,29,39,38,72,181,12,1446,405
431,433,281,152,37,32,44,41,79,200,10,1596,443
432,732,495,237,51,57,53,73,148,350,45,2629,777
433,656,444,212,45,51,47,65,132,316,64,2356,720
434,286,194,92,20,22,21,28,58,137,23,1027,309
435,299,202,97,21,23,21,30,60,144,0,1075,299
436,354,240,114,24,28,25,35,71,171,0,1272,354
437,414,280,134,29,32,30,41,84,198,0,1489,414
438,861,451,410,81,61,73,59,188,399,95,3053,956
439,1696,1369,327,239,240,157,179,306,575,13,4242,1709
440,2063,1638,425,322,243,211,179,393,715,186,4142,2249
441,746,592,154,116,88,76,65,142,259,128,1497,874
442,125,101,24,18,18,12,13,23,41,233,312,358
443,816,648,168,127,96,84,71,155,283,21,1639,837
444,2556,2246,310,315,326,266,230,490,929,75,4920,2631
445,1266,970,296,207,27,124,118,226,564,2,2915,1268
446,1284,984,300,210,27,125,120,230,572,5,2955,1289
447,392,300,92,64,8,38,37,70,175,0,902,392
448,49,44,5,4,4,4,4,10,23,23,98,72
449,601,390,211,52,45,60,58,110,276,1,2214,602
450,0,0,0,0,0,0,0,0,0,0,0,0
451,563,510,53,51,46,47,41,117,261,18,1112,581
452,1979,1818,161,388,317,210,225,309,530,103,3636,2082
453,1278,1032,246,180,181,118,135,231,433,104,3196,1382
454,865,698,167,122,122,80,91,156,294,8,2163,873
455,0,0,0,0,0,0,0,0,0,4,0,4
456,192,155,37,27,27,18,20,35,65,25,481,217
457,1536,1367,169,245,174,155,151,264,547,154,2822,1690
458,1601,1470,131,314,257,170,182,250,428,27,2941,1628
459,709,688,21,121,97,77,71,124,219,205,1303,914
460,255,193,62,28,24,35,22,49,97,0,701,255
461,261,198,63,29,24,36,23,50,99,0,718,261
462,76,71,5,10,6,7,8,14,31,0,141,76
463,7432,6980,452,997,583,710,821,1333,2988,46,13696,7478
464,1613,1515,98,216,127,154,178,289,649,4,2972,1617
465,693,651,42,93,54,66,77,124,279,0,1277,693
466,0,0,0,0,0,0,0,0,0,0,0,0
467,1400,1267,133,127,114,117,102,291,649,0,2766,1400
468,0,0,0,0,0,0,0,0,0,32,0,32
469,4,4,0,0,0,0,0,1,3,3,8,7
470,266,241,25,24,22,22,19,55,124,3,526,269
471,30,27,3,3,2,3,2,6,14,8,60,38
472,0,0,0,0,0,0,0,0,0,0,0,0
473,837,757,80,76,68,70,61,174,388,0,1653,837
474,580,326,254,72,41,58,38,115,256,0,1656,580
475,1000,562,438,123,72,100,66,199,440,8,2857,1008
476,1561,514,1047,228,103,197,86,305,642,3,4838,1564
477,401,218,183,28,42,37,41,79,174,0,1705,401
478,957,520,437,67,99,88,99,189,415,0,4071,957
479,774,330,444,83,60,76,59,162,334,0,2955,774
480,721,307,414,77,56,71,55,151,311,0,2753,721
481,318,140,178,35,26,28,26,61,142,1,1162,319
482,60,39,21,5,4,5,6,12,28,0,225,60
483,5564,3735,1829,417,669,515,514,1047,2402,0,17524,5564
484,2611,1753,858,196,314,242,241,491,1127,10,8224,2621
485,160,116,44,10,15,12,15,32,76,10,583,170
486,263,191,72,17,25,19,25,52,125,0,956,263
487,247,172,75,15,25,19,21,50,117,0,847,247
488,698,586,112,50,62,55,64,128,339,0,1679,698
489,672,564,108,48,60,53,61,123,327,0,1616,672
490,294,270,24,58,47,31,33,46,79,998,541,1292
491,599,464,135,41,51,35,53,115,304,0,1542,599
492,1290,1070,220,112,122,104,127,244,581,0,3073,1290
493,1408,1107,301,99,138,108,130,259,674,93,3675,1501
494,343,270,73,24,34,26,32,63,164,11,896,354
495,420,330,90,29,41,32,39,77,202,0,1096,420
496,516,406,110,36,51,40,48,95,246,21,1348,537
497,407,302,105,29,38,28,39,76,197,2,1145,409
498,298,221,77,22,28,21,29,56,142,0,839,298
499,335,248,87,24,31,23,32,63,162,0,942,335
500,320,237,83,23,30,22,31,60,154,0,899,320
501,529,392,137,38,49,37,51,99,255,12,1488,541
502,373,277,96,27,35,26,36,70,179,0,1050,373
503,309,229,80,22,29,22,30,58,148,8,869,317
504,362,285,77,25,37,29,30,72,169,4,998,366
505,607,478,129,42,62,49,51,122,281,0,1675,607
506,323,254,69,22,33,26,27,65,150,9,892,332
507,486,382,104,33,49,40,41,97,226,0,1340,486
508,298,234,64,20,30,24,25,60,139,0,822,298
509,288,227,61,20,29,23,24,58,134,0,795,288
510,255,201,54,17,26,21,21,51,119,0,704,255
511,455,349,106,34,49,32,39,88,213,0,1304,455
512,510,392,118,38,55,36,44,99,238,0,1460,510
513,625,480,145,46,67,44,53,121,294,30,1791,655
514,403,309,94,30,43,28,34,78,190,0,1154,403
515,557,428,129,41,60,39,48,108,261,65,1595,622
516,431,331,100,32,46,30,37,84,202,11,1234,442
517,560,475,85,47,59,40,34,105,275,18,1544,578
518,310,263,47,26,33,22,19,58,152,0,854,310
519,395,335,60,33,41,28,24,74,195,0,1088,395
520,241,204,37,20,25,17,15,45,119,0,663,241
521,797,649,148,57,79,56,68,142,395,0,1949,797
522,632,515,117,45,63,44,54,113,313,45,1544,677
523,579,447,132,41,57,41,51,105,284,0,1678,579
524,539,416,123,39,53,38,48,98,263,6,1562,545
525,421,325,96,30,42,30,37,76,206,0,1219,421
526,336,259,77,24,33,24,30,61,164,6,974,342
527,326,252,74,23,32,23,29,59,160,0,943,326
528,309,239,70,22,31,22,27,56,151,0,894,309
529,436,337,99,31,43,31,38,79,214,0,1263,436
530,631,514,117,45,62,44,54,112,314,0,1542,631
531,394,303,91,37,32,31,29,78,187,0,1124,394
532,341,262,79,32,27,27,25,68,162,0,972,341
533,386,297,89,37,31,30,28,77,183,0,1101,386
534,338,260,78,32,27,27,25,67,160,0,963,338
535,520,397,123,39,53,40,44,106,238,0,1534,520
536,353,270,83,27,36,27,30,72,161,22,1040,375
537,615,470,145,46,62,48,52,125,282,0,1813,615
538,378,289,89,28,38,29,32,77,174,6,1115,384
539,512,391,121,38,52,40,43,104,235,0,1508,512
540,324,247,77,24,33,25,27,66,149,0,955,324
541,509,389,120,37,40,39,46,100,247,0,1439,509
542,436,333,103,32,35,34,40,85,210,0,1233,436
543,463,354,109,34,37,36,42,91,223,0,1310,463
544,463,354,109,34,37,36,42,91,223,7,1308,470
545,950,816,134,72,94,78,72,189,445,0,2034,950
546,539,463,76,41,54,44,41,107,252,4,1155,543
547,860,716,144,67,89,71,73,165,395,0,2047,860
548,626,538,88,48,62,52,48,125,291,0,1340,626
549,870,747,123,76,80,67,72,172,403,0,1798,870
550,937,804,133,82,86,72,78,185,434,26,1936,963
551,545,454,91,42,56,45,46,105,251,0,1296,545
552,2631,2515,116,178,197,245,188,550,1273,2,6254,2633
553,700,583,117,54,72,58,60,134,322,97,1666,797
554,496,387,109,32,46,46,40,97,235,0,1288,496
555,479,399,80,37,49,39,41,92,221,0,1140,479
556,502,391,111,32,47,46,40,98,239,0,1303,502
557,252,191,61,16,25,19,22,51,119,0,668,252
558,466,353,113,29,46,36,41,94,220,0,1238,466
559,414,313,101,26,41,32,37,84,194,0,1100,414
560,361,273,88,23,36,28,32,73,169,0,960,361
561,309,240,69,21,27,18,27,60,156,10,794,319
562,1138,895,243,80,112,88,105,209,544,11,2970,1149
563,709,609,100,62,65,54,59,140,329,17,1464,726
564,479,373,106,31,45,44,38,93,228,0,1244,479
565,372,268,104,27,31,26,35,72,181,15,1146,387
566,580,418,162,42,49,40,55,112,282,10,1786,590
567,434,313,121,32,37,30,41,84,210,0,1336,434
568,527,380,147,38,44,37,50,102,256,0,1622,527
569,511,368,143,37,43,36,49,99,247,0,1573,511
570,510,368,142,37,43,36,48,99,247,0,1570,510
571,925,747,178,76,78,73,71,176,451,8,2379,933
572,844,681,163,70,72,66,65,161,410,0,2170,844
573,676,546,130,56,57,53,52,129,329,8,1738,684
574,807,652,155,67,68,63,62,154,393,29,2076,836
575,606,489,117,50,51,48,47,116,294,0,1558,606
576,456,368,88,38,39,36,35,87,221,11,1174,467
577,564,445,119,43,50,46,54,109,262,0,1602,564
578,692,547,145,52,61,56,66,133,324,198,1967,890
579,421,333,88,32,37,34,40,81,197,0,1197,421
580,504,398,106,38,44,41,48,97,236,0,1432,504
581,582,460,122,44,51,47,55,112,273,0,1654,582
582,440,348,92,33,39,36,42,85,205,0,1250,440
583,399,305,94,31,35,28,34,76,195,0,1176,399
584,432,330,102,34,38,30,37,83,210,0,1271,432
585,491,376,115,38,43,34,42,94,240,0,1447,491
586,635,486,149,49,55,44,54,121,312,19,1871,654
587,396,303,93,31,35,28,34,76,192,0,1167,396
588,430,329,101,33,37,30,37,82,211,19,1265,449
589,451,345,106,35,39,32,39,86,220,0,1329,451
590,1852,1537,315,161,176,149,183,350,833,0,4415,1852
591,410,340,70,36,39,33,41,78,183,0,977,410
592,1834,1522,312,160,174,148,181,347,824,0,4372,1834
593,1072,890,182,93,102,86,106,203,482,0,2554,1072
594,586,451,135,56,47,46,43,117,277,0,1673,586
595,638,487,151,47,51,49,58,125,308,0,1804,638
596,385,373,12,38,37,31,45,74,160,4,652,389
597,0,0,0,0,0,0,0,0,0,0,0,0
598,316,228,88,23,27,22,30,61,153,0,974,316
599,1403,1164,239,122,133,113,139,265,631,0,3344,1403
600,58,55,3,4,4,5,4,12,29,3014,138,3072
601,277,218,59,19,27,21,26,51,133,0,722,277
602,565,428,137,36,56,44,50,114,265,0,1501,565
603,636,617,19,109,87,69,64,112,195,0,1168,636
604,72,70,2,12,10,8,7,13,22,0,132,72
605,4553,4420,133,778,626,494,456,799,1400,0,8370,4553
606,30,29,1,5,4,3,3,5,10,0,55,30
607,377,364,13,144,60,46,25,51,51,67,599,444
608,122,118,4,47,19,15,8,17,16,23,195,145
609,110,106,4,42,17,13,7,15,16,13,174,123
610,519,516,3,153,141,51,49,59,66,9,780,528
611,0,0,0,0,0,0,0,0,0,3,0,3
612,229,228,1,68,62,23,22,26,28,0,345,229
613,180,176,4,53,48,21,10,20,28,0,274,180
614,320,314,6,93,86,38,18,36,49,13,488,333
615,517,514,3,137,113,69,43,74,81,7,782,524
616,2448,1717,731,151,262,241,214,477,1103,0,6887,2448
617,615,491,124,47,44,47,65,116,296,0,1547,615
618,1589,1093,496,123,161,141,160,375,629,181,5332,1770
619,1497,982,515,76,137,114,135,284,751,0,4613,1497
620,2446,1585,861,125,179,226,220,466,1230,8,6552,2454
621,11,9,2,1,0,0,1,4,5,0,33,11
622,3410,2781,629,295,319,320,371,726,1379,8,7844,3418
623,1294,901,393,86,120,110,132,275,571,0,4089,1294
624,1295,804,491,76,121,116,110,267,605,22,4691,1317
625,1975,1455,520,122,161,164,170,431,927,10,6071,1985
626,1516,989,527,71,154,118,143,335,695,25,5766,1541
627,456,319,137,31,57,43,47,106,172,0,1413,456
628,1774,1128,646,98,180,144,182,409,761,10,6527,1784
629,602,357,245,42,54,47,58,114,287,19,1925,621
630,4136,2652,1484,347,441,385,427,969,1567,4,12719,4140
631,1987,1241,746,81,184,175,195,352,1000,31,6091,2018
632,1680,1249,431,99,151,136,140,337,817,97,4004,1777
633,1909,1471,438,95,157,154,205,362,936,45,4215,1954
634,1231,876,355,70,102,108,109,231,611,0,3276,1231
635,1502,1018,484,69,126,124,136,294,753,0,3999,1502
636,2049,1418,631,117,168,169,219,405,971,0,5396,2049
637,1706,1106,600,102,142,119,164,345,834,24,5557,1730
638,1718,1162,556,109,150,148,168,369,774,298,5272,2016
639,328,258,70,24,28,23,30,67,156,0,854,328
640,914,709,205,48,57,63,87,205,454,0,2598,914
641,637,466,171,30,49,36,58,135,329,20,1816,657
642,541,444,97,29,46,39,57,114,256,3,1413,544
643,433,330,103,22,34,30,38,90,219,48,1109,481
644,2000,1234,766,92,195,177,184,425,927,38,6946,2038
645,3925,2408,1517,504,853,257,332,665,1314,1,13679,3926
646,1677,1033,644,113,134,137,159,318,816,149,5263,1826
647,2514,1199,1315,179,198,197,235,521,1184,0,9740,2514
648,1145,871,274,78,98,90,118,213,548,0,2910,1145
649,398,287,111,32,31,33,41,78,183,0,1105,398
650,359,259,100,29,28,30,37,70,165,1,1000,360
651,392,282,110,31,30,32,40,76,183,0,1090,392
652,1010,879,131,66,83,72,98,188,503,0,1806,1010
653,599,393,206,35,46,49,53,119,297,106,1913,705
654,2010,958,1052,143,158,158,188,417,946,0,7787,2010
655,925,570,355,62,74,75,88,175,451,16,2904,941
656,9202,6849,2353,494,1021,750,985,1952,4000,342,23646,9544
657,783,482,301,53,63,64,74,149,380,16,2457,799
658,1402,1070,332,72,109,98,124,292,707,382,3593,1784
659,340,223,117,20,26,28,30,67,169,50,1086,390
660,461,303,158,27,36,38,41,91,228,0,1470,461
661,957,657,300,70,81,76,99,185,446,25,2954,982
662,501,233,268,32,45,39,46,99,240,0,1887,501
663,350,163,187,22,32,27,32,69,168,0,1318,350
664,3968,3143,825,330,479,346,411,716,1686,22,9487,3990
665,328,267,61,16,32,24,35,71,150,0,722,328
666,4444,2865,1579,289,503,387,413,869,1983,52,13492,4496
667,756,620,136,41,65,54,80,159,357,39,1973,795
668,431,329,102,22,34,30,38,90,217,0,1105,431
669,437,203,234,28,39,34,40,86,210,32,1648,469
670,3478,2061,1417,240,310,270,337,657,1664,106,11130,3584
671,936,747,189,72,68,72,99,177,448,24,2354,960
672,1971,1504,467,102,154,138,174,411,992,60,5053,2031
673,642,490,152,33,50,45,57,134,323,0,1646,642
674,2994,2436,558,147,291,217,321,645,1373,0,6593,2994
675,236,169,67,9,22,10,27,51,117,0,663,236
676,448,320,128,17,42,19,51,96,223,0,1260,448
677,405,289,116,15,38,18,46,87,201,17,1138,422
678,1436,1007,429,88,154,142,125,280,647,0,4040,1436
679,654,406,248,39,61,59,56,135,304,0,2371,654
680,470,338,132,47,49,47,52,104,171,8,1270,478
681,390,281,109,39,41,39,43,86,142,0,1052,390
682,362,259,103,14,34,16,41,78,179,0,1016,362
683,718,400,318,53,60,59,56,154,336,0,2753,718
684,1233,687,546,92,102,102,97,265,575,0,4723,1233
685,375,233,142,22,35,34,32,77,175,0,1358,375
686,767,442,325,46,69,64,71,137,380,0,2873,767
687,850,490,360,51,76,70,78,151,424,0,3185,850
688,580,343,237,25,60,48,51,111,285,13,2151,593
689,492,291,201,21,51,41,43,94,242,3,1825,495
690,1078,638,440,46,112,89,94,206,531,135,4000,1213
691,513,303,210,22,53,42,45,98,253,9,1903,522
692,3687,2674,1013,302,381,288,379,669,1668,6,9156,3693
693,1240,959,281,94,121,131,93,245,556,0,3384,1240
694,4764,2928,1836,296,441,394,466,889,2278,10,15386,4774
695,744,533,211,51,79,65,73,142,334,0,2011,744
696,289,207,82,20,31,25,28,55,130,6,780,295
697,8241,5929,2312,825,858,826,908,1825,2999,0,22246,8241
698,1350,966,384,93,143,118,133,258,605,12,3649,1362
699,795,634,161,61,57,61,84,150,382,11,1999,806
700,4639,2991,1648,302,525,404,431,907,2070,0,14086,4639
701,4210,2714,1496,274,476,366,392,823,1879,30,12783,4240
702,689,481,208,46,62,64,60,147,310,0,2365,689
703,1212,845,367,81,109,112,106,258,546,27,4156,1239
704,1062,741,321,71,96,98,93,226,478,95,3641,1157
705,8370,6703,1667,693,912,848,847,1676,3394,0,17950,8370
706,1653,1157,496,114,206,158,172,384,619,18,5115,1671
707,678,516,162,46,58,53,70,126,325,7,1723,685
708,5148,3832,1316,276,571,420,551,1092,2238,0,13229,5148
709,1396,1039,357,75,155,114,149,296,607,0,3588,1396
710,756,595,161,55,65,53,70,154,359,14,1967,770
711,231,182,49,17,20,16,21,47,110,21,602,252
712,347,254,93,16,26,19,31,74,181,0,988,347
713,799,502,297,40,80,68,74,177,360,16,2788,815
714,639,402,237,32,64,54,59,142,288,5,2229,644
715,1231,774,457,61,123,104,113,273,557,0,4293,1231
716,877,678,199,67,85,93,66,173,393,0,2392,877
717,414,309,105,24,40,25,38,78,209,0,1104,414
718,1012,754,258,58,98,62,92,190,512,0,2694,1012
719,521,388,133,30,50,32,48,98,263,11,1388,532
720,691,538,153,48,70,69,57,136,311,0,1974,691
721,2303,1485,818,150,260,200,214,450,1029,115,6993,2418
722,895,550,345,56,83,74,88,167,427,17,2890,912
723,744,457,287,46,69,62,73,139,355,0,2404,744
724,0,0,0,0,0,0,0,0,0,0,0,0
725,0,0,0,0,0,0,0,0,0,106,0,106
726,670,421,249,33,67,57,62,149,302,0,2338,670
727,6051,4710,1341,416,617,604,496,1188,2730,0,17288,6051
728,1274,894,380,100,96,85,116,278,599,63,3863,1337
729,1185,832,353,93,90,80,108,258,556,45,3596,1230
730,1621,1114,507,118,138,129,167,313,756,0,5003,1621
731,446,356,90,34,32,34,47,84,215,24,1122,470
732,277,211,66,19,24,22,29,51,132,16,703,293
733,476,362,114,32,41,37,49,88,229,15,1208,491
734,27860,22065,5795,2315,3365,2432,2884,5026,11838,0,66615,27860
735,1895,1649,246,124,156,136,183,353,943,0,3388,1895
736,39,34,5,3,3,3,4,7,19,0,71,39
737,3569,2189,1380,458,775,234,302,605,1195,13,12438,3582
738,359,294,65,27,35,29,39,70,159,0,881,359
739,1289,1010,279,92,100,98,143,242,614,10,3279,1299
740,1434,1199,235,114,134,117,155,286,628,0,3385,1434
741,260,207,53,16,22,17,27,55,123,0,684,260
742,898,534,364,71,99,78,76,171,403,157,2902,1055
743,344,224,120,25,46,19,22,69,163,40,1066,384
744,2222,2014,208,248,250,216,227,400,881,0,4151,2222
745,1741,1369,372,145,283,180,211,329,593,0,4045,1741
746,1238,920,318,109,179,108,146,257,439,0,3209,1238
747,4270,3461,809,431,616,417,500,869,1437,0,9628,4270
748,798,527,271,68,105,68,75,184,298,3,2394,801
749,1315,937,378,117,180,117,132,298,471,111,3570,1426
750,2745,2099,646,163,283,241,343,435,1280,0,7355,2745
751,3534,2998,536,271,413,321,350,636,1543,0,7625,3534
752,401,283,118,19,37,26,39,78,202,0,1172,401
753,1416,951,465,54,126,112,137,297,690,0,4206,1416
754,628,464,164,30,77,39,72,126,284,6,1697,634
755,878,548,330,61,70,71,61,199,416,255,2335,1133
756,379,195,184,33,34,27,24,102,159,52,1355,431
757,1410,949,461,122,199,156,160,281,492,8,3790,1418
758,1213,888,325,105,178,102,122,266,440,0,3353,1213
759,1527,1161,366,139,220,158,181,309,520,22,3892,1549
760,2445,1654,791,133,180,178,198,471,1285,20,6401,2465
761,1792,1128,664,152,147,153,113,397,830,31,5664,1823
762,2290,1437,853,105,158,192,168,482,1185,168,6245,2458
763,3747,2555,1192,311,354,334,267,789,1692,112,10060,3859
764,2412,1760,652,171,302,213,242,485,999,22,5878,2434
765,421,314,107,24,42,23,41,86,205,0,1091,421
766,338,252,86,19,33,18,33,69,166,0,875,338
767,276,206,70,15,27,15,27,56,136,0,714,276
768,1687,1444,243,117,147,127,162,350,784,225,3572,1912
769,973,833,140,67,85,73,94,202,452,23,2061,996
770,399,311,88,19,37,28,38,78,199,46,951,445
771,2159,1715,444,139,263,181,240,378,958,11,5300,2170
772,995,790,205,64,121,83,111,174,442,34,2441,1029
773,987,784,203,64,120,83,110,173,437,0,2422,987
774,763,653,110,53,66,58,73,158,355,7,1616,770
775,869,703,166,51,77,56,82,192,411,0,2021,869
776,589,356,233,25,62,55,62,112,273,12,1857,601
777,416,251,165,18,44,39,44,79,192,0,1312,416
778,289,175,114,12,30,27,31,55,134,8,913,297
779,495,249,246,34,57,45,51,96,212,0,1801,495
780,756,380,376,52,87,68,79,146,324,130,2750,886
781,746,375,371,52,86,68,78,144,318,35,2716,781
782,586,465,121,38,71,49,65,103,260,566,1439,1152
783,476,240,236,33,55,43,49,92,204,0,1732,476
784,1247,1049,198,101,131,103,123,287,502,230,2622,1477
785,1094,920,174,89,115,90,108,252,440,21,2300,1115
786,644,487,157,60,78,48,66,135,257,0,1668,644
787,1170,984,186,95,123,96,115,270,471,0,2459,1170
788,411,327,84,25,35,27,42,87,195,0,1079,411
789,455,362,93,27,39,29,47,97,216,0,1195,455
790,540,428,112,37,56,52,56,102,237,0,1296,540
791,811,644,167,56,84,79,83,153,356,0,1947,811
792,316,223,93,15,29,21,31,61,159,0,923,316
793,1413,1142,271,84,126,91,133,313,666,18,3287,1431
794,2760,1991,769,228,313,187,244,576,1212,70,7381,2830
795,1053,825,228,80,101,80,105,220,467,111,2470,1164
796,1460,1144,316,110,140,111,146,306,647,0,3424,1460
797,729,551,178,59,62,52,78,153,325,26,1916,755
798,647,505,142,31,60,45,62,127,322,37,1543,684
799,744,581,163,35,69,52,71,146,371,1,1775,745
800,317,247,70,15,29,22,30,62,159,8,757,325
801,521,389,132,27,50,39,46,106,253,0,1225,521
802,254,190,64,13,24,19,22,52,124,0,598,254
803,663,495,168,35,64,49,58,135,322,0,1560,663
804,1146,856,290,60,110,85,101,234,556,0,2696,1146
805,281,210,71,15,27,21,25,57,136,0,661,281
806,610,461,149,50,52,44,65,128,271,57,1604,667
807,571,457,114,59,67,48,46,123,228,79,1313,650
808,1255,1003,252,130,147,105,102,270,501,131,2888,1386
809,319,255,64,33,37,27,26,69,127,51,734,370
810,5942,4642,1300,552,643,431,662,1159,2495,8,14025,5950
811,2462,2220,242,126,233,186,219,540,1158,1,4483,2463
812,1622,1462,160,83,154,122,144,356,763,12,2953,1634
813,1119,1009,110,57,106,84,100,245,527,0,2037,1119
814,582,379,203,41,79,33,36,118,275,93,1805,675
815,358,213,145,28,39,31,30,68,162,24,1157,382
816,361,186,175,31,33,26,22,98,151,68,1290,429
817,779,569,210,75,100,63,73,168,300,0,2014,779
818,1463,1069,394,142,189,118,136,316,562,0,3786,1463
819,668,471,197,48,78,50,67,127,298,23,1832,691
820,594,419,175,42,70,45,59,113,265,28,1629,622
821,327,231,96,23,38,25,33,62,146,38,895,365
822,329,232,97,23,39,25,33,63,146,0,902,329
823,1436,1160,276,110,162,150,131,271,612,0,3172,1436
824,336,237,99,16,31,22,33,65,169,0,982,336
825,461,310,151,18,41,37,44,97,224,0,1369,461
826,1037,965,72,72,115,75,91,215,469,0,1887,1037
827,890,628,262,41,83,59,86,173,448,0,2602,890
828,726,596,130,56,71,59,78,141,321,0,1781,726
829,684,637,47,48,76,50,60,142,308,0,1244,684
830,584,544,40,41,65,42,51,121,264,5,1062,589
831,785,731,54,55,87,57,69,163,354,54,1428,839
832,251,185,66,12,31,15,29,50,114,0,679,251
833,469,347,122,22,58,29,54,94,212,0,1267,469
834,636,481,155,59,77,47,65,133,255,20,1649,656
835,3700,2796,904,345,447,273,377,773,1485,0,9588,3700
836,218,181,37,15,29,17,18,43,96,0,458,218
837,2152,1687,465,164,236,187,229,408,928,172,5323,2324
838,1643,1177,466,164,148,111,141,383,696,38,4538,1681
839,374,304,70,37,50,38,45,83,121,0,833,374
840,1563,860,703,132,237,151,101,322,620,22,5503,1585
841,1536,727,809,113,197,161,103,339,623,129,6135,1665
842,1323,975,348,109,145,118,162,242,547,0,3537,1323
843,665,536,129,48,74,63,75,111,294,0,1686,665
844,1771,1393,378,127,228,179,221,318,698,35,4697,1806
845,2593,1865,728,182,419,227,284,515,966,0,6506,2593
846,432,176,256,30,68,48,37,93,156,0,1721,432
847,1653,1007,646,99,244,148,248,280,634,0,4944,1653
848,1080,795,285,82,167,111,124,232,364,39,3023,1119
849,828,566,262,87,116,76,63,177,309,87,2243,915
850,1796,602,1194,169,258,219,100,434,616,104,9087,1900
851,1648,561,1087,174,231,200,122,398,523,27,7861,1675
852,1898,1349,549,149,253,184,194,412,706,200,4599,2098
853,1097,842,255,131,142,93,116,241,374,0,2695,1097
854,1188,851,337,136,140,113,107,274,418,10,3371,1198
855,1840,1473,367,212,226,195,149,374,684,11,4618,1851
856,6007,5352,655,814,832,612,545,1162,2042,8,13570,6015
857,2731,2089,642,286,265,212,250,601,1117,69,6905,2800
858,1258,930,328,146,156,104,115,301,436,0,3354,1258
859,1253,939,314,149,125,96,127,264,492,0,3330,1253
860,2328,1753,575,182,318,244,248,462,874,41,6010,2369
861,2301,1717,584,206,327,252,266,433,817,43,5828,2344
862,3338,2655,683,276,479,366,466,604,1147,105,8735,3443
863,2017,1546,471,235,262,178,203,438,701,27,4930,2044
864,790,566,224,90,102,75,83,156,284,0,2228,790
865,4722,1792,2930,537,770,500,311,1033,1571,15,20437,4737
866,3029,1285,1744,249,500,341,217,742,980,77,12381,3106
867,3723,1948,1775,291,651,364,380,777,1260,36,10922,3759
868,2694,2411,283,340,393,301,300,537,823,57,5472,2751
869,224,160,64,26,29,21,24,44,80,539,632,763
870,495,354,141,57,64,47,52,98,177,0,1398,495
871,1578,984,594,104,203,148,155,309,659,0,4156,1578
872,413,310,103,28,55,42,46,79,163,0,1139,413
873,269,186,83,30,35,19,23,62,100,0,757,269
874,287,198,89,32,38,20,25,66,106,0,810,287
875,494,342,152,55,65,35,42,113,184,0,1393,494
876,1109,744,365,56,125,101,111,220,496,35,3152,1144
877,1019,731,288,50,107,79,130,187,466,0,2807,1019
878,778,558,220,38,81,60,100,143,356,3,2142,781
879,345,248,97,45,45,33,27,69,126,0,970,345
880,697,578,119,48,92,54,57,136,310,0,1460,697
881,1921,1594,327,132,254,149,156,376,854,19,4026,1940
882,1456,1208,248,100,193,113,118,285,647,16,3051,1472
883,676,519,157,81,88,58,71,148,230,0,1662,676
884,165,96,69,17,26,17,14,38,53,758,498,923
885,358,209,149,38,56,37,30,83,114,0,1080,358
886,1122,911,211,110,151,113,134,248,366,0,2501,1122
887,394,320,74,39,53,40,47,87,128,25,879,419
888,4033,3610,423,509,588,451,449,804,1232,2,8192,4035
889,459,330,129,59,60,45,37,91,167,3,1289,462
890,992,899,93,119,127,102,119,184,341,0,1868,992
891,994,901,93,120,127,102,120,184,341,0,1872,994
892,1198,1086,112,144,154,123,144,222,411,160,2256,1358
893,1050,527,523,77,158,87,109,187,432,46,3537,1096
894,384,193,191,28,58,32,40,68,158,0,1292,384
895,8037,6811,1226,816,1070,753,777,1520,3101,346,15508,8383
896,1155,810,345,91,133,117,97,266,451,0,3398,1155
897,477,194,283,33,75,52,41,102,174,0,1899,477
898,1501,1246,255,103,199,117,122,294,666,36,3145,1537
899,872,438,434,64,131,73,91,155,358,0,2939,872
900,474,401,73,68,139,48,37,89,93,125,1097,599
901,324,274,50,47,95,33,26,61,62,0,750,324
902,748,466,282,49,96,70,73,146,314,13,1970,761
903,1237,966,271,95,118,98,153,234,539,0,3025,1237
904,619,464,155,43,83,64,70,118,241,8,1706,627
905,451,373,78,32,54,44,49,89,183,36,1025,487
906,1189,984,205,84,142,115,129,234,485,12,2701,1201
907,546,452,94,39,65,53,59,108,222,9,1241,555
908,918,565,353,71,133,83,96,168,367,0,2593,918
909,626,255,371,43,99,69,54,134,227,340,2492,966
910,914,422,492,60,138,62,125,165,364,2,3303,916
911,572,370,202,36,79,47,65,111,234,0,1677,572
912,1148,1027,121,145,167,128,128,229,351,0,2333,1148
913,652,591,61,79,84,67,79,121,222,0,1227,652
914,757,350,407,50,114,52,104,136,301,37,2737,794
915,500,324,176,31,69,41,57,97,205,0,1467,500
916,732,474,258,46,101,60,83,142,300,38,2145,770
917,644,417,227,40,89,53,73,125,264,39,1890,683
918,1228,937,291,115,197,112,119,265,420,0,2970,1228
919,384,293,91,36,62,35,37,83,131,0,929,384
920,742,617,125,56,110,68,65,180,263,0,1912,742
921,6015,4721,1294,654,927,528,609,1231,2066,144,15506,6159
922,2131,1571,560,183,339,217,229,437,726,209,6135,2340
923,1551,1115,436,116,206,171,133,359,566,1,4508,1552
924,2018,1696,322,199,305,224,180,409,701,0,4948,2018
925,565,434,131,44,98,65,47,116,195,0,1537,565
926,2572,1913,659,292,385,259,243,569,824,0,6680,2572
927,632,483,149,56,103,53,58,141,221,0,1577,632
928,1053,782,271,104,160,112,118,205,354,0,3032,1053
929,9,7,2,2,1,1,1,2,2,3539,16,3548
930,1498,1145,353,132,208,133,171,324,530,13,4229,1511
931,671,593,78,95,88,67,76,140,205,24,1358,695
932,599,468,131,50,93,53,66,129,208,28,1487,627
933,1296,933,363,116,195,127,127,287,444,13,3653,1309
934,1108,849,259,92,158,88,89,255,426,0,3046,1108
935,1279,1054,225,120,180,152,100,255,472,0,3166,1279
936,1519,1135,384,126,245,166,127,356,499,10,4141,1529
937,1186,825,361,104,202,112,115,266,387,0,3183,1186
938,954,712,242,70,136,111,100,194,343,0,2729,954
939,0,0,0,0,0,0,0,0,0,0,0,0
940,1432,1369,63,132,251,185,96,308,460,367,3251,1799
941,2992,2410,582,260,351,269,315,660,1137,304,7866,3296
942,1233,955,278,134,210,118,139,273,359,10,3037,1243
943,1104,854,250,112,211,103,121,217,340,0,2626,1104
944,1104,814,290,140,200,102,121,241,300,0,2735,1104
945,2468,2065,403,285,452,210,331,456,734,38,5023,2506
946,1449,1171,278,151,211,121,178,324,464,0,3134,1449
947,645,537,108,76,99,51,86,132,201,0,1301,645
948,2653,2004,649,317,493,249,236,552,806,20,6499,2673
949,712,592,120,84,110,56,95,145,222,0,1435,712
950,1053,796,257,126,196,99,94,219,319,0,2580,1053
951,1063,884,179,125,164,84,142,217,331,0,2143,1063
952,3682,3412,270,453,541,333,424,751,1180,296,6732,3978
953,0,0,0,0,0,0,0,0,0,0,0,0
954,0,0,0,0,0,0,0,0,0,0,0,0
955,19290,15918,3372,3962,3048,2176,2226,3596,4282,24,34602,19314
956,1560,1136,424,136,251,152,131,355,535,7,4275,1567
957,1588,1472,116,195,233,144,183,324,509,26,2904,1614
958,418,311,107,47,62,42,40,92,135,0,1086,418
959,1373,1054,319,164,245,117,151,276,420,0,3117,1373
960,712,575,137,78,114,72,85,164,199,3634,977,4346
961,637,493,144,64,121,60,70,125,197,0,1513,637
962,801,570,231,78,115,76,69,177,286,0,2094,801
963,699,571,128,56,114,95,67,154,213,7,1821,706
964,1680,1323,357,179,297,168,164,344,528,0,4094,1680
965,1987,1564,423,212,352,199,194,407,623,0,4841,1987
966,1189,936,253,127,210,119,116,243,374,14,2898,1203
967,703,525,178,58,114,77,59,165,230,0,1917,703
968,909,693,216,104,145,87,88,196,289,0,2305,909
969,1121,847,274,134,209,105,100,233,340,0,2747,1121
970,557,435,122,47,87,50,62,120,191,0,1384,557
971,1383,1056,327,130,222,126,133,298,474,6,3344,1389
972,214,173,41,22,31,18,26,48,69,0,463,214
973,1013,819,194,106,148,84,124,226,325,0,2192,1013
974,1079,796,283,137,196,100,118,235,293,0,2673,1079
975,197,165,32,23,36,17,26,36,59,0,402,197
976,1082,817,265,129,201,102,96,225,329,0,2652,1082
977,3425,2527,898,434,621,316,374,747,933,36,8488,3461
978,205,181,24,29,27,21,23,43,62,0,415,205
979,701,577,124,66,99,83,55,139,259,83,1737,784
980,881,779,102,125,115,88,100,183,270,0,1782,881
981,701,620,81,99,92,70,80,146,214,0,1418,701
982,505,389,116,55,99,45,46,106,154,0,1251,505
983,335,258,77,36,66,30,31,70,102,0,831,335
984,3576,3024,552,481,641,314,460,723,957,0,7309,3576
985,878,676,202,95,172,78,80,185,268,0,2175,878
986,3850,3255,595,518,690,338,495,778,1031,0,7869,3850
987,1989,1516,473,227,316,189,192,429,636,0,5044,1989
988,2767,2339,428,372,496,243,356,559,741,0,5654,2767
989,1840,1556,284,247,330,162,237,372,492,3,3761,1843
990,351,270,81,38,69,31,32,74,107,21,868,372
991,0,0,0,0,0,0,0,0,0,0,0,0
992,803,559,244,70,137,76,78,180,262,4,2156,807
993,649,498,151,77,116,55,71,131,199,0,1472,649
994,485,354,131,45,65,46,44,110,175,0,1293,485
995,565,412,153,53,75,53,51,129,204,0,1503,565
996,293,214,79,27,39,28,27,67,105,0,781,293
997,281,205,76,26,38,26,25,64,102,0,747,281
998,814,754,60,100,120,74,94,166,260,95,1489,909
999,618,509,109,58,87,73,48,123,229,0,1530,618
1000,0,0,0,0,0,0,0,0,0,0,0,0
1001,1445,1109,336,173,258,123,159,291,441,0,3280,1445
1002,384,280,104,33,62,38,32,87,132,0,1052,384
1003,453,337,116,45,69,48,51,88,152,0,1305,453
1004,424,315,109,42,65,45,48,82,142,18,1222,442
1005,1225,942,283,94,213,141,101,252,424,0,3328,1225
1006,701,499,202,69,101,67,60,155,249,0,1834,701
1007,884,630,254,87,127,84,76,195,315,94,2313,978
1008,709,541,168,63,115,60,65,158,248,0,1768,709
1009,449,312,137,39,76,43,44,101,146,0,1206,449
1010,6363,5155,1208,567,1150,860,494,1375,1917,34,16760,6397
1011,4466,3685,781,917,706,504,515,832,992,0,8012,4466
1012,0,0,0,0,0,0,0,0,0,0,0,0
1013,3286,2376,910,342,442,301,381,642,1178,20,9070,3306
1014,1520,1073,447,128,217,147,178,309,541,0,4228,1520
1015,1889,1280,609,175,236,189,255,373,661,11,5472,1900
1016,1532,1012,520,154,197,139,197,341,504,0,4442,1532
1017,906,645,261,81,124,76,125,170,330,6,2540,912
1018,305,225,80,28,41,32,40,61,103,0,805,305
1019,2421,1789,632,223,322,252,315,484,825,0,6391,2421
1020,3754,2904,850,465,494,398,430,735,1232,11,9263,3765
1021,16011,13645,2366,1718,3172,1455,1753,3575,4338,3,34298,16014
1022,11213,7854,3359,3297,6203,447,410,553,303,0,26616,11213
1023,3789,3162,627,567,685,449,427,760,901,0,8887,3789
1024,865,452,413,67,106,70,136,160,326,32,3349,897
1025,2603,1925,678,287,335,259,219,660,843,7,7389,2610
1026,795,609,186,83,133,69,58,216,236,20,2431,815
1027,3801,3106,695,408,545,344,342,929,1233,0,9583,3801
1028,3902,3233,669,495,542,386,359,912,1208,8,9802,3910
1029,1362,874,488,149,196,148,149,282,438,0,4106,1362
1030,1374,1059,315,140,187,163,141,292,451,22,3308,1396
1031,2813,1981,832,247,393,256,304,634,979,0,7273,2813
1032,3559,2360,1199,393,478,378,426,756,1128,39,9625,3598
1033,2732,2041,691,295,375,265,371,563,863,161,7287,2893
1034,1076,850,226,108,119,121,126,232,370,171,2808,1247
1035,6131,5065,1066,750,806,611,777,1285,1902,115,14378,6246
1036,1149,910,239,129,147,121,144,230,378,0,2662,1149
1037,571,421,150,65,79,62,65,117,183,0,1452,571
1038,1639,1012,627,148,264,175,210,328,514,0,5237,1639
1039,5,3,2,0,1,0,0,2,2,0,13,5
1040,2726,1950,776,360,373,249,251,634,859,0,7711,2726
1041,6997,5419,1578,860,1069,745,605,1582,2136,13,15060,7010
1042,1074,824,250,138,198,92,97,226,323,0,2495,1074
1043,12,11,1,5,7,0,0,0,0,0,0,12
1044,134,127,7,26,23,19,16,30,20,0,0,134
1045,0,0,0,0,0,0,0,0,0,0,0,0
1046,11753,11045,708,1412,2093,832,1392,2517,3507,25,23487,11778
1047,11985,10211,1774,2484,1521,1083,1218,2621,3058,0,28168,11985
1048,204,157,47,22,42,21,16,47,56,4,568,208
1049,1184,793,391,95,126,98,132,269,464,11,3555,1195
1050,0,0,0,0,0,0,0,0,0,0,0,0
1051,5603,4445,1158,580,1045,441,609,1212,1716,0,12931,5603
1052,8811,8671,140,2429,3925,109,956,773,619,0,0,8811
1053,4,4,0,0,0,1,0,1,2,0,8,4
1054,6229,6079,150,2439,1654,207,447,612,870,0,0,6229
1055,1307,934,373,152,199,130,136,304,386,0,3930,1307
1056,186,91,95,25,54,18,24,33,32,0,739,186
1057,12461,10665,1796,1645,2189,1442,1482,2349,3354,0,29059,12461
1058,1661,1057,604,292,383,140,114,350,382,604,6352,2265
1059,205,122,83,19,31,18,21,53,63,0,688,205
1060,2037,1417,620,242,309,204,187,492,603,0,5784,2037
1061,1160,905,255,132,159,117,100,267,385,0,3152,1160
1062,1338,1059,279,145,241,138,122,296,396,17,3603,1355
1063,1916,1593,323,237,241,192,149,492,605,27,4703,1943
1064,2165,1572,593,229,296,221,261,474,684,0,5663,2165
1065,1650,1198,452,174,226,168,199,361,522,0,4315,1650
1066,0,0,0,0,0,0,0,0,0,0,0,0
1067,45,38,7,9,6,4,5,10,11,0,105,45
1068,10930,9312,1618,2266,1387,988,1110,2390,2789,0,25689,10930
1069,2276,1667,609,230,362,190,254,479,761,0,5261,2276
1070,9914,8447,1467,2055,1258,896,1007,2168,2530,0,23301,9914
1071,1536,1119,417,164,249,123,143,363,494,0,4270,1536
1072,1397,1017,380,149,226,112,130,330,450,0,3883,1397
1073,1106,877,229,184,98,129,147,225,323,0,2578,1106
1074,413,322,91,47,57,42,36,95,136,5,1123,418
1075,599,468,131,68,82,60,52,138,199,9,1629,608
1076,279,218,61,32,38,28,24,64,93,0,758,279
1077,4,4,0,0,1,0,1,1,1,0,8,4
1078,2515,2014,501,305,351,220,279,553,807,0,5429,2515
1079,282,216,66,29,47,24,21,77,84,0,861,282
1080,613,472,141,62,84,73,63,130,201,2,1476,615
1081,2771,2232,539,273,505,270,292,622,809,0,6390,2771
1082,358,214,144,33,54,31,36,93,111,0,1201,358
1083,195,116,79,18,30,17,20,51,59,0,656,195
1084,997,824,173,122,131,99,126,209,310,0,2338,997
1085,521,334,187,57,75,56,57,108,168,43,1572,564
1086,552,354,198,60,79,60,61,114,178,0,1664,552
1087,792,552,240,93,121,73,88,153,264,0,2143,792
1088,1040,768,272,118,143,112,118,214,335,0,2645,1040
1089,491,362,129,56,68,53,56,101,157,0,1248,491
1090,625,435,190,73,95,58,69,121,209,13,1692,638
1091,572,422,150,65,79,62,65,118,183,0,1454,572
1092,382,328,54,46,56,39,50,78,113,0,839,382
1093,1626,1216,410,247,286,156,128,377,432,0,4574,1626
1094,1339,975,364,143,217,107,125,316,431,0,3722,1339
1095,4903,4233,670,493,877,313,649,1143,1428,13,11842,4916
1096,1203,888,315,136,166,130,137,247,387,0,3058,1203
1097,871,748,123,105,127,89,113,177,260,4,1913,875
1098,3519,3022,497,423,514,359,459,716,1048,0,7727,3519
1099,618,466,152,55,88,63,73,134,205,126,1634,744
1100,545,411,134,49,77,55,65,118,181,0,1441,545
1101,1106,834,272,98,157,112,131,239,369,0,2923,1106
1102,597,473,124,67,76,63,75,120,196,0,1382,597
1103,408,296,112,43,56,42,49,89,129,0,1066,408
1104,672,532,140,75,86,71,84,135,221,0,1557,672
1105,1654,1183,471,218,227,151,152,384,522,15,4679,1669
1106,1162,892,270,149,214,99,104,244,352,0,2699,1162
1107,579,444,135,74,107,50,52,122,174,0,1345,579
1108,140,108,32,17,18,15,16,27,47,0,346,140
1109,1964,1451,513,181,261,204,256,392,670,7,5185,1971
1110,1702,753,949,150,241,142,180,432,557,10,6083,1712
1111,3365,2576,789,496,368,370,416,727,988,111,7799,3476
1112,713,664,49,139,34,61,49,194,236,0,1564,713
1113,10327,7944,2383,1126,2137,1043,828,2364,2829,0,28692,10327
1114,1413,843,570,132,215,124,144,366,432,8,4745,1421
1115,586,425,161,62,80,60,71,128,185,0,1533,586
1116,0,0,0,0,0,0,0,0,0,0,0,0
1117,444,352,92,74,39,52,59,90,130,10,1034,454
1118,780,619,161,130,69,91,104,158,228,0,1819,780
1119,2395,1667,728,202,343,171,297,562,820,11,6432,2406
1120,1047,622,425,65,198,104,117,233,330,0,3292,1047
1121,1555,964,591,108,204,134,179,380,550,0,4806,1555
1122,1411,876,535,133,223,120,170,315,450,7,4434,1418
1123,3968,2675,1293,342,631,309,490,877,1319,20,11738,3988
1124,911,720,191,108,128,92,91,193,299,0,2068,911
1125,2584,1820,764,266,386,252,272,573,835,0,6672,2584
1126,3244,1930,1314,346,395,317,366,728,1092,13,9406,3257
1127,2798,2008,790,291,372,238,339,585,973,245,7052,3043
1128,12432,9912,2520,1418,1704,1218,1212,2754,4126,4,25410,12436
1129,4212,3158,1054,506,617,437,467,917,1268,0,9715,4212
1130,1424,945,479,128,200,142,158,328,468,0,4122,1424
1131,2679,1686,993,253,383,261,298,604,880,18,7674,2697
1132,1335,809,526,150,181,131,156,300,417,0,3933,1335
1133,2214,1415,799,214,355,256,250,481,658,15,5961,2229
1134,2577,1805,772,224,398,197,315,592,851,87,6697,2664
1135,1994,1434,560,154,349,198,184,488,621,212,5357,2206
1136,1363,990,373,78,228,131,150,342,434,0,3694,1363
1137,2670,1891,779,252,372,236,353,592,865,0,7448,2670
1138,3225,2741,484,347,394,299,382,785,1018,150,6998,3375
1139,1076,770,306,99,156,98,133,237,353,129,2879,1205
1140,1818,1376,442,167,256,182,194,446,573,0,4215,1818
1141,914,627,287,81,107,71,112,226,317,0,2546,914
1142,3825,2884,941,339,477,300,460,862,1387,133,10086,3958
1143,1037,755,282,102,130,99,146,223,337,0,2714,1037
1144,1494,1106,388,124,239,140,158,348,485,34,3959,1528
1145,1984,1394,590,134,286,145,248,478,693,0,5629,1984
1146,1698,1097,601,155,239,142,182,388,592,0,5062,1698
1147,2033,1224,809,147,315,175,198,483,715,0,6095,2033
1148,2904,2043,861,264,388,245,349,623,1035,325,7960,3229
1149,3786,2199,1587,345,579,313,474,886,1189,0,11476,3786
1150,1848,1074,774,121,294,139,184,434,676,0,5814,1848
1151,1635,1038,597,127,256,146,234,288,584,0,4901,1635
1152,2408,1569,839,225,374,243,333,466,767,0,6642,2408
1153,5153,3669,1484,481,792,443,608,1212,1617,34,13941,5187
1154,3154,1914,1240,230,507,267,396,690,1064,42,9289,3196
1155,9706,7078,2628,941,1605,773,1128,1977,3282,3,25721,9709
1156,3335,2820,515,410,436,368,293,781,1047,185,7643,3520
1157,1998,1675,323,207,322,183,137,491,658,25,5012,2023
1158,1829,1536,293,227,271,141,149,418,623,0,4546,1829
1159,3263,2373,890,324,526,288,361,762,1002,314,8820,3577
1160,2843,1977,866,300,387,258,361,553,984,0,7284,2843
1161,2325,1632,693,230,315,237,238,484,821,0,5595,2325
1162,1158,850,308,128,179,111,116,264,360,25,2651,1183
1163,2621,1566,1055,325,349,209,317,545,876,0,8000,2621
1164,1877,1259,618,171,257,182,178,430,659,0,4995,1877
1165,1773,1153,620,159,257,165,207,371,614,13,4586,1786
1166,1637,1113,524,154,223,136,174,385,565,0,4454,1637
1167,1719,1273,446,174,250,167,199,368,561,14,4404,1733
1168,2396,1588,808,182,427,261,217,590,719,53,6903,2449
1169,1352,1098,254,165,167,113,138,315,454,1,2808,1353
1170,2039,1652,387,202,315,204,197,468,653,0,4897,2039
1171,1915,1310,605,133,258,145,233,436,710,7,5648,1922
1172,2015,1338,677,142,305,156,246,488,678,3,5916,2018
1173,1649,1165,484,131,201,145,201,416,555,24,4087,1673
1174,2333,1765,568,242,366,274,261,491,699,18,5854,2351
1175,5900,4371,1529,466,920,587,589,1428,1910,280,14854,6180
1176,2127,1640,487,222,329,182,252,426,716,11,5276,2138
1177,1781,1416,365,205,287,147,130,433,579,35,4830,1816
1178,1673,1287,386,166,251,161,129,448,518,46,4781,1719
1179,2222,1468,754,253,346,185,252,508,678,14,6413,2236
1180,1349,868,481,92,238,142,119,345,413,0,3991,1349
1181,3416,2951,465,303,703,387,362,662,999,0,8354,3416
1182,992,534,458,88,159,80,132,208,325,63,3926,1055
1183,941,288,653,99,145,90,110,196,301,14,4455,955
1184,1094,518,576,102,176,92,175,210,339,70,4692,1164
1185,918,386,532,73,149,91,129,187,289,69,3995,987
1186,809,438,371,93,124,89,105,161,237,107,2775,916
1187,3320,2059,1261,373,524,335,309,735,1044,94,10071,3414
1188,312,279,33,40,54,33,34,59,92,86,789,398
1189,655,415,240,98,92,69,73,143,180,25,1761,680
1190,2734,1898,836,343,387,277,281,622,824,289,7680,3023
1191,1585,1335,250,165,260,171,145,352,492,0,3165,1585
1192,1538,1343,195,136,209,153,138,362,540,8,3468,1546
1193,2465,1826,639,212,367,257,280,573,776,46,6651,2511
1194,1583,817,766,219,230,172,209,314,439,49,5153,1632
1195,6336,3571,2765,639,1191,766,712,1353,1675,34,18300,6370
1196,503,185,318,36,87,34,69,102,175,7,2427,510
1197,1282,649,633,123,198,139,134,279,409,94,4797,1376
1198,746,574,172,90,107,72,71,175,231,18,1654,764
1199,2740,2120,620,257,385,309,211,657,921,213,6707,2953
1200,3275,2587,688,360,515,338,332,715,1015,0,7560,3275
1201,2937,2399,538,295,452,268,319,634,969,15,6925,2952
1202,789,626,163,79,117,86,92,176,239,3,1917,792
1203,2051,1626,425,203,283,207,245,465,648,22,5218,2073
1204,8345,7085,1260,971,1298,785,865,1884,2542,29,17764,8374
1205,2397,1904,493,220,333,250,166,554,874,0,6156,2397
1206,597,214,383,78,99,66,69,116,169,7,2491,604
1207,2650,1892,758,252,377,271,253,625,872,11,6781,2661
1208,2591,1858,733,236,453,274,281,567,780,53,7244,2644
1209,1882,1470,412,159,286,189,201,425,622,11,5000,1893
1210,1606,1290,316,148,273,183,181,327,494,158,4026,1764
1211,2523,1201,1322,247,434,289,271,540,742,0,9314,2523
1212,1321,354,967,135,246,140,171,263,366,0,5774,1321
1213,1069,386,683,116,180,66,162,208,337,88,5093,1157
1214,1320,1266,54,175,167,128,81,349,420,179,3000,1499
1215,723,573,150,73,107,78,84,161,220,13,1756,736
1216,1720,1215,505,214,270,194,196,369,477,74,4471,1794
1217,4632,3273,1359,577,727,523,528,995,1282,541,12042,5173
1218,1333,561,772,138,215,149,167,251,413,0,5114,1333
1219,3340,2704,636,368,575,368,380,765,884,0,8264,3340
1220,13261,10737,2524,1460,2285,1460,1510,3037,3509,0,32808,13261
1221,268,209,59,43,34,31,36,54,70,4162,665,4430
1222,271,239,32,21,30,24,20,70,106,99,638,370
1223,56270,48606,7664,4991,11575,6375,5970,10911,16448,0,137631,56270
1224,1329,1119,210,221,173,149,132,296,358,24,2639,1353
1225,519,349,170,63,79,53,51,115,158,0,1567,519
1226,513,345,168,62,78,53,51,113,156,13,1548,526
1227,1610,1355,255,267,210,180,160,359,434,4,3198,1614
1228,1212,847,365,148,186,122,127,269,360,22,3320,1234
1229,3697,2612,1085,461,580,417,421,794,1024,1,9611,3698
1230,1034,429,605,117,180,116,114,193,314,0,3805,1034
1231,2724,1604,1120,308,391,270,261,570,924,34,8680,2758
1232,710,440,270,80,112,72,66,157,223,0,2154,710
1233,1955,1553,402,179,272,204,136,452,712,0,5020,1955
1234,1381,643,738,172,212,143,162,299,393,0,5232,1381
1235,402,169,233,42,65,45,50,76,124,296,1542,698
1236,10059,8022,2037,1293,1568,1025,1172,2223,2778,59,21290,10118
1237,359,280,79,57,46,41,48,72,95,0,890,359
1238,335,212,123,50,47,35,38,73,92,30,902,365
1239,1621,1132,489,199,248,164,170,360,480,1,4441,1622
1240,4196,2440,1756,536,690,379,547,936,1108,122,14408,4318
1241,1390,982,408,173,218,157,158,299,385,388,3613,1778
1242,414,328,86,41,57,42,49,94,131,0,1054,414
1243,2744,2590,154,543,198,227,253,649,874,1905,6562,4649
1244,681,540,141,69,101,74,79,152,206,0,1653,681
1245,549,435,114,55,81,60,64,122,167,0,1333,549
1246,586,465,121,59,87,64,68,130,178,0,1423,586
1247,711,671,40,141,51,59,66,168,226,3,1699,714
1248,389,308,81,39,58,42,45,87,118,0,945,389
1249,427,157,270,31,74,28,58,87,149,3,2062,430
1250,763,588,175,92,109,74,72,179,237,0,1691,763
1251,466,313,153,56,71,48,46,103,142,0,1405,466
1252,329,294,35,42,57,34,36,62,98,559,834,888
1253,466,313,153,56,71,48,46,103,142,0,1405,466
1254,407,171,236,42,66,46,51,77,125,29,1560,436
1255,294,119,175,29,36,26,35,74,94,0,1198,294
1256,1767,956,811,203,271,195,228,352,518,50,6064,1817
1257,155,32,123,15,22,16,17,35,50,8,692,163
1258,258,53,205,25,37,27,28,58,83,0,1151,258
1259,2047,1651,396,226,296,211,178,478,658,78,4485,2125
1260,231,97,134,24,37,26,29,43,72,0,887,231
1261,703,446,257,105,98,74,79,153,194,147,1891,850
1262,487,309,178,73,68,51,55,106,134,122,1311,609
1263,1079,684,395,162,151,114,121,236,295,0,2901,1079
1264,569,204,365,75,95,63,66,110,160,49,2373,618
1265,906,527,379,116,149,82,118,202,239,0,3112,906
1266,1519,883,636,194,250,137,198,339,401,0,5214,1519
1267,700,332,368,76,114,68,88,156,198,25,2693,725
1268,673,138,535,65,96,71,73,151,217,0,3005,673
1269,1111,526,585,121,180,108,140,248,314,0,4270,1111
1270,1009,802,207,93,140,105,70,233,368,0,2592,1009
1271,710,573,137,78,103,73,62,166,228,16,1557,726
1272,896,668,228,120,109,94,83,199,291,60,2167,956
1273,646,577,69,82,113,68,71,121,191,389,1636,1035
1274,514,324,190,65,78,47,60,112,152,0,1563,514
1275,364,325,39,46,64,38,40,68,108,30,920,394
1276,417,263,154,53,64,38,48,91,123,0,1267,417
1277,184,116,68,23,28,17,21,40,55,62,559,246
1278,1703,1190,513,209,261,172,179,378,504,342,4665,2045
1279,565,357,208,72,86,51,66,123,167,26,1716,591
1280,585,340,245,75,96,53,76,130,155,0,2007,585
1281,894,586,308,112,150,90,98,193,251,0,2486,894
1282,428,178,250,48,75,48,47,80,130,125,1575,553
1283,1460,956,504,184,244,148,161,316,407,0,4060,1460
1284,1295,1033,262,166,202,132,151,286,358,0,2741,1295
1285,0,0,0,0,0,0,0,0,0,0,0,0
1286,3694,2946,748,475,576,376,430,816,1021,175,7820,3869
1287,325,254,71,51,47,39,29,69,90,37,771,362
1288,818,571,247,100,125,83,86,182,242,8,2241,826
1289,1466,1148,318,229,213,175,133,309,407,72,3474,1538
1290,691,541,150,108,100,83,62,146,192,1,1638,692
1291,282,221,61,44,41,34,25,59,79,0,669,282
1292,365,286,79,57,53,44,33,77,101,13,864,378
1293,2170,1879,291,331,384,286,232,434,503,24,4138,2194
1294,1075,931,144,164,190,142,115,215,249,110,2051,1185
1295,627,506,121,69,91,65,55,146,201,0,1374,627
1296,322,230,92,37,59,30,32,75,89,98,760,420
1297,513,382,131,68,63,54,48,114,166,56,1241,569
1298,176,83,93,19,29,17,22,39,50,0,678,176
1299,703,593,110,87,113,59,61,164,219,0,1754,703
1300,914,771,143,113,147,77,79,213,285,64,2280,978
1301,580,489,91,72,93,49,50,135,181,0,1446,580
1302,249,118,131,27,40,24,31,56,71,4,956,253
1303,785,319,466,79,96,71,94,199,246,15,3192,800
1304,497,419,78,62,80,42,43,116,154,0,1240,497
1305,544,522,22,72,69,53,33,144,173,1285,1236,1829
1306,2902,2507,395,257,597,329,308,563,848,0,7099,2902
1307,25391,21933,3458,2252,5223,2877,2694,4923,7422,0,62103,25391
1308,2645,2227,418,439,345,297,263,589,712,0,5254,2645
1309,13122,6275,6847,1728,1299,1560,1716,2851,3968,46,56668,13168
1310,18459,7808,10651,1970,2224,1728,2322,3622,6593,25,92218,18484
1311,1032,672,360,101,137,94,132,216,352,6,3462,1038
1312,2521,1222,1299,220,398,203,321,595,784,35,9848,2556
1313,1742,742,1000,170,274,142,215,383,558,161,7101,1903
1314,3055,1353,1702,211,470,262,348,712,1052,67,11371,3122
1315,1055,513,542,59,176,98,110,259,353,43,4607,1098
1316,986,528,458,74,142,100,110,232,328,62,4116,1048
1317,853,450,403,68,119,85,106,189,286,20,3432,873
1318,1101,453,648,110,158,106,122,255,350,48,4401,1149
1319,2730,1533,1197,274,345,293,264,631,923,13,9701,2743
1320,1783,931,852,185,206,174,158,419,641,28,6510,1811
1321,852,652,200,107,84,102,56,207,296,0,2184,852
1322,1437,831,606,122,199,138,137,372,469,8,5063,1445
1323,548,303,245,59,57,59,52,119,202,0,1866,548
1324,738,365,373,90,73,73,57,177,268,0,2699,738
1325,1221,530,691,125,136,112,116,293,439,14,4697,1235
1326,1414,768,646,128,177,148,120,315,526,10,4835,1424
1327,1013,537,476,116,123,109,85,227,353,17,3739,1030
1328,1869,1061,808,210,224,186,200,412,637,10,6543,1879
1329,347,249,98,41,52,32,38,74,110,0,962,347
1330,8010,5975,2035,853,1363,699,966,1648,2481,0,22216,8010
1331,3419,1725,1694,458,374,399,416,633,1139,256,13163,3675
1332,1233,694,539,110,168,120,128,262,445,0,4522,1233
1333,3906,3383,523,375,477,436,477,824,1317,8,8795,3914
1334,1142,581,561,81,190,124,130,263,354,56,4580,1198
1335,915,244,671,119,122,91,106,190,287,7,4937,922
1336,1272,455,817,155,98,151,173,278,417,10,5963,1282
1337,1352,291,1061,154,188,110,195,285,420,6,7586,1358
1338,355,60,295,41,44,32,44,83,111,13,2085,368
1339,843,323,520,56,144,104,83,204,252,0,4055,843
1340,866,366,500,58,148,107,81,199,273,0,3963,866
1341,2444,1027,1417,304,310,317,273,483,757,13,10704,2457
1342,256,115,141,26,36,31,29,50,84,0,1038,256
1343,2025,1350,675,212,286,206,231,424,666,34,6815,2059
1344,1351,569,782,180,141,168,165,298,399,0,6049,1351
1345,1693,1140,553,138,244,202,220,366,523,28,5520,1721
1346,553,347,206,42,81,56,53,120,201,0,1711,553
1347,1207,636,571,137,169,113,91,284,413,36,4463,1243
1348,789,449,340,75,87,83,78,197,269,39,2771,828
1349,1664,733,931,136,247,134,193,421,533,0,6613,1664
1350,1397,782,615,147,184,126,164,324,452,24,4848,1421
1351,3858,1971,1887,282,546,296,469,949,1316,34,13662,3892
1352,2142,503,1639,307,176,245,275,473,666,14,11271,2156
1353,1196,375,821,98,196,146,102,276,378,78,6049,1274
1354,1240,472,768,111,192,162,124,273,378,27,5691,1267
1355,226,119,107,34,28,29,27,44,64,3,862,229
1356,861,244,617,112,101,97,104,161,286,0,4167,861
1357,6676,4469,2207,1048,722,902,688,1269,2047,0,19983,6676
1358,241,127,114,34,26,26,31,50,74,0,910,241
1359,2165,1342,823,197,315,236,232,489,696,231,7594,2396
1360,1673,1004,669,113,277,148,247,337,551,18,5649,1691
1361,2430,1343,1087,208,366,259,261,529,807,59,9227,2489
1362,1679,767,912,142,261,208,160,378,530,0,6956,1679
1363,988,487,501,100,120,118,91,233,326,460,3959,1448
1364,1269,567,702,98,186,139,137,294,415,7,5462,1276
1365,1584,1220,364,150,200,145,216,339,534,34,4639,1618
1366,1438,1032,406,125,176,183,171,292,491,24,4473,1462
1367,1402,1012,390,127,183,139,178,275,500,4,4260,1406
1368,2194,1370,824,196,406,219,239,460,674,0,6354,2194
1369,1984,1066,918,218,271,180,198,452,665,25,6795,2009
1370,700,391,309,67,85,70,74,156,248,17,2484,717
1371,1326,565,761,132,181,141,100,313,459,0,5125,1326
1372,1720,924,796,156,240,186,165,405,568,4,5887,1724
1373,1220,668,552,116,192,133,96,264,419,8,4406,1228
1374,2050,1418,632,202,341,190,178,424,715,0,5883,2050
1375,4969,3103,1866,444,920,495,542,1042,1526,0,14391,4969
1376,2834,1758,1076,292,407,259,289,587,1000,0,9195,2834
1377,301,170,131,37,49,28,30,64,93,10,1059,311
1378,898,377,521,112,114,116,100,178,278,99,3934,997
1379,277,125,152,35,32,35,29,61,85,17,1040,294
1380,266,120,146,34,31,33,28,58,82,0,999,266
1381,5236,3270,1966,468,969,522,571,1097,1609,0,15167,5236
1382,653,359,294,66,80,67,60,147,233,20,2432,673
1383,9025,5636,3389,807,1671,900,985,1892,2770,0,26140,9025
1384,592,327,265,54,74,55,62,139,208,0,2209,592
1385,11583,8641,2942,1234,1970,1011,1397,2384,3587,0,32126,11583
1386,615,324,291,92,75,80,74,119,175,0,2352,615
1387,5101,2299,2802,650,587,641,532,1121,1570,0,19140,5101
1388,626,331,295,87,68,69,81,129,192,10,2362,636
1389,819,369,450,82,116,99,94,159,269,109,3317,928
1390,482,254,228,72,59,63,58,94,136,0,1844,482
1391,263,118,145,26,37,32,30,51,87,0,1065,263
1392,1677,1037,640,219,196,207,179,297,579,35,5719,1712
1393,1512,935,577,197,176,187,161,268,523,122,5156,1634
1394,657,363,294,70,69,71,63,143,241,15,2241,672
1395,824,456,368,75,104,76,87,193,289,13,3077,837
1396,461,293,168,53,57,51,54,98,148,35,1613,496
1397,4922,3128,1794,568,607,546,572,1051,1578,0,17239,4922
1398,3720,2772,948,379,498,426,344,557,1516,175,12060,3895
1399,528,291,237,53,65,54,49,118,189,18,1963,546
1400,235,131,104,23,29,23,25,52,83,0,834,235
1401,5617,3180,2437,681,922,527,557,1186,1744,0,19772,5617
1402,425,238,187,41,52,42,45,94,151,12,1508,437
1403,1753,1095,658,157,324,175,191,367,539,60,5077,1813
1404,2227,1398,829,171,326,224,212,485,809,1,6884,2228
1405,917,519,398,111,151,86,91,194,284,8,3226,925
1406,815,518,297,94,101,90,95,174,261,7,2854,822
1407,2664,1652,1012,274,382,244,272,552,940,0,8641,2664
1408,1059,665,394,81,155,107,101,231,384,0,3274,1059
1409,231,166,65,27,34,21,25,49,75,0,641,231
1410,8442,6298,2144,899,1436,737,1018,1737,2615,0,23416,8442
1411,3327,2052,1275,333,452,352,323,767,1100,45,9866,3372
1412,1288,855,433,93,207,147,137,305,399,0,3912,1288
1413,2842,1718,1124,205,423,276,314,694,930,0,8766,2842
1414,3655,2520,1135,365,598,407,356,944,985,57,9710,3712
1415,1666,964,702,150,224,168,202,369,553,11,5301,1677
1416,2205,1517,688,181,309,216,246,518,735,31,6423,2236
1417,1135,595,540,112,172,93,143,280,335,0,3765,1135
1418,1803,1261,542,117,258,186,173,418,651,0,5269,1803
1419,1003,721,282,75,159,108,95,252,314,0,2935,1003
1420,1391,922,469,112,238,147,153,307,434,13,4199,1404
1421,5887,3618,2269,454,1104,655,545,1461,1668,38,18389,5925
1422,1647,994,653,139,217,178,165,393,555,43,5294,1690
1423,1082,448,634,100,155,107,134,262,324,1,4188,1083
1424,2036,1230,806,159,326,210,189,519,633,32,6220,2068
1425,1888,1046,842,155,288,173,181,463,628,11,5576,1899
1426,1671,1083,588,118,260,178,156,377,582,0,4771,1671
1427,520,329,191,42,86,59,57,112,164,23,1594,543
1428,1030,609,421,76,158,102,129,239,326,0,3201,1030
1429,462,248,214,37,62,46,42,116,159,11,1556,473
1430,4951,3099,1852,517,1168,597,509,1050,1110,42,15356,4993
1431,1329,797,532,134,188,120,157,329,401,0,4147,1329
1432,1755,1075,680,163,240,189,183,416,564,41,5452,1796
1433,6622,4617,2005,627,1077,782,804,1520,1812,88,17471,6710
1434,1397,690,707,152,178,114,164,322,467,20,5208,1417
1435,709,468,241,48,105,64,63,183,246,0,2195,709
1436,1863,1234,629,135,317,183,165,437,626,35,5263,1898
1437,844,539,305,62,137,90,74,197,284,18,2766,862
1438,5560,3886,1674,585,793,653,549,1202,1778,0,14874,5560
1439,1654,977,677,126,247,202,160,397,522,23,4905,1677
1440,934,526,408,87,129,95,103,214,306,0,3003,934
1441,1327,757,570,100,188,145,128,322,444,11,4282,1338
1442,1700,1105,595,137,291,161,182,380,549,25,4765,1725
1443,2153,1573,580,201,368,222,225,510,627,7,5536,2160
1444,1262,907,355,134,193,136,163,261,375,198,3345,1460
1445,1281,892,389,89,233,134,115,303,407,113,3743,1394
1446,2312,1565,747,160,381,254,234,528,755,38,6556,2350
1447,2392,1735,657,218,396,272,258,545,703,11,6008,2403
1448,1750,1156,594,132,315,174,158,427,544,0,5075,1750
1449,577,303,274,57,87,47,73,142,171,13,1913,590
1450,275,144,131,27,42,22,35,68,81,1,912,276
1451,453,238,215,45,69,37,57,112,133,0,1504,453
1452,319,211,108,21,47,29,29,82,111,10,989,329
1453,2224,920,1304,205,318,220,275,539,667,24,8609,2248
1454,18197,11390,6807,1902,4293,2195,1871,3858,4078,0,56442,18197
1455,651,459,192,55,97,72,60,164,203,17,1744,668
1456,2915,2054,861,247,434,324,271,734,905,0,7815,2915
1457,2589,1375,1214,218,365,200,331,616,859,41,8843,2630
1458,540,289,251,43,73,54,49,136,185,11,1818,551
1459,469,297,172,37,78,54,51,101,148,0,1436,469
1460,588,372,216,47,97,67,64,126,187,34,1801,622
1461,1112,657,455,85,166,136,108,267,350,25,3296,1137
1462,614,388,226,49,102,70,67,132,194,9,1880,623
1463,1515,1067,448,128,226,168,141,381,471,67,4062,1582
1464,509,252,257,56,65,41,60,117,170,11,1900,520
1465,636,420,216,43,94,58,57,164,220,0,1971,636
1466,496,305,191,39,84,46,45,129,153,22,1540,518
1467,844,519,325,67,143,78,76,219,261,25,2621,869
1468,253,155,98,20,43,23,23,66,78,30,787,283
1469,1415,960,455,148,197,131,198,318,423,13,4037,1428
1470,2207,1066,1141,215,305,247,272,538,630,147,7826,2354
1471,503,277,226,59,49,55,58,125,157,144,1596,647
1472,1491,922,569,125,219,148,186,346,467,11,4610,1502
1473,1230,893,337,113,161,117,151,296,392,0,3478,1230
1474,3194,1945,1249,258,452,253,428,742,1061,67,10139,3261
1475,240,147,93,22,31,25,29,62,71,10,811,250
1476,2829,1526,1303,243,407,287,352,671,869,0,9185,2829
1477,1301,617,684,139,202,128,120,343,369,430,4833,1731
1478,4884,2833,2051,521,596,526,592,1149,1500,40,15242,4924
1479,4201,2328,1873,536,583,476,465,1005,1136,0,13747,4201
1480,1582,993,589,150,247,165,193,347,480,0,4789,1582
1481,1685,1064,621,162,231,159,188,382,563,21,5502,1706
1482,1008,632,376,115,139,84,114,229,327,7,3192,1015
1483,463,347,116,42,37,43,58,101,182,55,1269,518
1484,1787,1033,754,188,239,157,205,407,591,0,5454,1787
1485,818,472,346,86,107,81,87,198,259,0,2610,818
1486,1485,859,626,156,198,131,170,338,492,48,4531,1533
1487,448,259,189,47,60,39,51,102,149,12,1367,460
1488,305,176,129,32,40,30,33,74,96,18,973,323
1489,1149,663,486,121,150,114,123,278,363,0,3664,1149
1490,994,574,420,105,130,99,106,240,314,51,3169,1045
1491,1439,908,531,138,198,136,161,326,480,179,4697,1618
1492,4091,2365,1726,430,546,360,469,931,1355,0,12485,4091
1493,246,90,156,30,33,26,25,64,68,167,999,413
1494,833,483,350,89,102,90,101,196,255,6,2598,839
1495,583,213,370,71,79,61,58,151,163,36,2366,619
1496,240,88,152,29,32,25,24,62,68,0,974,240
1497,860,314,546,105,116,91,86,223,239,34,3488,894
1498,2698,1495,1203,345,374,306,299,646,728,18,8828,2716
1499,1326,811,515,124,170,137,158,340,397,8,4485,1334
1500,1318,894,424,138,184,122,185,297,392,0,3763,1318
1501,411,237,174,43,54,41,44,99,130,51,1311,462
1502,4096,1496,2600,501,553,431,410,1061,1140,64,16618,4160
1503,973,610,363,111,134,81,110,221,316,13,3081,986
1504,1020,589,431,107,133,101,109,246,324,200,3253,1220
1505,593,281,312,64,92,58,55,156,168,137,2201,730
1506,1432,898,534,163,197,120,162,326,464,28,4537,1460
1507,383,140,243,47,52,40,38,99,107,20,1555,403
1508,1048,657,391,119,144,88,119,238,340,0,3321,1048
1509,758,599,159,90,107,76,75,161,249,105,1723,863
1510,1036,819,217,122,146,104,103,220,341,0,2352,1036
1511,502,397,105,59,71,51,50,106,165,0,1139,502
1512,3576,2624,952,396,554,342,359,815,1110,0,8186,3576
1513,121,93,28,13,19,10,14,24,41,0,301,121
1514,97,75,22,10,15,8,11,19,34,0,239,97
1515,115,89,26,12,18,10,14,23,38,0,285,115
1516,3,3,0,1,2,0,0,0,0,0,0,3
1517,12113,10320,1793,2511,1537,1095,1231,2649,3090,0,28469,12113
1518,50,21,29,5,8,6,6,9,16,1,191,51
1519,1877,1580,297,312,245,210,187,418,505,1,3729,1878
1520,13,11,2,1,1,1,1,3,6,4,32,17
1521,1799,1286,513,205,329,169,181,416,499,130,4240,1929
1522,524,461,63,41,58,46,39,134,206,6,1232,530
1523,2714,2090,624,328,388,263,258,637,840,13,6015,2727
1524,703,541,162,85,101,68,67,165,217,0,1558,703
1525,0,0,0,0,0,0,0,0,0,0,0,0
1526,778,599,179,94,111,75,74,183,241,0,1724,778
1527,2217,1593,624,263,330,204,240,470,710,0,6152,2217
1528,2061,1481,580,245,306,190,223,437,660,0,5719,2061
1529,2875,1628,1247,349,472,270,285,607,892,0,10122,2875
1530,3731,2839,892,982,667,402,405,541,734,1,8502,3732
1531,1512,1146,366,122,178,138,191,359,524,0,3214,1512
1532,1034,648,386,89,145,95,113,245,347,11,3008,1045
1533,110,65,45,9,14,8,12,27,40,0,338,110
1534,298,175,123,25,39,21,32,74,107,18,916,316
1535,1442,914,528,77,139,97,134,292,703,84,4111,1526
1536,1009,557,452,43,75,55,86,215,535,18,2987,1027
1537,5,3,2,0,0,0,1,1,3,0,14,5
1538,278,150,128,14,21,16,28,62,137,0,866,278
1539,845,456,389,43,65,48,86,187,416,0,2633,845
1540,1695,1061,634,87,122,108,149,377,852,0,4787,1695
1541,22759,15963,6796,1554,1957,1550,2189,4679,10830,0,64930,22759
1542,2700,1740,960,208,290,238,281,631,1052,15,7477,2715
1543,2757,1986,771,158,212,175,215,590,1407,0,7121,2757
1544,1130,691,439,55,94,83,102,269,527,18,3436,1148
1545,383,213,170,23,39,31,37,97,156,18,1127,401
1546,965,569,396,57,70,69,85,215,469,36,3027,1001
1547,1040,774,266,59,75,59,83,238,526,0,2770,1040
1548,374,248,126,21,30,25,27,82,189,15,1031,389
1549,1224,949,275,88,97,87,104,259,589,164,2756,1388
1550,2632,1676,956,150,183,176,261,535,1327,0,7569,2632
1551,0,0,0,0,0,0,0,0,0,0,0,0
1552,306,184,122,26,37,25,34,72,112,4,898,310
1553,1009,686,323,71,115,77,115,246,385,0,2707,1009
1554,290,208,82,18,19,17,27,60,149,0,780,290
1555,1120,742,378,89,123,92,115,255,446,17,3075,1137
1556,526,370,156,28,38,39,36,118,267,5,1426,531
1557,422,251,171,24,39,30,39,94,196,0,1275,422
1558,1077,641,436,62,100,77,100,240,498,0,3254,1077
1559,3021,1907,1114,163,227,208,290,687,1446,20,8023,3041
1560,361,203,158,20,25,24,32,78,182,13,1037,374
1561,1018,640,378,65,68,53,82,245,505,199,2952,1217
1562,1105,651,454,65,80,78,97,246,539,7,3464,1112
1563,116,65,51,7,8,8,10,25,58,0,332,116
1564,877,628,249,56,58,51,82,183,447,0,2358,877
1565,1111,766,345,49,90,69,99,261,543,16,2920,1127
1566,6945,4600,2345,554,765,569,713,1579,2765,0,19063,6945
1567,431,307,124,24,27,27,36,88,229,0,1136,431
1568,273,192,81,15,20,20,19,61,138,16,741,289
1569,647,431,216,38,47,42,56,143,321,42,1658,689
1570,818,513,305,71,115,75,89,194,274,26,2381,844
1571,802,489,313,69,100,68,92,190,283,0,2243,802
1572,722,498,224,32,59,45,65,169,352,15,1898,737
1573,1424,1105,319,102,113,101,120,302,686,0,3205,1424
1574,8020,7076,944,1055,1554,566,567,1459,2819,0,21286,8020
1575,452,321,131,25,29,28,38,92,240,195,1192,647
1576,1530,851,679,90,155,125,147,388,625,0,4500,1530
1577,31,18,13,2,3,2,3,7,14,0,95,31
1578,1502,894,608,86,140,107,139,334,696,0,4540,1502
1579,756,418,338,33,57,42,65,161,398,0,2239,756
1580,459,356,103,33,36,33,39,97,221,0,1033,459
1581,386,228,158,23,28,27,34,86,188,0,1209,386
1582,7804,4760,3044,673,978,664,897,1852,2740,0,21834,7804
1583,1068,577,491,54,82,61,108,237,526,0,3327,1068
1584,2620,2094,526,169,225,186,237,592,1211,0,6045,2620
1585,260,172,88,15,21,17,19,57,131,0,715,260
1586,12,11,1,2,2,1,1,2,4,0,31,12
1587,472,313,159,38,52,39,48,107,188,0,1296,472
1588,2065,1376,689,121,148,134,177,456,1029,0,5294,2065
1589,621,462,159,36,45,36,49,142,313,36,1653,657
1590,1309,1046,263,84,112,93,118,296,606,165,3020,1474
1591,2208,1948,260,291,428,156,156,402,775,0,5861,2208
1592,306,165,141,16,24,18,31,68,149,0,953,306
1593,900,563,337,46,65,57,79,200,453,85,2542,985
1594,285,178,107,15,21,18,25,63,143,0,806,285
1595,555,330,225,32,52,40,52,124,255,133,1678,688
1596,3143,1770,1373,177,217,212,275,683,1579,0,9023,3143
1597,197,111,86,11,14,13,17,43,99,0,564,197
1598,583,396,187,41,66,45,66,142,223,0,1564,583
1599,628,427,201,44,71,48,71,153,241,11,1686,639
1600,6069,3910,2159,467,652,534,631,1419,2366,0,16807,6069
1601,0,0,0,0,0,0,0,0,0,0,0,0
1602,289,170,119,17,21,21,25,64,141,0,907,289
1603,243,161,82,14,20,16,18,53,122,9,670,252
1604,899,529,370,76,118,63,96,224,322,20,2762,919
1605,391,275,116,21,28,29,27,88,198,0,1059,391
1606,1007,604,403,86,120,82,111,238,370,38,2954,1045
1607,1538,938,600,133,193,131,177,365,539,0,4303,1538
1608,510,363,147,28,32,32,42,104,272,0,1344,510
1609,529,352,177,31,38,34,45,117,264,95,1357,624
1610,4841,3034,1807,418,678,443,530,1147,1625,45,14089,4886
1611,1295,859,436,73,106,87,95,285,649,22,3565,1317
1612,4827,3386,1441,330,415,329,464,992,2297,0,13773,4827
1613,28,25,3,4,5,2,2,5,10,0,74,28
1614,0,0,0,0,0,0,0,0,0,0,0,0
1615,461,277,184,40,55,38,51,109,168,11,1351,472
1616,213,145,68,15,24,16,24,52,82,0,570,213
1617,3006,1745,1261,336,425,319,315,684,927,0,9022,3006
1618,662,360,302,62,101,57,91,122,229,83,2531,745
1619,464,317,147,48,62,46,54,109,145,0,1267,464
1620,939,615,324,92,140,94,112,209,292,17,2874,956
1621,748,361,387,66,105,73,84,166,254,7,2653,755
1622,498,267,231,49,69,45,61,109,165,15,1750,513
1623,2567,1793,774,363,395,239,293,542,735,0,6811,2567
1624,504,282,222,45,90,52,51,104,162,10,1654,514
1625,688,439,249,76,100,65,76,158,213,37,2073,725
1626,870,523,347,97,122,85,92,189,285,25,2691,895
1627,2086,1194,892,254,405,237,238,415,537,16,6792,2102
1628,1169,607,562,103,176,92,132,290,376,0,3966,1169
1629,2273,1469,804,237,378,211,272,512,663,8,6729,2281
1630,2474,1259,1215,229,256,176,259,489,1065,20,8865,2494
1631,125,81,44,17,19,12,14,28,35,0,356,125
1632,839,462,377,53,122,71,95,201,297,15,2707,854
1633,607,353,254,50,85,65,62,138,207,0,1936,607
1634,604,367,237,50,83,57,61,149,204,0,1978,604
1635,1969,1119,850,209,297,192,211,469,591,349,6505,2318
1636,1028,730,298,100,155,87,97,224,365,11,2830,1039
1637,1975,1221,754,177,334,216,235,443,570,27,6185,2002
1638,1328,727,601,101,202,135,144,307,439,98,4306,1426
1639,1533,716,817,116,231,136,170,364,516,106,5224,1639
1640,1133,639,494,94,162,110,131,252,384,0,3603,1133
1641,476,310,166,41,44,38,49,92,212,0,1433,476
1642,1779,846,933,155,188,122,187,343,784,45,6263,1824
1643,1975,988,987,161,205,172,204,386,847,64,6816,2039
1644,3713,2319,1394,369,476,316,429,749,1374,17,11201,3730
1645,3029,1649,1380,267,340,252,303,556,1311,77,10474,3106
1646,454,333,121,45,44,38,43,92,192,87,1220,541
1647,1410,966,444,134,188,151,149,327,461,99,3673,1509
1648,1625,1011,614,173,255,157,168,367,505,31,4969,1656
1649,1450,893,557,129,243,143,156,321,458,22,4488,1472
1650,1425,757,668,132,269,124,155,286,459,22,4766,1447
1651,1215,733,482,105,192,118,130,279,391,32,3936,1247
1652,319,128,191,20,41,25,33,62,138,0,1225,319
1653,251,136,115,24,38,22,35,46,86,28,960,279
1654,901,640,261,99,88,79,107,154,374,0,2327,901
1655,3359,2555,804,757,426,284,236,1041,615,1,8779,3360
1656,826,604,222,115,112,79,80,176,264,0,2144,826
1657,267,138,129,18,36,26,29,61,97,0,875,267
1658,431,279,152,60,64,41,48,96,122,0,1223,431
1659,1388,794,594,169,269,158,159,276,357,16,4519,1404
1660,614,321,293,60,70,44,59,115,266,0,2076,614
1661,726,338,388,56,127,71,83,155,234,11,2670,737
1662,971,700,271,117,157,99,100,205,293,10,2662,981
1663,394,206,188,39,45,28,38,74,170,7,1332,401
1664,310,207,103,31,47,28,33,71,100,0,909,310
1665,894,519,375,111,141,85,101,183,273,9,2631,903
1666,669,435,234,88,85,67,74,132,223,31,2011,700
1667,1827,1182,645,253,271,174,203,408,518,57,5188,1884
1668,2673,1730,943,371,397,255,297,597,756,141,7592,2814
1669,467,188,279,29,61,36,49,90,202,0,1795,467
1670,172,89,83,12,17,13,17,35,78,1,638,173
1671,457,235,222,33,46,34,46,92,206,39,1694,496
1672,502,258,244,36,50,38,50,101,227,44,1860,546
1673,6121,3690,2431,537,819,516,661,1210,2378,0,18780,6121
1674,6970,4202,2768,611,933,588,753,1377,2708,0,21386,6970
1675,312,162,150,22,42,31,34,71,112,0,1025,312
1676,478,277,201,60,75,45,54,98,146,11,1404,489
1677,786,411,375,77,90,56,75,147,341,18,2657,804
1678,820,560,260,85,110,82,95,193,255,49,2238,869
1679,398,206,192,28,53,39,43,91,144,6,1307,404
1680,1134,739,395,98,104,90,117,220,505,15,3416,1149
1681,636,341,295,63,88,58,78,139,210,7,2233,643
1682,920,614,306,92,141,83,98,210,296,30,2704,950
1683,848,436,412,61,85,64,85,171,382,0,3140,848
1684,7,4,3,1,1,1,1,2,1,60,21,67
1685,772,492,280,85,112,73,85,177,240,0,2327,772
1686,264,176,88,26,40,24,28,60,86,0,777,264
1687,7063,5101,1962,701,1156,748,833,1516,2109,0,17887,7063
1688,1514,1093,421,150,248,160,179,325,452,0,3835,1514
1689,2295,1657,638,228,376,243,271,493,684,0,5813,2295
1690,1219,880,339,121,200,129,144,262,363,0,3088,1219
1691,262,170,92,35,33,26,29,52,87,19,786,281
1692,225,101,124,18,34,18,26,43,86,0,805,225
1693,330,165,165,33,47,29,40,69,112,0,1203,330
1694,362,237,125,36,54,36,43,80,113,18,1108,380
1695,4877,3522,1355,484,798,516,575,1047,1457,0,12351,4877
1696,2424,1751,673,241,397,257,286,520,723,0,6140,2424
1697,926,558,368,81,124,78,100,183,360,0,2840,926
1698,880,531,349,77,118,74,95,174,342,30,2700,910
1699,300,92,208,27,44,23,36,67,103,23,1255,323
1700,828,578,250,117,127,77,95,175,237,4,2198,832
1701,795,463,332,66,112,85,82,181,269,0,2536,795
1702,556,359,197,62,86,56,59,121,172,136,1539,692
1703,1080,697,383,121,167,109,114,236,333,12,2991,1092
1704,609,393,216,68,94,61,64,133,189,0,1686,609
1705,396,290,106,55,53,38,38,84,128,0,1027,396
1706,531,323,208,44,73,50,54,131,179,0,1739,531
1707,1711,937,774,130,260,174,185,395,567,0,5546,1711
1708,468,234,234,46,67,41,57,97,160,7,1706,475
1709,313,203,110,41,40,31,35,62,104,17,940,330
1710,367,197,170,36,51,34,45,80,121,13,1287,380
1711,340,105,235,31,50,26,41,75,117,0,1421,340
1712,289,123,166,27,39,23,35,59,106,30,1119,319
1713,763,493,270,86,118,77,81,166,235,0,2115,763
1714,858,547,311,94,125,81,95,196,267,183,2585,1041
1715,668,431,237,75,104,67,71,146,205,8,1850,676
1716,1182,763,419,133,183,119,125,258,364,11,3275,1193
1717,478,305,173,52,70,45,53,109,149,0,1440,478
1718,540,296,244,41,82,55,58,125,179,0,1749,540
1719,673,438,235,58,62,53,70,131,299,7,2028,680
1720,311,148,163,27,33,21,33,60,137,0,1096,311
1721,393,187,206,34,41,27,41,76,174,11,1384,404
1722,373,209,164,33,67,38,38,77,120,0,1224,373
1723,268,196,72,27,26,22,26,54,113,4,719,272
1724,325,177,148,29,36,27,32,60,141,18,1125,343
1725,322,211,111,32,48,32,38,72,100,8,987,330
1726,354,207,147,40,50,33,40,78,113,0,1086,354
1727,1520,1111,409,212,205,146,147,324,486,481,3945,2001
1728,1012,691,321,105,136,101,117,238,315,1,2764,1013
1729,363,163,200,30,54,30,42,69,138,0,1302,363
1730,478,309,169,66,71,46,53,107,135,0,1359,478
1731,99,57,42,11,14,10,10,23,31,0,298,99
1732,462,259,203,41,83,48,47,95,148,0,1518,462
1733,446,250,196,39,80,46,45,92,144,0,1467,446
1734,464,282,182,38,64,44,47,115,156,0,1520,464
1735,668,283,385,64,89,54,82,137,242,19,2590,687
1736,758,366,392,67,107,74,85,169,256,7,2686,765
1737,389,253,136,51,49,39,43,77,130,0,1169,389
1738,330,102,228,30,48,25,39,73,115,13,1379,343
1739,318,98,220,29,47,24,38,71,109,0,1329,318
1740,736,430,306,82,104,69,84,162,235,27,2258,763
1741,214,125,89,24,30,20,24,47,69,19,658,233
1742,998,583,415,112,141,94,114,219,318,0,3062,998
1743,416,208,208,41,60,37,50,86,142,25,1515,441
1744,396,205,191,27,53,39,43,90,144,7,1299,403
1745,908,606,302,91,139,82,97,207,292,4,2666,912
1746,0,0,0,0,0,0,0,0,0,0,0,0
1747,577,335,242,64,82,61,61,131,178,0,1732,577
1748,704,362,342,51,71,53,70,142,317,0,2607,704
1749,795,479,316,70,106,67,86,157,309,22,2438,817
1750,404,244,160,35,54,34,44,80,157,14,1239,418
1751,145,105,40,14,24,15,17,31,44,7,367,152
1752,680,440,240,94,101,65,75,152,193,0,1932,680
1753,95,57,38,23,41,5,3,10,13,0,285,95
1754,4200,2530,1670,1009,1798,238,146,425,584,0,12597,4200
1755,925,557,368,222,396,52,32,94,129,0,2775,925
1756,1585,955,630,381,679,90,55,160,220,4,4755,1589
1757,476,289,187,39,66,45,48,118,160,0,1557,476
1758,1126,906,220,69,97,86,102,207,565,4,3070,1130
1759,777,595,182,53,62,59,64,171,368,0,2202,777
1760,372,239,133,22,31,31,35,68,185,3,1155,375
1761,1136,738,398,53,86,71,117,233,576,178,3333,1314
1762,2764,1894,870,115,235,224,245,521,1424,28,7888,2792
1763,2147,1490,657,109,166,156,175,415,1126,150,6013,2297
1764,683,510,173,21,52,46,49,166,349,0,1881,683
1765,880,526,354,68,73,76,75,163,425,0,2370,880
1766,1093,808,285,52,80,81,89,213,578,20,3043,1113
1767,1458,1053,405,79,140,122,130,284,703,10,4102,1468
1768,1306,764,542,111,128,112,115,254,586,503,4092,1809
1769,1402,867,535,59,145,128,127,246,697,27,4675,1429
1770,1253,832,421,62,103,94,89,278,627,38,3974,1291
1771,1447,978,469,66,135,130,114,285,717,6,4412,1453
1772,895,665,230,59,82,71,88,176,419,39,2302,934
1773,859,681,178,48,67,75,64,161,444,21,2262,880
1774,1237,777,460,122,176,120,149,210,460,13,3548,1250
1775,504,271,233,49,77,46,51,91,190,24,1775,528
1776,647,410,237,51,81,52,69,126,268,7,2169,654
1777,737,433,304,60,103,76,86,148,264,8,2725,745
1778,184,69,115,18,22,15,16,39,74,0,714,184
1779,747,526,221,66,66,69,73,130,343,31,2248,778
1780,1807,1017,790,142,276,174,168,324,723,14,6886,1821
1781,576,385,191,44,59,56,71,102,244,10,1846,586
1782,530,372,158,30,39,43,45,107,266,0,1500,530
1783,1259,899,360,91,135,91,127,254,561,10,3309,1269
1784,872,711,161,67,72,78,71,164,420,1,2142,873
1785,1294,1061,233,91,110,101,102,259,631,11,3396,1305
1786,1599,1238,361,130,150,143,138,299,739,0,3744,1599
1787,1804,1270,534,106,162,134,137,375,890,7,5730,1811
1788,950,693,257,55,69,76,79,191,480,14,3018,964
1789,864,614,250,50,80,65,71,167,431,0,2528,864
1790,659,423,236,37,69,44,68,124,317,11,1927,670
1791,2437,1596,841,175,308,230,238,469,1017,53,7141,2490
1792,1440,1306,134,82,106,128,140,278,706,1533,3771,2973
1793,327,207,120,22,28,27,26,70,154,0,862,327
1794,854,577,277,38,88,71,79,177,401,18,2693,872
1795,1301,943,358,62,111,97,80,286,665,7,4043,1308
1796,544,375,169,50,66,63,56,93,216,0,1475,544
1797,369,189,180,29,50,37,35,77,141,0,1260,369
1798,1358,968,390,118,166,132,158,246,538,33,3919,1391
1799,836,607,229,74,104,79,78,157,344,94,2374,930
1800,731,287,444,47,112,75,79,153,265,167,2872,898
1801,655,408,247,54,87,56,86,129,243,298,2212,953
1802,1366,769,597,87,166,122,145,259,587,52,4935,1418
1803,795,406,389,55,123,76,85,151,305,59,3362,854
1804,314,232,82,16,30,24,30,59,155,0,789,314
1805,614,331,283,48,58,53,56,109,290,14,1845,628
1806,357,281,76,28,31,26,34,68,170,79,832,436
1807,306,225,81,25,25,19,25,66,146,0,885,306
1808,227,185,42,19,19,17,21,45,106,0,527,227
1809,198,145,53,16,16,12,16,42,96,0,571,198
1810,485,382,103,37,44,38,43,91,232,0,1206,485
1811,534,366,168,55,68,51,59,104,197,9,1634,543
1812,320,205,115,18,33,22,33,60,154,0,934,320
1813,330,253,77,22,26,25,27,73,157,4,936,334
1814,587,478,109,48,49,45,54,116,275,12,1359,599
1815,707,498,209,41,63,52,54,147,350,0,2247,707
1816,636,492,144,52,60,57,55,119,293,8,1490,644
1817,326,274,52,20,30,29,29,68,150,0,714,326
1818,732,616,116,45,68,65,64,152,338,52,1602,784
1819,528,416,112,41,47,42,47,100,251,153,1313,681
1820,1015,746,269,84,82,63,84,218,484,0,2934,1015
1821,513,381,132,34,47,41,51,101,239,13,1318,526
1822,698,514,184,39,82,55,66,142,314,50,1725,748
1823,700,454,246,45,68,49,59,134,345,18,2289,718
1824,684,529,155,56,64,61,59,128,316,0,1602,684
1825,493,382,111,40,46,44,43,92,228,0,1155,493
1826,1268,982,286,103,119,114,109,237,586,0,2970,1268
1827,392,276,116,23,35,29,30,81,194,25,1246,417
1828,6610,4330,2280,476,836,623,645,1272,2758,0,19371,6610
1829,207,154,53,14,19,16,20,41,97,6,532,213
1830,1212,768,444,96,152,97,129,236,502,0,4064,1212
1831,384,243,141,30,48,31,41,75,159,0,1289,384
1832,639,464,175,56,80,61,59,120,263,124,1817,763
1833,143,93,50,9,14,10,12,27,71,0,466,143
1834,349,226,123,23,34,25,29,67,171,0,1141,349
1835,580,376,204,38,56,41,48,111,286,0,1896,580
1836,370,240,130,24,36,26,31,71,182,0,1210,370
1837,1057,833,224,81,95,83,93,199,506,49,2627,1106
1838,313,230,83,17,37,25,30,64,140,7,773,320
1839,332,227,105,34,43,31,37,64,123,9,1018,341
1840,495,372,123,30,41,41,43,91,249,38,1272,533
1841,362,229,133,25,31,30,29,77,170,180,953,542
1842,528,397,131,32,44,44,46,97,265,11,1357,539
1843,1112,863,249,72,95,94,87,234,530,0,2619,1112
1844,492,346,146,27,37,39,42,99,248,50,1392,542
1845,103,39,64,10,12,8,9,22,42,45,401,148
1846,371,139,232,36,45,31,32,79,148,0,1444,371
1847,1407,1026,381,126,135,138,154,278,576,75,4294,1482
1848,1342,979,363,120,129,132,147,265,549,32,4095,1374
1849,615,485,130,47,55,48,54,116,295,0,1528,615
1850,3307,2166,1141,238,418,312,323,636,1380,0,9693,3307
1851,274,179,95,20,35,26,27,53,113,20,802,294
1852,783,458,325,66,77,67,69,152,352,122,2453,905
1853,303,192,111,24,38,24,32,59,126,24,1017,327
1854,334,180,154,26,32,29,30,59,158,0,1003,334
1855,648,349,299,50,62,56,59,115,306,9,1948,657
1856,339,260,79,23,27,26,28,75,160,0,959,339
1857,845,711,134,52,78,75,74,176,390,109,1849,954
1858,154,98,56,12,19,12,16,30,65,0,517,154
1859,244,155,89,19,31,20,26,48,100,7,818,251
1860,375,140,235,36,45,31,32,80,151,0,1460,375
1861,454,266,188,39,45,39,40,88,203,0,1424,454
1862,635,332,303,57,55,47,47,123,306,95,1926,730
1863,2492,1817,675,223,239,244,273,492,1021,10,7603,2502
1864,309,151,158,20,32,25,29,67,136,0,1148,309
1865,556,272,284,35,57,45,53,120,246,6,2063,562
1866,242,91,151,23,29,20,21,52,97,0,940,242
1867,339,178,161,30,30,25,25,66,163,124,1030,463
1868,460,275,185,37,55,32,39,95,202,0,1501,460
1869,934,760,174,71,81,89,95,183,415,19,2115,953
1870,407,295,112,36,51,39,38,76,167,33,1156,440
1871,1307,953,354,117,125,128,143,258,536,19,3989,1326
1872,463,338,125,41,44,45,51,91,191,0,1414,463
1873,311,226,85,27,39,29,29,58,129,0,884,311
1874,451,270,181,36,53,32,38,93,199,32,1472,483
1875,1007,819,188,82,85,77,92,200,471,0,2332,1007
1876,1815,1477,338,148,153,140,166,360,848,132,4205,1947
1877,500,407,93,41,42,38,46,99,234,182,1158,682
1878,172,98,74,14,28,13,14,33,70,0,605,172
1879,207,120,87,14,26,18,23,41,85,0,727,207
1880,362,206,156,30,58,27,28,70,149,0,1279,362
1881,888,474,414,65,114,80,83,177,369,11,2887,899
1882,520,278,242,38,67,47,48,104,216,90,1692,610
1883,664,355,309,49,85,60,62,132,276,133,2159,797
1884,865,499,366,57,109,76,97,170,356,64,3044,929
1885,162,124,38,11,13,12,13,36,77,0,458,162
1886,199,128,71,12,17,17,19,36,98,107,617,306
1887,505,324,181,29,53,34,52,95,242,0,1476,505
1888,344,255,89,23,36,32,35,69,149,9,911,353
1889,345,249,96,19,33,29,31,67,166,0,970,345
1890,1032,801,231,67,89,88,81,218,489,0,2432,1032
1891,523,256,267,33,54,42,50,113,231,0,1940,523
1892,289,195,94,13,30,24,27,60,135,0,910,289
1893,633,324,309,49,85,64,60,132,243,14,2159,647
1894,178,114,64,10,15,15,17,33,88,2,552,180
1895,506,285,221,32,62,45,54,96,217,0,1830,506
1896,780,466,314,60,65,68,67,144,376,890,2102,1670
1897,720,533,187,37,69,54,69,136,355,301,1812,1021
1898,246,185,61,15,21,20,22,45,123,0,631,246
1899,224,168,56,14,19,18,20,41,112,0,574,224
1900,2237,1487,750,143,214,198,226,404,1052,0,6756,2237
1901,541,342,199,37,47,44,43,116,254,190,1424,731
1902,284,145,139,22,38,29,27,59,109,7,968,291
1903,1241,825,416,79,119,110,125,224,584,0,3749,1241
1904,404,218,186,31,38,35,37,72,191,4,1214,408
1905,373,293,80,29,32,27,36,71,178,79,871,452
1906,206,110,96,15,26,19,19,41,86,0,671,206
1907,717,495,222,67,88,84,74,122,282,0,1944,717
1908,471,349,122,31,50,44,48,95,203,21,1250,492
1909,644,478,166,43,59,51,64,127,300,12,1655,656
1910,165,81,84,11,17,13,16,36,72,0,614,165
1911,527,376,151,46,64,51,62,96,208,22,1520,549
1912,522,331,191,41,56,39,42,112,232,0,1672,522
1913,700,444,256,55,76,53,56,150,310,7,2244,707
1914,433,274,159,34,47,33,35,93,191,0,1389,433
1915,624,444,180,48,61,52,50,123,290,17,1873,641
1916,1129,803,326,87,111,94,91,223,523,0,3385,1129
1917,352,283,69,22,30,27,32,65,176,0,959,352
1918,759,540,219,44,70,58,62,146,379,0,2220,759
1919,904,711,193,71,79,66,86,171,431,92,2110,996
1920,1067,868,199,81,93,102,109,209,473,147,2414,1214
1921,1736,1412,324,131,151,166,177,340,771,41,3928,1777
1922,584,432,152,39,61,54,59,117,254,22,1549,606
1923,1149,764,385,73,110,102,116,207,541,0,3471,1149
1924,400,266,134,26,38,35,40,72,189,0,1207,400
1925,250,162,88,16,24,18,21,48,123,0,819,250
1926,72,51,21,6,7,6,6,14,33,0,215,72
1927,7945,5650,2295,611,779,662,643,1567,3683,0,23828,7945
1928,105,71,34,5,11,9,10,22,48,0,331,105
1929,434,321,113,22,42,33,42,82,213,0,1091,434
1930,223,188,35,14,21,20,20,46,102,0,488,223
1931,74,54,20,4,9,6,7,15,33,0,182,74
1932,156,115,41,9,18,12,15,32,70,0,386,156
1933,176,111,65,14,22,14,19,34,73,0,589,176
1934,0,0,0,0,0,0,0,0,0,0,0,0
1935,2560,1409,1151,220,299,223,221,439,1158,50,9157,2610
1936,537,508,29,62,57,49,59,103,207,0,859,537
1937,2063,1707,356,130,143,130,149,463,1048,0,4835,2063
1938,705,557,148,48,66,55,50,143,343,1,1709,706
1939,287,225,62,21,25,25,23,66,127,0,652,287
1940,1971,1583,388,132,153,149,168,390,979,34,4740,2005
1941,185,158,27,12,13,14,16,37,93,0,452,185
1942,835,715,120,52,57,61,71,166,428,11,2042,846
1943,641,532,109,32,46,50,55,137,321,0,1571,641
1944,2025,1698,327,128,125,156,164,443,1009,7,4814,2032
1945,1466,1197,269,78,102,95,116,302,773,0,3564,1466
1946,466,273,193,42,42,47,43,91,201,48,1385,514
1947,974,928,46,72,71,89,74,187,481,492,2281,1466
1948,2621,2124,497,169,198,195,221,527,1311,0,6204,2621
1949,248,169,79,24,18,24,21,50,111,14,610,262
1950,1029,819,210,70,76,74,98,210,501,0,2552,1029
1951,33,19,14,3,3,3,3,6,15,0,99,33
1952,1316,898,418,91,123,103,88,285,626,3,3700,1319
1953,790,638,152,63,77,72,76,150,352,0,1856,790
1954,2617,1491,1126,183,269,229,255,491,1190,0,7257,2617
1955,772,642,130,64,76,66,63,146,357,0,1673,772
1956,1504,1251,253,124,148,128,124,284,696,13,3259,1517
1957,572,455,117,42,54,46,55,103,272,0,1372,572
1958,2087,1595,492,121,187,159,179,393,1048,0,5618,2087
1959,1996,1374,622,120,146,169,161,372,1028,18,5325,2014
1960,74,46,28,7,7,7,6,18,29,0,208,74
1961,796,624,172,64,79,68,78,142,365,0,1864,796
1962,309,272,37,22,26,28,27,61,145,0,630,309
1963,230,171,59,17,24,17,20,50,102,0,578,230
1964,369,334,35,35,33,38,34,77,152,964,901,1333
1965,428,312,116,27,32,44,34,99,192,0,1072,428
1966,660,353,307,65,56,65,54,128,292,46,2339,706
1967,357,191,166,35,30,35,29,69,159,9,1266,366
1968,366,244,122,32,29,36,36,69,164,0,925,366
1969,500,392,108,40,49,42,49,89,231,0,1171,500
1970,608,429,179,87,62,61,73,110,215,0,1468,608
1971,201,97,104,17,20,22,17,38,87,0,727,201
1972,483,379,104,39,48,41,47,86,222,0,1130,483
1973,453,320,133,65,46,45,54,82,161,9,1094,462
1974,511,361,150,73,52,51,61,92,182,0,1235,511
1975,2123,2009,114,804,602,191,165,184,177,0,3236,2123
1976,389,233,156,149,104,34,28,39,35,0,1034,389
1977,277,170,107,109,68,23,23,27,27,7,720,284
1978,1079,1022,57,549,248,90,90,55,47,0,1949,1079
1979,0,0,0,0,0,0,0,0,0,119,0,119
1980,1045,666,379,195,279,120,114,142,195,21,2602,1066
1981,301,230,71,20,27,28,27,59,140,0,761,301
1982,3270,2488,782,861,584,352,355,474,644,0,7453,3270
1983,1358,1112,246,96,130,125,140,236,631,0,3266,1358
1984,394,302,92,26,36,37,36,77,182,0,993,394
1985,632,313,319,77,56,68,64,119,248,325,2202,957
1986,424,349,75,32,36,41,41,82,192,0,915,424
1987,448,356,92,33,42,36,43,80,214,0,1074,448
1988,404,271,133,36,35,37,35,86,175,0,1006,404
1989,505,221,284,50,41,60,38,94,222,0,2011,505
1990,616,330,286,60,52,60,50,120,274,49,2183,665
1991,612,368,244,51,54,57,49,120,281,13,1883,625
1992,301,132,169,30,25,36,23,56,131,0,1199,301
1993,471,270,201,48,44,44,41,88,206,14,1406,485
1994,1254,1187,67,145,133,114,137,241,484,186,2006,1440
1995,625,554,71,141,86,69,67,104,158,0,1119,625
1996,621,423,198,129,80,72,61,101,178,0,1624,621
1997,1256,764,492,433,325,119,103,147,129,0,3704,1256
1998,871,773,98,196,120,97,93,144,221,0,1559,871
1999,817,725,92,184,112,91,87,135,208,0,1461,817
2000,594,405,189,123,77,69,58,97,170,0,1553,594
2001,531,362,169,110,68,61,52,86,154,0,1390,531
2002,369,252,117,77,48,43,36,60,105,177,965,546
2003,231,158,73,16,22,18,16,50,109,0,650,231
2004,1897,1880,17,498,286,232,191,283,407,83,3445,1980
2005,970,961,9,255,146,119,98,145,207,683,1760,1653
2006,501,317,184,107,66,63,48,77,140,581,1188,1082
2007,481,412,69,52,57,47,45,89,191,0,942,481
2008,647,457,190,92,66,65,77,117,230,23,1562,670
2009,742,410,332,177,126,76,78,118,167,69,2034,811
2010,954,750,204,67,83,81,79,180,464,0,2419,954
2011,377,273,104,37,38,38,35,63,166,0,906,377
2012,616,445,171,60,61,63,57,102,273,15,1481,631
2013,441,260,181,43,44,41,41,81,191,28,1412,469
2014,388,227,161,35,35,39,36,76,167,0,1152,388
2015,239,144,95,20,21,22,19,47,110,0,737,239
2016,247,141,106,25,23,23,21,46,109,0,739,247
2017,407,198,209,57,44,40,44,73,149,11,1446,418
2018,545,265,280,76,59,53,59,98,200,8,1938,553
2019,242,96,146,20,25,19,20,45,113,20,939,262
2020,168,126,42,64,38,14,20,17,15,13,408,181
2021,546,348,198,102,146,63,60,74,101,0,1360,546
2022,287,236,51,27,29,25,26,52,128,0,628,287
2023,608,536,72,42,50,55,53,121,287,92,1241,700
2024,413,282,131,86,53,48,40,67,119,0,1080,413
2025,431,209,222,60,47,42,47,78,157,17,1533,448
2026,264,128,136,37,29,26,29,48,95,13,937,277
2027,703,409,294,75,65,71,65,121,306,0,2232,703
2028,440,256,184,47,41,45,41,76,190,104,1397,544
2029,305,190,115,31,27,27,31,57,132,12,843,317
2030,516,321,195,52,45,46,52,97,224,0,1429,516
2031,552,343,209,55,48,50,55,104,240,0,1528,552
2032,307,191,116,31,27,28,31,58,132,0,851,307
2033,443,276,167,44,39,40,44,84,192,47,1225,490
2034,417,259,158,42,36,38,42,79,180,0,1154,417
2035,345,260,85,24,34,27,27,75,158,0,923,345
2036,1332,1094,238,168,153,149,122,249,491,53,2672,1385
2037,473,405,68,51,56,46,44,88,188,0,927,473
2038,505,279,226,121,85,52,53,80,114,1,1385,506
2039,451,386,65,49,54,44,42,83,179,0,883,451
2040,997,926,71,141,113,112,92,193,346,0,1661,997
2041,988,812,176,124,114,110,90,184,366,157,1982,1145
2042,1149,559,590,145,120,113,96,214,461,0,3790,1149
2043,579,325,254,48,44,52,42,115,278,87,2124,666
2044,521,257,264,62,50,48,42,97,222,46,1892,567
2045,367,215,152,33,33,37,34,72,158,0,1090,367
2046,380,224,156,37,38,35,36,70,164,0,1214,380
2047,339,245,94,33,34,35,31,56,150,0,814,339
2048,429,236,193,49,36,46,32,82,184,0,1395,429
2049,428,208,220,54,45,42,36,80,171,0,1412,428
2050,284,158,126,28,27,29,24,54,122,115,909,399
2051,3142,1729,1413,270,367,273,271,539,1422,20,11241,3162
2052,2181,1102,1079,225,176,190,154,407,1029,862,6792,3043
2053,643,356,287,65,65,63,56,123,271,0,2216,643
2054,459,254,205,47,46,45,40,88,193,0,1579,459
2055,555,308,247,56,56,54,49,106,234,0,1909,555
2056,249,138,111,25,25,24,22,48,105,0,857,249
2057,272,151,121,28,27,27,24,52,114,0,936,272
2058,284,157,127,29,29,28,25,54,119,0,977,284
2059,179,71,108,15,19,14,15,33,83,7,698,186
2060,237,135,102,17,24,21,23,44,108,0,656,237
2061,470,286,184,158,93,54,41,64,60,1,1262,471
2062,347,211,136,117,69,40,31,47,43,0,932,347
2063,605,334,271,144,102,62,64,96,137,643,1659,1248
2064,252,121,131,22,25,27,21,48,109,0,912,252
2065,880,499,381,89,106,99,78,172,336,119,3161,999
2066,372,211,161,37,45,42,33,73,142,13,1336,385
2067,782,755,27,342,146,86,58,76,74,393,1178,1175
2068,690,440,250,129,184,79,75,94,129,9,1720,699
2069,645,433,212,57,55,60,56,138,279,0,1604,645
2070,330,195,135,32,33,31,31,61,142,0,1054,330
2071,596,319,277,59,50,59,48,116,264,0,2110,596
2072,359,197,162,37,39,33,34,66,150,4,1216,363
2073,417,230,187,51,37,39,42,73,175,0,1287,417
2074,298,165,133,36,26,28,30,52,126,0,920,298
2075,402,181,221,40,35,35,36,79,177,0,1589,402
2076,771,691,80,90,99,82,71,148,281,9,1436,780
2077,2342,1893,449,187,227,215,226,444,1043,39,5503,2381
2078,704,532,172,258,170,70,68,69,69,31,1604,735
2079,533,311,222,165,97,50,56,71,94,7,1476,540
2080,805,470,335,249,147,76,85,108,140,74,2228,879
2081,278,189,89,27,20,27,23,57,124,0,684,278
2082,607,274,333,60,54,53,55,119,266,2,2397,609
2083,984,444,540,97,87,86,88,193,433,8,3887,992
2084,684,272,412,57,72,55,56,126,318,0,2661,684
2085,237,114,123,20,24,25,20,45,103,0,858,237
2086,351,170,181,36,35,31,29,67,153,55,1145,406
2087,313,209,104,28,24,30,31,59,141,17,790,330
2088,636,524,112,55,67,51,55,96,312,448,1386,1084
2089,675,580,95,286,173,54,57,60,45,4,1260,679
2090,610,577,33,231,173,55,48,53,50,10,930,620
2091,1,1,0,0,0,0,0,0,1,108,2,109
2092,555,268,287,57,55,49,46,106,242,0,1809,555
2093,278,249,29,32,36,30,26,53,101,0,517,278
2094,269,118,151,27,22,32,20,50,118,0,1070,269
2095,484,302,182,49,48,47,40,115,185,0,1366,484
2096,281,154,127,29,30,26,27,52,117,0,952,281
2097,283,189,94,25,22,28,28,54,126,0,715,283
2098,1050,647,403,139,102,109,103,196,401,42,3132,1092
2099,217,164,53,15,22,17,17,47,99,0,579,217
2100,866,711,155,109,100,97,79,162,319,0,1738,866
2101,598,491,107,75,69,67,55,112,220,0,1200,598
2102,1571,1488,83,799,361,131,131,79,70,129,2839,1700
2103,860,787,73,120,109,89,77,156,309,7,1470,867
2104,399,262,137,39,37,37,44,77,165,0,1069,399
2105,314,173,141,36,27,34,23,60,134,0,1020,314
2106,1356,1344,12,356,205,166,136,202,291,46,2462,1402
2107,399,317,82,29,37,32,38,72,191,0,957,399
2108,630,516,114,45,60,58,65,110,292,0,1517,630
2109,629,500,129,46,59,50,60,113,301,0,1509,629
2110,309,177,132,32,29,29,27,58,134,0,923,309
2111,1028,604,424,277,275,120,99,126,131,0,2791,1028
2112,1069,629,440,288,286,124,103,131,137,17,2902,1086
2113,328,284,44,33,28,34,27,65,141,0,709,328
2114,361,301,60,25,24,26,27,73,186,0,873,361
2115,413,251,162,142,107,39,34,48,43,0,1217,413
2116,686,312,374,77,31,60,58,136,324,0,2033,686
2117,469,359,110,31,42,44,43,92,217,0,1184,469
2118,498,392,106,35,43,43,41,94,242,0,1264,498
2119,944,802,142,327,366,80,70,52,49,1,1852,945
2120,723,719,4,328,195,62,44,52,42,152,1298,875
2121,388,246,142,83,51,49,37,59,109,0,920,388
2122,433,274,159,92,57,55,41,66,122,0,1026,433
2123,413,345,68,29,28,30,31,83,212,0,998,413
2124,665,484,181,103,59,75,75,109,244,0,1549,665
2125,18,18,0,7,6,2,1,1,1,24,29,42
2126,136,133,3,60,47,10,8,7,4,53,235,189
2127,584,481,103,44,49,57,56,113,265,0,1261,584
2128,314,259,55,24,27,30,30,61,142,0,677,314
2129,982,781,201,66,92,71,86,186,481,0,2176,982
2130,702,578,124,61,74,56,61,106,344,0,1529,702
2131,519,427,92,45,54,42,45,79,254,0,1131,519
2132,1261,1019,242,101,122,116,122,239,561,0,2962,1261
2133,592,439,153,94,72,58,69,109,190,0,1454,592
2134,294,225,69,20,27,28,27,58,134,38,743,332
2135,864,710,154,82,88,74,80,155,385,85,1896,949
2136,285,224,61,23,28,24,28,51,131,0,668,285
2137,501,433,68,50,42,52,41,99,217,0,1082,501
2138,469,392,77,32,32,34,35,94,242,0,1134,469
2139,343,211,132,45,33,36,34,64,131,0,1023,343
2140,854,793,61,121,96,96,78,165,298,0,1421,854
2141,941,861,80,132,120,98,84,170,337,17,1609,958
2142,442,396,46,52,57,47,41,85,160,13,824,455
2143,617,546,71,99,83,62,72,98,203,0,1185,617
2144,378,280,98,60,46,37,44,70,121,21,928,399
2145,347,257,90,55,42,34,41,64,111,0,853,347
2146,276,148,128,34,27,27,29,47,112,0,893,276
2147,352,266,86,25,35,27,28,77,160,0,941,352
2148,290,213,77,25,31,23,34,47,130,0,752,290
2149,385,206,179,47,38,38,41,66,155,0,1246,385
2150,453,288,165,43,47,55,37,81,190,179,1302,632
2151,457,345,112,167,110,46,44,45,45,0,1040,457
2152,376,181,195,32,38,40,32,72,162,0,1361,376
2153,2456,2371,85,1075,459,270,181,238,233,44,3699,2500
2154,2787,2522,265,741,346,321,310,425,644,27,4757,2814
2155,566,459,107,59,42,50,53,110,252,3,1255,569
2156,515,404,111,38,45,46,41,119,226,56,1168,571
2157,321,252,69,23,28,28,26,74,142,0,728,321
2158,372,277,95,28,39,28,33,81,163,0,935,372
2159,252,198,54,18,22,22,20,58,112,0,573,252
2160,386,272,114,55,39,39,46,70,137,0,931,386
2161,423,299,124,60,43,42,51,76,151,0,1022,423
2162,1157,1047,110,308,144,133,129,176,267,19,1976,1176
2163,273,247,26,73,34,31,30,42,63,0,466,273
2164,319,289,30,85,40,37,35,49,73,0,544,319
2165,427,386,41,114,53,49,47,65,99,25,729,452
2166,1962,1762,200,375,267,205,208,344,563,228,3352,2190
2167,497,472,25,115,78,54,52,77,121,74,765,571
2168,833,790,43,194,130,90,88,130,201,0,1282,833
2169,524,497,27,122,82,57,55,82,126,0,807,524
2170,739,701,38,172,116,80,78,115,178,0,1138,739
2171,1054,998,56,122,112,96,116,202,406,0,1686,1054
2172,467,442,25,54,50,42,51,90,180,0,748,467
2173,782,458,324,82,86,73,66,154,321,3,2763,785
2174,342,190,152,33,33,35,29,65,147,0,1091,342
2175,243,162,81,21,19,24,24,46,109,8,614,251
2176,604,440,164,38,46,62,48,140,270,11,1515,615
2177,367,244,123,32,29,36,36,70,164,0,927,367
2178,715,561,154,52,62,63,57,165,316,0,1623,715
2179,435,255,180,39,39,44,40,85,188,0,1293,435
2180,670,579,91,67,56,70,55,132,290,3,1448,673
2181,386,207,179,47,38,38,41,66,156,0,1249,386
2182,665,597,68,127,90,70,71,116,191,0,1135,665
2183,229,123,106,28,22,22,24,39,94,0,741,229
2184,500,444,56,113,69,55,53,83,127,0,895,500
2185,416,202,214,58,45,41,45,75,152,0,1478,416
2186,623,309,314,76,56,67,63,117,244,0,2171,623
2187,280,151,129,32,23,24,33,51,117,12,945,292
2188,525,305,220,56,49,53,49,90,228,0,1666,525
2189,7676,4223,3453,659,897,668,662,1317,3473,0,27462,7676
2190,333,170,163,31,38,31,28,71,134,6,1261,339
2191,256,190,66,19,27,19,22,56,113,0,642,256
2192,348,265,83,27,31,27,29,72,162,39,844,387
2193,409,304,105,31,43,31,36,89,179,0,1026,409
2194,241,176,65,15,18,25,19,56,108,0,604,241
2195,444,338,106,34,39,34,37,92,208,0,1078,444
2196,259,197,62,20,23,20,21,54,121,6,628,265
2197,438,349,89,29,41,31,38,83,216,0,969,438
2198,271,245,26,25,24,28,25,57,112,0,662,271
2199,422,209,213,50,40,39,34,79,180,13,1531,435
2200,325,235,90,32,32,33,30,54,144,0,782,325
2201,2641,1546,1095,277,289,247,224,518,1086,3,9331,2644
2202,437,248,189,44,52,49,39,86,167,57,1569,494
2203,267,132,135,32,26,24,22,50,113,13,969,280
2204,487,287,200,47,49,45,46,90,210,0,1556,487
2205,558,271,287,71,58,55,47,104,223,0,1838,558
2206,580,319,261,67,49,62,43,110,249,0,1886,580
2207,597,400,197,53,51,55,52,127,259,0,1485,597
2208,2957,2396,561,190,224,220,249,595,1479,0,7001,2957
2209,2533,1410,1123,246,243,256,216,485,1087,0,8093,2533
2210,381,229,152,145,102,33,28,38,35,4,1015,385
2211,347,168,179,35,34,31,29,66,152,0,1130,347
2212,229,126,103,24,25,21,22,42,95,0,776,229
2213,416,373,43,49,53,44,38,80,152,0,776,416
2214,226,124,102,23,24,21,22,42,94,0,767,226
2215,340,164,176,35,34,30,28,65,148,0,1107,340
2216,3593,3052,541,1245,1392,303,267,196,190,65,7045,3658
2217,535,298,237,52,51,54,46,102,230,0,1709,535
2218,397,219,178,49,35,38,40,70,165,0,1227,397
2219,324,178,146,33,35,30,31,60,135,0,1096,324
2220,275,166,109,23,24,25,22,54,127,0,847,275
2221,360,192,168,34,34,39,31,73,149,170,1240,530
2222,380,224,156,37,38,35,36,70,164,0,1214,380
2223,458,270,188,45,46,43,43,84,197,0,1464,458
2224,429,380,49,69,58,43,50,68,141,17,824,446
2225,490,434,56,79,66,49,57,78,161,0,942,490
2226,1315,1283,32,545,302,103,96,146,123,0,1944,1315
2227,571,376,195,55,54,53,64,110,235,13,1531,584
2228,667,590,77,107,90,67,78,106,219,0,1281,667
2229,286,216,70,20,28,22,22,62,132,0,765,286
2230,419,343,76,30,40,38,43,73,195,0,1008,419
2231,329,224,105,23,31,26,22,71,156,0,925,329
2232,768,409,359,73,72,82,67,157,317,8,2642,776
2233,443,405,38,62,56,46,40,80,159,25,757,468
2234,258,123,135,31,27,27,28,47,98,0,919,258
2235,692,425,267,273,170,59,59,68,63,0,1802,692
2236,720,615,105,59,61,63,65,152,320,0,1585,720
2237,488,248,240,46,55,45,41,103,198,0,1847,488
2238,233,176,57,16,23,18,18,51,107,0,621,233
2239,527,450,77,43,44,46,47,111,236,0,1160,527
2240,271,130,141,23,27,29,23,52,117,15,980,286
2241,475,419,56,33,39,43,41,95,224,92,970,567
2242,386,318,68,29,33,37,37,75,175,0,833,386
2243,440,363,77,33,37,43,42,85,200,111,950,551
2244,531,362,169,51,38,52,45,108,237,179,1308,710
2245,280,204,76,43,25,31,32,46,103,0,653,280
2246,483,340,143,60,40,48,49,90,196,0,1229,483
2247,269,199,70,43,33,26,32,50,85,0,661,269
2248,2933,1806,1127,389,284,304,289,547,1120,10,8747,2943
2249,446,324,122,69,39,50,50,73,165,0,1040,446
2250,458,323,135,57,38,46,47,85,185,21,1166,479
2251,375,264,111,47,31,37,38,70,152,0,955,375
2252,615,525,90,51,52,54,55,129,274,0,1355,615
2253,694,593,101,57,58,61,62,146,310,0,1527,694
2254,498,366,132,42,54,40,59,81,222,440,1291,938
2255,398,190,208,47,41,42,43,72,153,0,1418,398
2256,373,232,141,38,37,36,31,89,142,0,1053,373
2257,634,395,239,64,62,62,52,151,243,0,1788,634
2258,1691,1041,650,224,164,176,167,315,645,6,5044,1697
2259,541,438,103,57,41,48,51,105,239,0,1199,541
2260,492,235,257,58,51,52,53,89,189,0,1750,492
2261,380,182,198,45,40,40,41,69,145,0,1350,380
2262,304,151,153,37,27,33,31,57,119,0,1061,304
2263,336,181,155,38,28,28,39,61,142,52,1133,388
2264,399,215,184,45,33,34,47,73,167,0,1347,399
2265,417,265,152,40,43,51,34,74,175,0,1197,417
2266,318,172,146,36,26,27,37,58,134,0,1074,318
2267,240,140,100,26,22,24,22,41,105,0,763,240
2268,467,297,170,45,48,57,38,83,196,0,1343,467
2269,438,256,182,39,40,44,41,85,189,25,1302,463
2270,469,298,171,45,48,57,38,84,197,0,1348,469
2271,317,202,115,30,33,39,26,57,132,33,912,350
2272,1682,818,864,213,175,165,141,313,675,0,5545,1682
2273,394,223,171,40,47,44,35,77,151,0,1416,394
2274,103,88,15,6,7,8,9,20,53,212,252,315
2275,87,74,13,5,6,6,7,17,46,0,212,87
2276,997,991,6,453,269,85,61,71,58,60,1792,1057
2277,1112,1085,27,461,256,87,81,123,104,113,1643,1225
2278,283,268,15,107,80,25,22,25,24,33,431,316
2279,562,323,239,214,120,65,50,56,57,49,1442,611
2280,893,513,380,341,191,103,80,89,89,7,2289,900
2281,51,39,12,4,5,4,4,11,23,10,123,61
2282,338,208,130,45,33,35,33,63,129,4,1009,342
2283,803,719,84,56,52,56,61,149,429,0,1802,803
2284,747,712,35,56,47,48,96,163,337,0,1776,747
2285,959,917,42,87,44,69,109,195,455,0,2346,959
2286,589,564,25,47,33,43,57,117,292,0,1423,589
2287,1309,1259,50,114,81,72,126,272,644,31,3061,1340
2288,793,768,25,65,50,57,86,143,392,0,1782,793
2289,419,390,29,54,38,39,62,67,159,0,964,419
2290,599,575,24,66,52,50,62,104,265,50,1204,649
2291,11,8,3,2,0,1,1,0,7,1653,32,1664
2292,210,199,11,22,22,20,25,32,89,1560,394,1770
2293,571,528,43,74,55,57,75,87,223,1539,1295,2110
2294,270,250,20,35,26,27,36,41,105,895,612,1165
2295,2811,2779,32,349,244,228,441,392,1157,184,5504,2995
2296,280,217,63,36,15,24,38,54,113,8,637,288
2297,1418,1365,53,146,92,118,177,247,638,28,3264,1446
2298,553,511,42,59,51,50,83,85,225,0,1211,553
2299,699,691,8,87,61,57,110,98,286,3,1368,702
2300,11,10,1,2,1,1,1,2,4,0,20,11
2301,329,295,34,52,36,35,36,60,110,0,580,329
2302,1024,917,107,162,112,110,112,186,342,0,1809,1024
2303,4061,3637,424,642,443,435,445,737,1359,0,7174,4061
2304,588,555,33,61,31,41,75,94,286,0,1456,588
2305,312,290,22,40,28,29,46,50,119,0,717,312
2306,564,539,25,67,44,55,67,95,236,0,1165,564
2307,378,355,23,40,35,33,49,55,166,0,779,378
2308,373,347,26,48,33,34,55,60,143,10,856,383
2309,524,489,35,76,55,45,84,72,192,0,1258,524
2310,427,406,21,49,36,38,53,66,185,12,924,439
2311,598,557,41,77,54,55,88,96,228,132,1374,730
2312,322,282,40,39,22,32,33,59,137,0,696,322
2313,295,258,37,36,20,30,30,54,125,0,638,295
2314,1362,1220,142,215,149,146,149,247,456,0,2406,1362
2315,722,647,75,114,79,77,79,131,242,0,1276,722
2316,1050,940,110,166,115,112,115,191,351,3,1855,1053
2317,1311,1174,137,207,143,140,144,238,439,0,2316,1311
2318,953,928,25,132,76,79,146,142,378,1,2125,954
2319,503,439,64,49,40,43,43,102,226,0,1009,503
2320,169,145,24,14,16,16,17,34,72,0,379,169
2321,861,752,109,84,68,74,73,174,388,14,1728,875
2322,954,836,118,115,64,96,97,174,408,177,2060,1131
2323,445,427,18,50,34,50,49,67,195,62,898,507
2324,359,344,15,40,27,40,39,54,159,0,725,359
2325,403,386,17,39,24,32,50,71,187,0,950,403
2326,487,413,74,57,36,42,53,86,213,46,1010,533
2327,637,490,147,93,52,58,70,117,247,3,1446,640
2328,2474,2216,258,391,270,265,271,449,828,99,4371,2573
2329,286,217,69,38,25,30,31,48,114,0,662,286
2330,497,377,120,66,43,53,54,84,197,215,1150,712
2331,459,429,30,43,33,39,65,71,208,0,1113,459
2332,550,418,132,83,45,57,64,97,204,190,1214,740
2333,380,288,92,50,33,40,41,64,152,19,879,399
2334,420,394,26,41,23,23,56,90,187,5,1077,425
2335,637,483,154,85,55,68,69,107,253,0,1474,637
2336,432,334,98,56,24,37,59,83,173,0,986,432
2337,749,717,32,86,54,67,95,123,324,14,1639,763
2338,865,842,23,119,69,72,132,129,344,116,1929,981
2339,1273,966,307,193,105,133,148,225,469,0,2810,1273
2340,481,438,43,56,37,47,60,77,204,119,1215,600
2341,1249,1155,94,133,114,113,186,193,510,0,2734,1249
2342,457,447,10,48,33,41,60,84,191,832,989,1289
2343,814,796,18,95,65,72,96,133,353,0,1560,814
2344,735,719,16,86,59,65,87,120,318,0,1408,735
2345,0,0,0,0,0,0,0,0,0,4,0,4
2346,532,451,81,62,40,46,58,94,232,0,1104,532
2347,788,767,21,109,63,65,121,117,313,5,1756,793
2348,292,283,9,24,19,21,32,53,143,11,655,303
2349,595,569,26,68,43,53,75,98,258,57,1303,652
2350,426,417,9,45,31,38,56,78,178,46,924,472
2351,740,627,113,87,55,64,80,131,323,0,1534,740
2352,360,310,50,30,34,34,37,72,153,98,806,458
2353,631,604,27,61,38,50,78,112,292,0,1486,631
2354,874,864,10,111,72,81,105,157,348,5184,1652,6058
2355,1153,1089,64,145,94,104,139,216,455,0,2607,1153
2356,231,206,25,32,25,20,32,31,91,0,584,231
2357,489,465,24,46,30,33,48,103,229,0,1131,489
2358,340,319,21,33,18,19,45,73,152,0,871,340
2359,341,305,36,47,36,30,47,46,135,60,863,401
2360,282,270,12,30,21,19,35,46,131,0,675,282
2361,354,334,20,45,18,18,41,65,167,0,944,354
2362,466,443,23,45,31,37,56,90,207,5,1004,471
2363,494,470,24,48,33,39,59,96,219,0,1065,494
2364,392,375,17,41,29,26,48,64,184,0,936,392
2365,439,414,25,46,23,31,56,70,213,0,1088,439
2366,526,493,33,52,29,29,70,112,234,6,1350,532
2367,339,324,15,31,15,25,39,69,160,0,829,339
2368,550,527,23,58,40,37,67,89,259,7,1315,557
2369,585,557,28,55,36,39,58,124,273,0,1352,585
2370,500,480,20,56,44,42,52,87,219,1,1005,501
2371,267,249,18,28,20,23,33,47,116,0,607,267
2372,408,387,21,45,38,35,47,71,172,0,837,408
2373,512,486,26,55,53,49,61,77,217,30,960,542
2374,602,571,31,67,57,52,69,105,252,3,1233,605
2375,1367,1337,30,160,109,121,161,223,593,8,2619,1375
2376,219,208,11,21,14,17,26,42,99,0,473,219
2377,596,571,25,74,46,48,77,93,258,0,1208,596
2378,1042,978,64,110,96,91,135,153,457,35,2148,1077
2379,290,272,18,31,27,25,38,43,126,207,598,497
2380,374,351,23,39,35,33,48,55,164,0,772,374
2381,275,254,21,36,26,27,36,42,108,295,624,570
2382,548,517,31,69,45,49,66,103,216,0,1240,548
2383,538,489,49,62,42,53,67,86,228,0,1361,538
2384,346,332,14,38,30,29,36,60,153,16,695,362
2385,777,742,35,92,61,76,93,131,324,21,1605,798
2386,337,321,16,33,22,27,40,65,150,0,727,337
2387,189,181,8,18,11,15,23,34,88,0,446,189
2388,564,540,24,70,43,45,73,88,245,83,1142,647
2389,1799,1709,90,205,153,159,223,280,779,153,3896,1952
2390,351,266,85,53,29,37,41,62,129,26,776,377
2391,320,286,34,44,34,28,44,43,127,0,808,320
2392,249,241,8,28,25,25,27,43,101,37,490,286
2393,216,209,7,24,21,22,24,37,88,89,425,305
2394,592,456,136,87,48,53,65,109,230,0,1342,592
2395,823,786,37,97,65,81,98,139,343,174,1700,997
2396,279,260,19,30,21,24,34,49,121,0,636,279
2397,524,497,27,58,49,45,60,91,221,0,1073,524
2398,607,594,13,63,44,54,79,112,255,0,1314,607
2399,500,494,6,63,41,47,60,90,199,1816,944,2316
2400,286,270,16,37,15,15,33,52,134,0,763,286
2401,763,754,9,97,63,71,92,137,303,613,1442,1376
2402,811,770,41,87,85,78,97,122,342,820,1522,1631
2403,1684,1614,70,208,129,134,218,263,732,9,3413,1693
2404,602,582,20,67,60,60,66,105,244,2,1185,604
2405,640,598,42,93,68,55,102,87,235,0,1538,640
2406,389,347,42,53,41,34,54,53,154,127,982,516
2407,1811,1744,67,186,117,150,226,315,817,0,4169,1811
2408,303,293,10,25,19,22,33,55,149,0,680,303
2409,411,391,20,39,25,28,40,87,192,0,949,411
2410,440,416,24,56,22,22,51,81,208,0,1174,440
2411,970,934,36,100,63,80,121,169,437,1,2233,971
2412,816,762,54,77,59,69,116,127,368,0,1976,816
2413,11,10,1,1,1,1,2,2,4,0,25,11
2414,441,395,46,31,29,31,34,82,234,3,991,444
2415,0,0,0,0,0,0,0,0,0,0,0,0
2416,174,162,12,18,13,15,21,31,76,0,395,174
2417,187,174,13,20,14,16,23,33,81,0,426,187
2418,214,204,10,21,14,17,25,41,96,6,461,220
2419,912,843,69,97,83,83,136,141,372,0,1996,912
2420,614,568,46,65,56,56,92,95,250,0,1344,614
2421,0,0,0,0,0,0,0,0,0,10,0,10
2422,770,690,80,122,84,82,84,140,258,0,1360,770
2423,453,448,5,56,39,37,71,63,187,0,887,453
2424,361,357,4,45,31,29,57,50,149,3,707,364
2425,478,473,5,59,41,39,75,67,197,210,935,688
2426,294,291,3,37,24,27,35,53,118,0,556,294
2427,216,209,7,24,21,22,24,37,88,179,426,395
2428,247,239,8,28,25,25,27,43,99,0,486,247
2429,98,95,3,11,10,10,11,17,39,0,193,98
2430,102,99,3,11,10,10,11,18,42,0,201,102
2431,157,152,5,18,16,16,17,27,63,0,309,157
2432,409,381,28,53,37,38,60,65,156,29,940,438
2433,88,79,9,12,9,8,12,12,35,0,224,88
2434,379,360,19,43,32,34,47,59,164,0,822,379
2435,179,170,9,20,15,16,22,28,78,0,389,179
2436,91,81,10,12,10,8,13,12,36,18,229,109
2437,97,74,23,13,8,10,11,16,39,0,224,97
2438,113,86,27,15,10,12,12,19,45,0,262,113
2439,110,83,27,15,10,12,12,19,42,0,255,110
2440,124,94,30,16,11,13,13,21,50,0,286,124
2441,292,251,41,24,27,27,30,59,125,0,653,292
2442,257,224,33,25,20,22,22,52,116,0,516,257
2443,742,648,94,72,59,64,63,150,334,0,1488,742
2444,213,186,27,21,17,18,18,43,96,41,427,254
2445,776,392,384,80,63,68,55,145,365,0,2418,776
2446,0,0,0,0,0,0,0,0,0,0,0,0
2447,0,0,0,0,0,0,0,0,0,0,0,0
2448,177,81,96,20,8,16,15,35,83,0,525,177
2449,0,0,0,0,0,0,0,0,0,0,0,0
2450,1334,1078,256,107,130,122,129,253,593,0,3136,1334
2451,652,527,125,52,63,60,63,124,290,0,1533,652
2452,2660,2150,510,213,258,244,257,504,1184,0,6252,2660
2453,26,26,0,10,8,3,2,1,2,0,43,26
2454,7,7,0,3,2,1,0,0,1,0,12,7
2455,1296,1270,26,570,446,93,73,68,46,6,2238,1302
2456,194,148,46,51,35,21,21,28,38,0,442,194
2457,1202,914,288,316,215,129,130,174,238,6,2740,1208
2458,50,49,1,22,17,4,3,3,1,3,86,53
2459,817,622,195,215,146,88,89,119,160,0,1863,817
2460,188,184,4,83,65,13,11,10,6,0,325,188
2461,116,114,2,51,40,8,6,6,5,4,200,120
2462,61,56,5,6,6,6,9,9,25,415,133,476
2463,302,279,23,32,28,27,45,47,123,0,661,302
2464,542,501,41,58,50,49,81,84,220,1,1186,543
2465,0,0,0,0,0,0,0,0,0,49,0,49
2466,490,382,108,38,41,37,42,99,233,0,1245,490
2467,1224,751,473,93,107,121,120,234,549,0,4015,1224
2468,711,378,333,77,77,82,70,122,283,0,2264,711
2469,948,802,146,66,67,67,91,193,464,0,2150,948
2470,1247,835,412,87,119,101,117,265,558,0,3495,1247
2471,1537,948,589,118,156,134,145,303,681,9,4291,1546
2472,2844,1917,927,202,319,235,273,586,1229,14,7968,2858
2473,1763,1194,569,142,187,170,158,378,728,25,5020,1788
2474,1547,1288,259,119,156,130,198,344,600,0,3277,1547
2475,2316,1621,695,126,216,150,197,422,1205,59,6338,2375
2476,1461,1038,423,108,129,97,117,308,702,32,3862,1493
2477,2037,1417,620,160,213,172,172,423,897,9,5482,2046
2478,3230,2345,885,181,243,271,316,627,1592,64,9088,3294
2479,2064,1485,579,120,173,152,173,418,1028,85,5394,2149
2480,1078,858,220,71,75,87,94,214,537,0,2570,1078
2481,519,301,218,41,57,44,64,109,204,10,1721,529
2482,667,489,178,61,64,63,65,122,292,338,1719,1005
2483,1125,829,296,66,104,89,126,221,519,3,2907,1128
2484,1354,951,403,105,139,122,126,256,606,6,3847,1360
2485,2517,2304,213,198,169,213,236,532,1169,4,4845,2521
2486,2540,1952,588,269,242,258,272,459,1040,0,5587,2540
2487,314,274,40,19,26,23,27,65,154,0,761,314
2488,342,289,53,22,35,25,31,72,157,0,811,342
2489,485,282,203,32,45,43,57,111,197,0,1557,485
2490,603,321,282,65,66,69,59,104,240,244,1922,847
2491,602,327,275,60,57,64,60,113,248,90,2057,692
2492,3341,2253,1088,238,375,276,321,689,1442,0,9360,3341
2493,810,546,264,58,91,67,78,167,349,0,2268,810
2494,524,304,220,34,48,46,62,120,214,0,1681,524
2495,912,596,316,59,92,79,90,186,406,0,2655,912
2496,584,382,202,38,59,51,57,119,260,0,1701,584
2497,324,174,150,27,23,28,32,61,153,0,1151,324
2498,406,218,188,33,29,35,40,76,193,8,1444,414
2499,290,156,134,24,21,25,28,55,137,0,1031,290
2500,774,383,391,64,69,63,73,154,351,0,2762,774
2501,325,218,107,28,29,32,32,57,147,6,894,331
2502,931,623,308,81,84,91,91,164,420,0,2559,931
2503,723,613,110,63,65,68,65,149,313,0,1633,723
2504,885,751,134,77,80,83,79,182,384,10,1999,895
2505,418,351,67,26,41,30,37,85,199,0,1013,418
2506,427,359,68,27,42,31,38,87,202,0,1035,427
2507,288,167,121,22,32,25,35,60,114,10,953,298
2508,1862,1255,607,132,209,154,179,384,804,0,5217,1862
2509,402,169,233,32,38,42,35,76,179,158,1471,560
2510,319,275,44,21,30,24,23,64,157,0,773,319
2511,4709,3175,1534,335,528,388,452,971,2035,0,13196,4709
2512,317,276,41,27,33,26,30,52,149,0,704,317
2513,297,249,48,18,29,21,26,60,143,6,719,303
2514,450,378,72,28,44,32,40,92,214,0,1089,450
2515,716,625,91,42,58,51,61,147,357,0,1737,716
2516,507,422,85,36,50,45,39,93,244,0,1182,507
2517,306,262,44,21,27,23,33,54,148,0,716,306
2518,614,517,97,40,56,43,66,115,294,0,1387,614
2519,875,672,203,93,83,89,94,158,358,3,1925,878
2520,1507,1048,459,118,157,127,127,313,665,13,4056,1520
2521,1282,939,343,118,124,121,125,234,560,146,3305,1428
2522,1263,1156,107,99,85,107,118,267,587,2,2432,1265
2523,467,242,225,55,46,50,45,82,189,0,1565,467
2524,392,335,57,27,34,30,42,69,190,0,920,392
2525,1949,1622,327,137,192,175,151,359,935,0,4544,1949
2526,559,465,94,39,55,50,43,103,269,6,1303,565
2527,205,171,34,14,20,18,16,38,99,0,479,205
2528,373,315,58,28,32,26,37,71,179,7,832,380
2529,282,238,44,21,24,19,28,54,136,11,631,293
2530,629,531,98,47,53,43,62,120,304,0,1405,629
2531,485,408,77,32,45,34,52,91,231,15,1094,500
2532,497,364,133,46,48,47,48,91,217,0,1282,497
2533,922,617,305,64,88,74,86,196,414,0,2586,922
2534,4940,3846,1094,502,558,495,510,887,1988,0,12856,4940
2535,676,499,177,56,54,64,71,124,307,0,1813,676
2536,922,718,204,94,104,92,95,166,371,0,2400,922
2537,5463,4253,1210,556,617,548,564,981,2197,0,14216,5463
2538,335,219,116,22,34,29,33,68,149,0,975,335
2539,992,649,343,64,100,86,97,202,443,0,2887,992
2540,337,196,141,22,31,30,40,77,137,17,1081,354
2541,665,561,104,44,68,50,59,139,305,0,1576,665
2542,1480,921,559,110,158,134,163,280,635,18,4554,1498
2543,3909,3044,865,398,442,392,403,702,1572,0,10173,3909
2544,309,228,81,26,25,29,32,57,140,9,831,318
2545,370,273,97,31,30,35,39,68,167,29,993,399
2546,561,230,331,61,53,57,51,109,230,0,2237,561
2547,189,78,111,20,18,19,17,37,78,0,754,189
2548,395,162,233,43,37,40,36,77,162,56,1573,451
2549,447,184,263,48,42,45,41,87,184,0,1781,447
2550,316,222,94,24,32,29,30,60,141,0,897,316
2551,240,147,93,18,21,24,24,46,107,4,789,244
2552,349,214,135,27,30,34,34,67,157,0,1145,349
2553,271,166,105,21,24,27,27,52,120,28,888,299
2554,392,197,195,44,43,33,37,85,150,0,1550,392
2555,284,143,141,32,31,24,27,61,109,0,1125,284
2556,472,237,235,53,52,39,44,102,182,0,1866,472
2557,460,340,120,47,45,42,46,78,202,0,1212,460
2558,298,220,78,30,29,27,30,51,131,0,785,298
2559,456,337,119,46,45,42,46,78,199,7,1200,463
2560,375,277,98,38,37,34,38,64,164,21,987,396
2561,596,230,366,64,69,63,55,112,233,0,2370,596
2562,1249,482,767,135,145,132,115,234,488,15,4969,1264
2563,2976,1148,1828,321,346,314,273,557,1165,0,11844,2976
2564,273,142,131,32,27,29,26,48,111,0,915,273
2565,446,231,215,53,44,48,43,78,180,0,1494,446
2566,759,394,365,90,74,82,73,133,307,10,2546,769
2567,1044,556,488,113,114,120,103,179,415,0,3327,1044
2568,520,277,243,56,57,60,51,89,207,0,1658,520
2569,400,213,187,43,44,46,39,69,159,8,1275,408
2570,410,223,187,41,39,43,41,77,169,0,1403,410
2571,426,232,194,43,40,45,43,80,175,39,1458,465
2572,563,306,257,57,53,60,56,105,232,0,1926,563
2573,1891,1453,438,201,180,192,202,342,774,1,4161,1892
2574,2574,1570,1004,239,291,238,250,489,1067,239,7900,2813
2575,1406,858,548,131,159,130,136,267,583,30,4313,1436
2576,864,527,337,80,98,80,84,164,358,11,2651,875
2577,1703,1039,664,158,193,157,165,324,706,4,5227,1707
2578,743,498,245,64,67,73,73,131,335,14,2044,757
2579,502,336,166,44,45,49,49,89,226,28,1380,530
2580,494,419,75,43,44,46,44,102,215,0,1116,494
2581,157,90,67,11,16,13,17,35,65,41,511,198
2582,216,133,83,17,22,19,20,43,95,0,602,216
2583,260,160,100,20,26,23,25,51,115,9,726,269
2584,835,414,421,70,75,67,78,166,379,0,2981,835
2585,1183,1002,181,93,115,100,104,241,530,0,2732,1183
2586,2258,1913,345,177,220,192,198,459,1012,1,5215,2259
2587,358,312,46,29,35,36,36,73,149,0,765,358
2588,398,347,51,33,39,39,39,81,167,63,853,461
2589,274,113,161,30,26,28,25,53,112,0,1092,274
2590,281,115,166,30,26,29,26,54,116,0,1120,281
2591,377,276,101,35,36,36,37,69,164,68,973,445
2592,1122,644,478,80,117,95,123,250,457,0,3656,1122
2593,364,238,126,24,37,32,36,74,161,0,1061,364
2594,423,178,245,34,40,44,36,80,189,0,1548,423
2595,420,177,243,34,40,44,36,79,187,0,1537,420
2596,610,450,160,51,49,58,64,112,276,0,1636,610
2597,282,243,39,18,26,21,21,56,140,3,681,285
2598,284,245,39,19,26,21,21,57,140,0,688,284
2599,393,343,50,33,41,32,37,65,185,15,875,408
2600,437,230,207,35,33,46,42,86,195,0,1508,437
2601,736,388,348,59,56,77,71,146,327,10,2538,746
2602,223,118,105,18,17,23,21,44,100,0,768,223
2603,1173,816,357,92,123,99,99,244,516,8,3156,1181
2604,271,211,60,21,22,21,23,55,129,0,689,271
2605,360,281,79,28,30,27,31,73,171,13,915,373
2606,269,173,96,21,26,25,18,66,113,0,815,269
2607,1037,774,263,73,67,78,103,215,501,22,2519,1059
2608,1722,1236,486,81,149,117,160,358,857,22,4458,1744
2609,1360,1041,319,75,99,95,108,322,661,53,3413,1413
2610,2965,2045,920,200,199,205,279,606,1476,22,8086,2987
2611,1198,736,462,67,84,75,107,280,585,0,3484,1198
2612,421,299,122,25,36,32,23,95,210,0,1108,421
2613,1649,1335,314,141,100,135,129,376,768,43,3871,1692
2614,1855,1281,574,114,176,134,144,416,871,6,5123,1861
2615,231,164,67,18,24,21,23,53,92,82,570,313
2616,1354,1003,351,75,96,98,117,297,671,8,3370,1362
2617,941,690,251,54,87,69,77,189,465,0,2375,941
2618,2459,1912,547,129,204,183,212,558,1173,14,6069,2473
2619,1542,1326,216,106,135,122,136,315,728,26,3027,1568
2620,1590,1197,393,90,130,132,120,339,779,311,3889,1901
2621,5194,3912,1282,333,488,441,434,1147,2351,23,12935,5217
2622,502,368,134,41,37,34,53,97,240,0,1320,502
2623,186,136,50,15,14,13,20,36,88,9,489,195
2624,2774,1975,799,244,155,191,272,554,1358,0,7603,2774
2625,2217,1608,609,182,121,170,180,489,1075,90,6057,2307
2626,1531,1153,378,114,79,127,118,321,772,7,3845,1538
2627,3885,2847,1038,330,247,269,345,805,1889,17,9254,3902
2628,2561,1437,1124,189,189,242,133,604,1204,10,9353,2571
2629,598,434,164,41,34,43,60,127,293,19,1645,617
2630,872,522,350,64,69,84,88,198,369,0,2510,872
2631,365,248,117,24,20,25,30,78,188,0,985,365
2632,6016,4254,1762,439,348,465,509,1240,3015,14,15612,6030
2633,1397,1026,371,65,102,84,112,303,731,14,3772,1411
2634,3298,2212,1086,257,187,252,272,687,1643,11,9447,3309
2635,1539,1109,430,112,119,104,136,329,739,0,4273,1539
2636,434,304,130,26,43,36,43,102,184,0,1112,434
2637,2572,1937,635,165,242,218,215,568,1164,96,6405,2668
2638,895,574,321,71,86,85,61,221,371,0,2707,895
2639,659,644,15,73,48,41,116,138,243,0,1214,659
2640,475,378,97,39,54,43,49,104,186,183,966,658
2641,1213,1043,170,84,106,96,107,248,572,100,2381,1313
2642,661,464,197,61,45,47,67,144,297,5,1882,666
2643,757,523,234,47,72,55,59,170,354,0,2092,757
2644,365,301,64,21,40,34,38,83,149,0,806,365
2645,593,472,121,49,68,54,62,130,230,1,1206,594
2646,601,495,106,34,65,57,63,136,246,0,1326,601
2647,731,526,205,45,56,66,48,165,351,0,1811,731
2648,541,389,152,33,42,49,36,122,259,31,1341,572
2649,539,388,151,33,41,49,36,122,258,0,1336,539
2650,344,241,103,21,34,29,34,81,145,0,884,344
2651,1160,727,433,103,118,89,100,245,505,0,3572,1160
2652,580,499,81,40,51,46,51,118,274,0,1138,580
2653,1610,1385,225,111,141,127,142,329,760,0,3161,1610
2654,2270,1953,317,157,199,180,200,464,1070,100,4456,2370
2655,1439,784,655,110,150,119,141,292,627,0,4858,1439
2656,13892,7923,5969,2703,6243,613,649,1366,2318,0,46916,13892
2657,6224,3550,2674,1211,2797,274,291,612,1039,0,21020,6224
2658,744,527,217,58,77,68,74,170,297,0,1834,744
2659,1433,1070,363,101,93,108,142,297,692,37,3481,1470
2660,732,459,273,65,75,56,63,154,319,0,2253,732
2661,245,172,73,15,24,20,24,58,104,0,629,245
2662,798,586,212,37,58,48,64,173,418,7,2156,805
2663,739,532,207,46,57,67,49,167,353,553,1831,1292
2664,904,670,234,50,64,66,78,198,448,0,2252,904
2665,262,192,70,15,24,19,21,53,130,0,662,262
2666,788,588,200,56,51,59,78,164,380,0,1914,788
2667,3849,2899,950,247,361,327,322,850,1742,0,9586,3849
2668,3738,3481,257,397,332,409,294,715,1591,4,6210,3742
2669,2347,2186,161,249,209,257,185,449,998,146,3899,2493
2670,537,380,157,47,35,47,50,122,236,40,1518,577
2671,440,311,129,38,29,38,41,100,194,7,1245,447
2672,455,333,122,37,34,31,48,88,217,37,1196,492
2673,465,341,124,38,34,31,49,90,223,81,1222,546
2674,421,308,113,35,31,28,45,82,200,24,1106,445
2675,594,447,147,33,49,49,45,126,292,0,1454,594
2676,1076,674,402,95,110,82,93,227,469,0,3313,1076
2677,1291,704,587,98,134,107,127,262,563,0,4357,1291
2678,1259,789,470,112,128,96,109,266,548,0,3876,1259
2679,1057,780,277,98,78,77,102,200,502,24,2906,1081
2680,367,271,96,34,27,27,35,69,175,0,1009,367
2681,537,442,95,30,58,51,56,122,220,57,1184,594
2682,275,165,110,20,22,27,28,62,116,106,790,381
2683,726,514,212,56,75,66,72,166,291,3,1790,729
2684,693,491,202,54,72,63,69,159,276,0,1709,693
2685,300,222,78,28,22,22,29,57,142,14,825,314
2686,562,407,155,39,32,40,56,119,276,24,1547,586
2687,111,90,21,10,7,9,9,25,51,0,261,111
2688,69,56,13,6,4,6,5,16,32,75,162,144
2689,1089,882,207,93,66,89,85,249,507,267,2556,1356
2690,357,253,104,28,37,33,35,82,142,0,880,357
2691,270,191,79,21,28,25,27,62,107,6,665,276
2692,2959,2072,887,180,291,247,294,696,1251,92,7590,3051
2693,670,497,173,37,47,49,58,147,332,8,1667,678
2694,710,521,189,41,65,52,58,143,351,13,1792,723
2695,435,300,135,27,41,31,34,98,204,37,1202,472
2696,563,398,165,49,37,49,52,128,248,13,1591,576
2697,602,426,176,52,40,53,56,137,264,3,1704,605
2698,362,254,108,34,25,26,37,79,161,8,1031,370
2699,546,383,163,51,37,39,55,119,245,31,1556,577
2700,351,246,105,33,24,25,35,76,158,5,999,356
2701,750,549,201,62,55,50,80,146,357,0,1972,750
2702,1162,1055,107,84,143,114,120,262,439,0,2092,1162
2703,1910,1494,416,142,196,180,150,434,808,409,4568,2319
2704,2185,1611,574,97,187,147,193,503,1058,38,5949,2223
2705,1042,807,235,51,98,88,76,209,520,36,2780,1078
2706,2050,1546,504,93,173,151,153,458,1022,63,5548,2113
2707,1633,1318,315,99,148,123,146,343,774,28,3919,1661
2708,1117,886,231,76,124,95,121,222,479,25,2688,1142
2709,894,740,154,66,111,79,102,188,348,7,2100,901
2710,1425,1073,352,92,154,124,150,312,593,8,3749,1433
2711,7322,7320,2,810,1026,846,722,1480,2438,0,9871,7322
2712,756,592,164,68,59,51,99,174,305,1363,2012,2119
2713,370,298,72,25,46,35,41,75,148,0,841,370
2714,112,90,22,8,14,11,13,23,43,0,255,112
2715,730,518,212,39,74,62,74,154,327,0,2083,730
2716,1677,1422,255,89,163,143,152,364,766,801,4662,2478
2717,2439,1928,511,159,244,190,236,614,996,0,6177,2439
2718,969,814,155,55,91,89,82,216,436,0,2291,969
2719,382,278,104,27,38,31,41,78,167,0,1041,382
2720,709,567,142,43,65,60,66,156,319,0,1847,709
2721,1136,760,376,46,84,65,92,254,595,8,3296,1144
2722,253,194,59,13,23,18,26,52,121,0,701,253
2723,666,515,151,40,52,59,73,149,293,0,1773,666
2724,1439,1282,157,88,155,112,131,270,683,0,2813,1439
2725,1926,1656,270,129,192,189,179,414,823,196,4118,2122
2726,988,720,268,69,99,79,107,202,432,0,2692,988
2727,3854,3499,355,278,473,377,397,868,1461,31,6944,3885
2728,1124,1002,122,88,134,112,126,210,454,10,2025,1134
2729,3859,3440,419,304,461,385,431,719,1559,0,6952,3859
2730,1014,917,97,70,108,85,97,205,449,0,1983,1014
2731,640,579,61,44,68,53,61,130,284,0,1251,640
2732,1348,1219,129,93,143,113,128,273,598,2,2636,1350
2733,2275,2028,247,179,272,227,254,424,919,43,4098,2318
2734,2297,2046,251,141,248,179,209,432,1088,0,4491,2297
2735,1686,1316,370,107,144,142,127,346,820,57,4147,1743
2736,482,389,93,29,44,36,43,101,229,0,1157,482
2737,589,533,56,41,63,49,56,119,261,2,1152,591
2738,471,420,51,37,56,47,53,88,190,0,848,471
2739,1215,902,313,71,121,111,126,246,540,2,3392,1217
2740,263,202,61,13,24,19,27,54,126,0,729,263
2741,423,325,98,22,39,31,43,87,201,0,1173,423
2742,329,257,72,21,28,28,25,67,160,0,808,329
2743,604,471,133,38,51,51,46,124,294,0,1485,604
2744,796,621,175,50,68,67,60,163,388,236,1959,1032
2745,1738,1439,299,128,217,154,199,366,674,7,4082,1745
2746,367,288,79,19,25,24,24,92,183,97,970,464
2747,1348,1060,288,69,93,90,86,337,673,28,3567,1376
2748,1944,1732,212,120,210,151,177,365,921,0,3801,1944
2749,226,182,44,14,20,17,20,47,108,14,542,240
2750,703,567,136,43,64,53,63,148,332,0,1687,703
2751,699,555,144,48,77,60,76,139,299,17,1682,716
2752,271,212,59,20,28,26,21,62,114,84,647,355
2753,988,818,170,73,123,87,113,208,384,0,2321,988
2754,931,730,201,69,121,94,107,208,332,0,2276,931
2755,1191,959,232,81,149,114,133,240,474,0,2711,1191
2756,374,278,96,22,37,34,39,76,166,20,1044,394
2757,1764,1382,382,131,230,178,202,394,629,70,4315,1834
2758,1835,1438,397,136,239,186,210,410,654,0,4488,1835
2759,2007,1615,392,137,251,192,224,404,799,0,4567,2007
2760,426,302,124,23,43,36,43,90,191,0,1214,426
2761,848,601,247,45,86,71,86,179,381,0,2420,848
2762,513,394,119,26,47,37,53,106,244,11,1423,524
2763,1633,1305,328,99,149,139,153,359,734,59,4256,1692
2764,333,266,67,20,30,28,31,73,151,0,867,333
2765,2532,1956,576,181,326,262,301,576,886,0,6452,2532
2766,1641,1083,558,108,151,108,158,359,757,41,4648,1682
2767,2612,1753,859,168,236,189,285,540,1194,46,7227,2658
2768,340,206,134,21,39,26,35,74,145,0,1035,340
2769,1665,1157,508,104,164,155,171,366,705,24,4484,1689
2770,1230,914,316,64,125,103,126,253,559,0,3288,1230
2771,12935,7866,5069,695,969,946,1194,2956,6175,489,41128,13424
2772,3964,2782,1182,216,341,306,388,884,1829,8,10669,3972
2773,2413,1950,463,141,202,163,227,513,1167,0,5506,2413
2774,2955,2016,939,197,242,209,320,597,1390,0,7970,2955
2775,5156,3874,1282,343,540,463,527,1041,2242,53,13203,5209
2776,1353,1040,313,78,106,99,123,284,663,0,3310,1353
2777,1901,1328,573,86,160,127,205,416,907,39,5442,1940
2778,5283,3739,1544,322,542,418,554,1100,2347,6,14676,5289
2779,3576,2274,1302,213,330,307,426,767,1533,7,10218,3583
2780,1261,697,564,70,96,84,115,275,621,0,3944,1261
2781,795,611,184,46,63,58,72,167,389,0,1946,795
2782,219,149,70,15,18,15,24,44,103,0,590,219
2783,503,278,225,28,38,33,46,110,248,0,1572,503
2784,448,248,200,25,34,30,41,98,220,19,1400,467
2785,966,743,223,56,76,71,88,203,472,0,2364,966
2786,529,292,237,29,40,35,48,115,262,8,1653,537
2787,319,193,126,20,36,25,33,70,135,1,973,320
2788,487,294,193,31,55,38,50,107,206,3,1483,490
2789,4254,3437,817,248,356,288,399,905,2058,0,9706,4254
2790,1239,845,394,83,101,87,134,250,584,0,3343,1239
2791,3231,2205,1026,215,264,228,350,652,1522,0,8715,3231
2792,1557,1102,455,99,150,125,158,354,671,63,4543,1620
2793,1436,1034,402,100,105,135,162,251,683,10,4078,1446
2794,1036,626,410,94,104,99,119,176,444,83,3209,1119
2795,1501,812,689,161,147,169,167,272,585,0,4401,1501
2796,424,277,147,25,31,30,39,93,206,0,1278,424
2797,1365,914,451,124,131,136,145,264,565,129,3947,1494
2798,332,181,151,24,33,33,33,70,139,3,1185,335
2799,423,363,60,47,55,41,49,91,140,21,977,444
2800,969,471,498,40,84,60,85,204,496,16,3324,985
2801,1325,727,598,70,110,97,114,297,637,0,4425,1325
2802,6243,3901,2342,366,544,463,580,1353,2937,0,19124,6243
2803,1521,1030,491,125,163,163,187,289,594,0,4560,1521
2804,453,272,181,34,44,46,46,84,199,5,1508,458
2805,3485,2091,1394,261,335,354,357,645,1533,31,10012,3516
2806,487,362,125,47,48,51,68,83,190,10,1366,497
2807,2493,1722,771,166,242,212,274,453,1146,39,7671,2532
2808,1306,799,507,99,152,116,152,266,521,21,4252,1327
2809,203,124,79,15,24,18,24,41,81,0,660,203
2810,1644,764,880,124,184,155,179,319,683,7,6437,1651
2811,9800,5015,4785,818,1408,674,734,1828,4338,119,34511,9919
2812,2192,1152,1040,107,162,146,185,488,1104,0,7373,2192
2813,1531,805,726,74,113,102,129,341,772,44,5148,1575
2814,5216,3693,1523,331,503,417,530,1187,2248,209,15215,5425
2815,200,142,58,13,19,16,20,46,86,0,583,200
2816,338,156,182,24,37,33,38,66,140,4,1260,342
2817,528,280,248,29,40,35,44,121,259,16,1832,544
2818,226,138,88,17,26,20,26,46,91,0,737,226
2819,964,526,438,70,96,95,95,202,406,0,3442,964
2820,438,239,199,32,42,35,40,95,194,66,1329,504
2821,128,78,50,10,15,11,15,26,51,0,415,128
2822,551,302,249,29,46,40,47,124,265,0,1841,551
2823,1131,600,531,61,87,75,94,259,555,0,3925,1131
2824,692,378,314,51,67,55,63,150,306,11,2099,703
2825,867,474,393,64,84,69,79,188,383,1,2631,868
2826,587,321,266,43,57,47,53,127,260,4,1783,591
2827,825,401,424,34,71,51,73,174,422,1,2830,826
2828,653,318,335,27,56,40,57,137,336,0,2242,653
2829,785,429,356,58,76,63,72,170,346,20,2382,805
2830,1205,895,310,117,118,127,168,204,471,0,3380,1205
2831,768,404,364,37,57,51,65,171,387,96,2585,864
2832,844,551,293,49,61,61,77,185,411,13,2545,857
2833,634,424,210,59,69,62,76,122,246,50,1834,684
2834,1704,1282,422,148,192,158,203,333,670,46,4613,1750
2835,1630,865,765,88,125,108,135,373,801,0,5657,1630
2836,450,246,204,33,43,36,41,98,199,0,1366,450
2837,1103,549,554,52,82,96,89,230,554,0,3659,1103
2838,283,141,142,13,21,25,23,59,142,13,937,296
2839,1088,572,516,53,81,72,92,242,548,0,3658,1088
2840,607,371,236,46,71,54,71,124,241,42,1977,649
2841,242,148,94,22,25,24,26,48,97,0,779,242
2842,625,382,243,56,65,62,68,123,251,38,2012,663
2843,369,192,177,31,44,36,37,67,154,0,1299,369
2844,1469,981,488,136,161,143,175,283,571,11,4250,1480
2845,548,366,182,51,60,53,65,105,214,124,1587,672
2846,432,289,143,40,47,42,51,83,169,35,1251,467
2847,530,376,154,38,64,46,59,125,198,57,1524,587
2848,464,329,135,33,56,40,52,109,174,15,1335,479
2849,773,548,225,55,93,67,86,182,290,147,2222,920
2850,664,471,193,48,80,58,74,156,248,0,1909,664
2851,2970,2093,877,217,263,260,265,634,1331,0,8522,2970
2852,237,161,76,20,25,25,29,45,93,0,711,237
2853,498,325,173,29,36,36,45,109,243,0,1502,498
2854,1103,720,383,64,80,79,100,242,538,0,3324,1103
2855,450,235,215,36,50,40,54,90,180,0,1582,450
2856,360,188,172,28,40,32,43,72,145,0,1266,360
2857,1250,695,555,92,128,107,157,227,539,36,4414,1286
2858,765,425,340,56,78,65,96,139,331,0,2702,765
2859,456,254,202,34,47,39,57,83,196,0,1611,456
2860,1006,638,368,89,100,121,134,175,387,0,3049,1006
2861,390,290,100,38,38,41,55,66,152,1,1093,391
2862,1551,1152,399,150,152,164,217,263,605,0,4351,1551
2863,400,185,215,29,44,38,45,78,166,6,1493,406
2864,997,463,534,70,96,90,119,220,402,0,3717,997
2865,702,429,273,53,82,63,82,143,279,0,2285,702
2866,383,209,174,28,38,38,38,80,161,0,1367,383
2867,778,520,258,72,85,76,93,150,302,0,2252,778
2868,962,511,451,52,74,64,80,220,472,5,3340,967
2869,246,128,118,21,29,24,25,45,102,14,866,260
2870,1008,525,483,85,119,99,102,183,420,0,3544,1008
2871,475,290,185,43,50,47,52,93,190,0,1528,475
2872,1938,1184,754,174,203,191,210,381,779,87,6235,2025
2873,413,293,120,30,50,36,46,97,154,0,1187,413
2874,939,662,277,68,83,82,84,200,422,3,2695,942
2875,879,662,217,77,99,82,105,172,344,0,2380,879
2876,1015,531,484,80,112,91,121,204,407,0,3568,1015
2877,685,419,266,52,80,61,80,140,272,0,2231,685
2878,447,206,241,32,49,43,51,87,185,0,1666,447
2879,9,5,4,0,1,1,1,2,4,41,29,50
2880,819,450,369,43,68,60,70,184,394,0,2734,819
2881,1583,869,714,83,131,116,136,355,762,4,5287,1587
2882,912,501,411,48,76,67,78,205,438,110,3046,1022
2883,940,516,424,49,78,69,81,211,452,2,3141,942
2884,1570,981,589,92,137,116,146,340,739,12,4809,1582
2885,876,547,329,51,76,65,81,190,413,0,2684,876
2886,1226,766,460,72,107,91,114,266,576,0,3755,1226
2887,1041,650,391,61,91,77,97,226,489,0,3190,1041
2888,1165,728,437,68,101,86,108,252,550,3,3569,1168
2889,1499,937,562,88,131,111,139,325,705,5,4593,1504
2890,2809,1755,1054,165,245,208,261,609,1321,19,8604,2828
2891,3831,2394,1437,225,334,284,356,830,1802,0,11737,3831
2892,1651,1032,619,97,144,123,153,358,776,3,5059,1654
2893,6699,4186,2513,393,583,497,622,1452,3152,22,20522,6721
2894,8548,5341,3207,502,745,634,794,1852,4021,48,26186,8596
2895,1482,926,556,87,129,110,138,321,697,9,4541,1491
2896,2181,1061,1120,91,188,134,192,459,1117,12,7486,2193
2897,55,39,16,3,5,4,6,13,24,0,159,55
2898,1450,1244,206,161,190,139,170,311,479,0,3350,1450
2899,4041,2498,1543,316,497,400,454,984,1390,53,12711,4094
2900,1167,817,350,133,110,138,136,264,386,99,3307,1266
2901,1240,891,349,141,143,124,141,279,412,13,3279,1253
2902,1139,835,304,94,121,108,137,248,431,35,3141,1174
2903,1622,927,695,155,189,165,186,372,555,29,5251,1651
2904,2949,1969,980,248,329,315,338,676,1043,27,8210,2976
2905,1024,719,305,108,99,104,106,243,364,643,2328,1667
2906,4225,2844,1381,575,319,428,674,1030,1199,0,12605,4225
2907,792,617,175,76,100,79,104,179,254,0,2027,792
2908,2385,1768,617,232,235,242,287,550,839,73,6703,2458
2909,1468,1039,429,137,160,156,145,323,547,78,4116,1546
2910,810,577,233,78,95,79,94,181,283,45,2299,855
2911,254,165,89,30,31,27,24,58,84,21,743,275
2912,998,605,393,108,109,93,133,229,326,0,2802,998
2913,313,168,145,23,36,34,34,74,112,22,1160,335
2914,1605,898,707,137,188,176,166,360,578,24,5556,1629
2915,1291,888,403,112,124,104,168,295,488,0,3311,1291
2916,1528,1132,396,132,175,141,187,369,524,0,3932,1528
2917,285,196,89,30,34,32,30,62,97,243,783,528
2918,2432,2164,268,229,265,242,258,614,824,7,4968,2439
2919,1691,1202,489,189,211,163,191,407,530,20,4200,1711
2920,1983,1399,584,187,219,198,224,447,708,29,5406,2012
2921,2924,1579,1345,206,263,274,352,643,1186,0,9314,2924
2922,1899,1392,507,150,207,206,243,421,672,0,4783,1899
2923,1390,996,394,139,153,150,171,317,460,8,3557,1398
2924,773,466,307,77,82,63,82,175,294,17,2363,790
2925,852,593,259,96,85,108,104,161,298,0,2072,852
2926,336,181,155,25,39,37,36,79,120,14,1247,350
2927,459,265,194,42,45,52,44,103,173,0,1664,459
2928,804,521,283,94,100,84,74,184,268,3,2355,807
2929,699,534,165,76,78,85,81,161,218,9,1436,708
2930,1180,902,278,129,131,143,137,272,368,302,2425,1482
2931,292,218,74,30,38,32,33,66,93,0,674,292
2932,403,318,85,39,44,40,48,90,142,0,1006,403
2933,321,240,81,33,41,36,37,72,102,0,740,321
2934,313,234,79,32,40,35,36,70,100,0,722,313
2935,336,202,134,33,36,28,35,76,128,0,1026,336
2936,300,199,101,29,38,35,29,69,100,7,848,307
2937,295,196,99,28,37,34,28,68,100,14,835,309
2938,471,312,159,45,60,55,45,108,158,0,1334,471
2939,438,346,92,43,48,44,52,98,153,0,1094,438
2940,306,242,64,30,33,31,37,69,106,0,763,306
2941,591,460,131,57,74,59,78,134,189,0,1512,591
2942,322,214,108,29,34,36,41,75,107,0,876,322
2943,426,283,143,39,45,47,55,100,140,4,1160,430
2944,727,497,230,88,79,77,85,155,243,0,1725,727
2945,270,185,85,33,30,28,32,57,90,10,642,280
2946,582,405,177,65,58,74,71,110,204,64,1417,646
2947,354,205,149,32,35,40,34,79,134,34,1284,388
2948,399,231,168,36,39,45,38,89,152,34,1445,433
2949,866,595,271,91,102,96,90,188,299,202,2378,1068
2950,679,467,212,71,80,76,71,147,234,78,1864,757
2951,294,153,141,26,30,34,30,68,106,12,1084,306
2952,520,271,249,45,52,60,53,121,189,0,1916,520
2953,241,126,115,21,24,28,24,56,88,12,888,253
2954,563,294,269,49,57,65,57,131,204,28,2078,591
2955,512,340,172,46,54,56,66,120,170,0,1393,512
2956,1471,1261,210,165,158,157,188,324,479,55,3023,1526
2957,322,173,149,24,37,35,34,76,116,26,1196,348
2958,263,152,111,24,26,30,25,59,99,7,952,270
2959,847,659,188,82,107,85,111,191,271,15,2168,862
2960,25,16,9,2,3,2,3,6,9,0,73,25
2961,229,118,111,22,31,26,25,51,74,0,739,229
2962,1729,906,823,132,240,185,212,412,548,3,5719,1732
2963,811,365,446,106,132,78,104,212,179,1272,2867,2083
2964,4569,2594,1975,339,718,411,568,1159,1374,0,13971,4569
2965,1214,767,447,88,177,109,144,306,390,0,3444,1214
2966,0,0,0,0,0,0,0,0,0,0,0,0
2967,931,643,288,77,141,80,107,223,303,0,2345,931
2968,1236,817,419,103,171,118,134,323,387,0,3209,1236
2969,2082,1595,487,157,251,169,239,540,726,0,5421,2082
2970,6416,5013,1403,688,963,793,614,1570,1788,163,14162,6579
2971,1207,866,341,105,143,104,167,290,398,0,3201,1207
2972,3680,2861,819,344,395,375,466,811,1289,164,9316,3844
2973,470,263,207,45,61,49,59,103,153,0,1539,470
2974,1696,1011,685,131,194,173,222,365,611,254,5165,1950
2975,899,628,271,63,102,89,116,215,314,0,2624,899
2976,479,235,244,30,65,45,55,112,172,0,1560,479
2977,1606,1142,464,130,178,165,216,362,555,7,4644,1613
2978,4288,3050,1238,366,572,408,521,1010,1411,43,11450,4331
2979,4737,2830,1907,398,720,489,625,1118,1387,181,15340,4918
2980,2013,1215,798,170,263,186,264,465,665,116,6028,2129
2981,1923,1226,697,174,251,196,282,460,560,46,5971,1969
2982,1243,705,538,130,143,124,165,302,379,8,3971,1251
2983,2159,1320,839,191,296,215,281,487,689,27,6543,2186
2984,1659,932,727,147,195,181,203,371,562,11,5144,1670
2985,1148,575,573,86,143,119,145,277,378,0,3747,1148
2986,1814,1241,573,155,253,194,235,430,547,0,5165,1814
2987,3246,2592,654,304,389,316,393,806,1038,0,7294,3246
2988,1486,1139,347,111,228,134,155,365,493,11,4140,1497
2989,2743,2106,637,281,615,231,284,636,696,29,7214,2772
2990,1146,678,468,86,182,113,124,286,355,0,3460,1146
2991,1870,1097,773,158,226,166,207,457,656,15,5483,1885
2992,486,382,104,39,63,44,62,115,163,4,1222,490
2993,2257,1503,754,200,362,234,277,507,677,0,6053,2257
2994,1660,1413,247,190,195,160,207,387,521,6,4492,1666
2995,4138,2307,1831,301,662,366,485,1025,1299,6,12890,4144
2996,1573,1088,485,129,243,147,171,384,499,0,4223,1573
2997,765,512,253,60,134,77,85,175,234,21,2274,786
2998,1031,576,455,98,133,107,130,227,336,147,3381,1178
2999,670,345,325,64,91,75,73,148,219,0,2163,670
3000,506,305,201,32,80,52,59,129,154,0,1607,506
3001,1013,611,402,64,159,103,119,258,310,1,3216,1014
3002,410,247,163,26,64,42,48,104,126,0,1302,410
3003,624,396,228,47,102,59,71,155,190,0,1930,624
3004,682,411,271,43,107,69,80,174,209,0,2166,682
3005,0,0,0,0,0,0,0,0,0,0,0,0
3006,7763,4638,3125,652,1179,801,1025,1832,2274,0,25143,7763
3007,552,333,219,35,87,56,65,141,168,0,1752,552
3008,601,382,219,45,98,57,68,149,184,0,1861,601
3009,650,413,237,49,106,62,74,161,198,0,2011,650
3010,474,286,188,30,75,48,56,121,144,0,1504,474
3011,407,258,149,30,66,39,46,101,125,0,1258,407
3012,477,299,178,41,62,47,64,115,148,16,1421,493
3013,58,36,22,5,8,6,8,14,17,0,173,58
3014,702,440,262,61,91,69,94,170,217,0,2093,702
3015,897,498,399,86,89,88,107,224,303,6,2797,903
3016,306,157,149,29,42,34,34,68,99,0,987,306
3017,1394,874,520,121,182,137,187,337,430,0,4154,1394
3018,596,313,283,58,71,65,82,144,176,9,2026,605
3019,150,100,50,12,26,15,17,34,46,0,446,150
3020,408,227,181,39,41,40,49,102,137,2,1273,410
3021,665,497,168,61,79,60,79,147,239,0,1792,665
3022,694,470,224,75,66,84,85,158,226,111,1978,805
3023,239,162,77,26,23,29,29,54,78,53,682,292
3024,355,265,90,32,42,32,42,79,128,0,956,355
3025,699,368,331,68,83,76,96,169,207,11,2377,710
3026,430,239,191,41,43,42,51,107,146,0,1342,430
3027,1572,1099,473,110,179,156,203,376,548,4,4587,1576
3028,1547,1081,466,108,176,154,200,370,539,0,4514,1547
3029,2007,985,1022,127,274,187,232,470,717,0,6534,2007
3030,580,285,295,37,79,54,67,136,207,1,1889,581
3031,208,164,44,17,27,19,27,49,69,14,522,222
3032,291,229,62,24,38,26,37,69,97,0,732,291
3033,1011,795,216,82,132,91,130,238,338,10,2542,1021
3034,527,364,163,43,80,45,60,126,173,0,1327,527
3035,371,256,115,31,56,32,42,89,121,0,934,371
3036,318,219,99,26,48,27,36,76,105,0,801,318
3037,816,563,253,67,124,70,93,195,267,0,2054,816
3038,832,664,168,78,100,81,101,207,265,0,1869,832
3039,905,723,182,85,108,88,110,225,289,0,2033,905
3040,626,500,126,59,75,61,76,155,200,0,1407,626
3041,14,9,5,1,2,1,2,3,5,0,41,14
3042,0,0,0,0,0,0,0,0,0,0,0,0
3043,0,0,0,0,0,0,0,0,0,0,0,0
3044,0,0,0,0,0,0,0,0,0,0,0,0
3045,4,3,1,0,1,0,0,1,2,0,13,4
3046,1979,1240,739,171,258,194,266,479,611,25,5895,2004
3047,332,224,108,20,28,24,34,66,160,0,1006,332
3048,3531,2535,996,234,261,252,307,768,1709,78,9733,3609
3049,2366,1326,1040,123,201,161,205,520,1156,28,7671,2394
3050,2271,1727,544,131,169,170,202,512,1087,83,5682,2354
3051,2594,1881,713,171,204,173,216,565,1265,11,7314,2605
3052,2531,1773,758,146,173,190,228,546,1248,50,6591,2581
3053,1083,807,276,55,82,80,88,226,552,1,2870,1084
3054,2285,1794,491,143,190,180,187,495,1090,140,5687,2425
3055,40,39,1,1,1,0,1,12,25,0,57,40
3056,1465,805,660,87,139,99,128,295,717,71,5187,1536
3057,3290,2319,971,203,316,250,229,732,1560,0,10847,3290
3058,351,233,118,21,29,30,32,71,168,0,923,351
3059,1001,638,363,66,109,72,86,209,459,0,2954,1001
3060,939,533,406,63,79,73,81,198,445,1,2788,940
3061,464,365,99,35,38,44,40,95,212,8,1080,472
3062,601,472,129,45,50,56,52,123,275,0,1399,601
3063,394,297,97,23,31,33,33,92,182,0,862,394
3064,237,179,58,14,19,20,20,55,109,176,519,413
3065,466,309,157,28,39,39,43,94,223,0,1227,466
3066,506,335,171,31,42,43,46,102,242,115,1331,621
3067,1069,740,329,75,88,77,92,227,510,57,2879,1126
3068,576,392,184,35,46,40,53,128,274,17,1459,593
3069,652,492,160,38,51,54,55,153,301,164,1426,816
3070,492,332,160,30,41,35,51,98,237,0,1492,492
3071,1026,693,333,63,85,73,106,204,495,0,3111,1026
3072,994,688,306,70,82,71,85,211,475,0,2679,994
3073,258,176,82,16,20,18,24,58,122,0,652,258
3074,725,462,263,48,79,52,62,151,333,0,2138,725
3075,1323,844,479,88,144,95,114,276,606,62,3902,1385
3076,522,410,112,39,43,49,45,107,239,0,1214,522
3077,438,303,135,31,36,31,38,93,209,0,1180,438
3078,410,284,126,29,34,29,35,87,196,382,1105,792
3079,412,285,127,29,34,30,35,88,196,0,1110,412
3080,433,238,195,26,41,29,38,87,212,0,1533,433
3081,537,295,242,32,51,36,47,108,263,0,1900,537
3082,576,406,170,35,55,44,40,128,274,8,1898,584
3083,1067,752,315,66,102,81,74,237,507,0,3517,1067
3084,1174,1030,144,90,90,98,102,254,540,1383,2186,2557
3085,2682,2066,616,166,222,207,228,586,1273,137,6418,2819
3086,875,628,247,69,70,73,64,197,402,14,2179,889
3087,2433,1898,535,191,235,168,252,517,1070,76,6178,2509
3088,2190,1837,353,159,144,173,156,494,1064,15,5267,2205
3089,2728,2171,557,183,177,197,242,575,1354,63,6469,2791
3090,1009,798,211,61,62,70,98,216,502,20,2392,1029
3091,1828,1523,305,135,171,144,164,417,797,1493,4374,3321
3092,728,591,137,55,39,47,60,163,364,88,1612,816
3093,4,2,2,0,0,0,0,1,3,0,15,4
3094,450,247,203,27,43,31,39,91,219,0,1592,450
3095,1,1,0,0,0,0,0,0,1,0,3,1
3096,1,1,0,0,0,0,0,0,1,0,3,1
3097,0,0,0,0,0,0,0,0,0,0,0,0
3098,0,0,0,0,0,0,0,0,0,0,0,0
3099,1,1,0,0,0,0,0,0,1,0,3,1
3100,0,0,0,0,0,0,0,0,0,0,0,0
3101,303,241,62,20,20,22,27,64,150,27,720,330
3102,314,250,64,21,20,23,28,66,156,0,746,314
3103,191,152,39,13,12,14,17,40,95,14,453,205
3104,1097,877,220,83,154,118,104,272,366,6,2609,1103
3105,2259,2087,172,203,295,272,233,500,756,17,4427,2276
3106,2060,1383,677,208,275,198,265,414,700,39,5695,2099
3107,2301,1779,522,235,267,208,335,521,735,986,5058,3287
3108,3133,2072,1061,242,400,310,364,633,1184,0,8646,3133
3109,1481,1035,446,114,203,155,148,333,528,0,4221,1481
3110,2934,2145,789,303,380,314,304,643,990,170,8171,3104
3111,6023,4060,1963,466,856,651,749,1355,1946,66,16531,6089
3112,403,269,134,39,57,43,47,85,132,0,1050,403
3113,541,416,125,51,70,63,64,108,185,0,1266,541
3114,562,353,209,52,72,66,67,116,189,8,1578,570
3115,1598,1237,361,143,214,183,190,350,518,0,3746,1598
3116,665,538,127,74,79,92,71,140,209,3223,1764,3888
3117,2000,1258,742,176,311,236,233,427,617,0,5483,2000
3118,3996,3149,847,372,639,433,477,831,1244,355,8765,4351
3119,1567,1164,403,115,241,142,186,361,522,0,4080,1567
3120,762,642,120,58,98,81,77,183,265,0,1839,762
3121,366,276,90,33,54,40,41,81,117,0,884,366
3122,790,597,193,71,118,87,88,175,251,0,1907,790
3123,1395,1046,349,132,157,140,165,323,478,42,3496,1437
3124,1844,1284,560,129,275,177,195,415,653,593,4842,2437
3125,967,744,223,90,126,112,115,193,331,3,2261,970
3126,3660,2781,879,423,418,387,443,791,1198,0,8756,3660
3127,483,328,155,41,61,47,63,109,162,0,1343,483
3128,3259,2656,603,320,438,334,439,675,1053,17,7599,3276
3129,2186,1454,732,197,326,234,274,480,675,0,5744,2186
3130,4107,3447,660,391,543,432,517,836,1388,0,8774,4107
3131,2778,2384,394,224,422,282,340,631,879,59,5900,2837
3132,3456,2088,1368,335,439,383,434,724,1141,21,10095,3477
3133,1343,933,410,116,167,150,148,277,485,15,4161,1358
3134,1347,1055,292,113,196,172,126,314,426,205,3402,1552
3135,4007,3871,136,462,484,473,502,860,1226,0,6773,4007
3136,2154,1693,461,191,294,236,269,454,710,256,5104,2410
3137,6439,5125,1314,603,914,730,638,1606,1948,118,15563,6557
3138,1455,1111,344,137,226,175,165,325,427,60,3516,1515
3139,3132,2338,794,259,476,331,370,709,987,46,8109,3178
3140,4227,3244,983,504,627,441,515,842,1298,97,10280,4324
3141,987,734,253,86,166,115,99,225,296,0,2563,987
3142,1470,1172,298,174,196,170,152,334,444,419,3184,1889
3143,1704,1291,413,188,236,170,202,393,515,60,3769,1764
3144,1667,1103,564,135,253,188,177,400,514,38,4166,1705
3145,2071,1314,757,148,282,233,225,493,690,43,5827,2114
3146,1759,1314,445,192,267,197,184,388,531,20,4323,1779
3147,1682,893,789,159,225,197,198,420,483,27,5670,1709
3148,561,326,235,60,76,70,62,127,166,8,1858,569
3149,1528,812,716,165,209,164,191,333,466,33,5365,1561
3150,604,321,283,65,83,65,76,132,183,13,2122,617
3151,2754,2114,640,217,449,261,364,676,787,0,6426,2754
3152,3858,2743,1115,368,571,414,453,883,1169,21,10384,3879
3153,1830,1271,559,174,239,197,223,439,558,11,4951,1841
3154,1323,982,341,150,169,149,148,297,410,20,3607,1343
3155,2135,1430,705,254,300,260,252,487,582,18,6043,2153
3156,2343,1656,687,192,382,253,285,542,689,67,6475,2410
3157,2611,1959,652,257,337,370,292,614,741,43,6802,2654
3158,1489,613,876,150,223,159,142,362,453,279,6031,1768
3159,4929,2705,2224,520,647,517,584,1144,1517,60,17387,4989
3160,933,605,328,82,122,106,103,216,304,45,2879,978
3161,1666,1292,374,138,233,161,213,379,542,206,3820,1872
3162,1699,1288,411,151,251,184,208,367,538,17,3971,1716
3163,1800,1368,432,149,272,191,229,371,588,22,4351,1822
3164,1557,1199,358,129,246,159,178,352,493,0,3661,1557
3165,2208,1674,534,224,306,258,283,474,663,151,5220,2359
3166,3001,1678,1323,302,391,367,333,691,917,70,10036,3071
3167,4738,3145,1593,552,669,574,512,1002,1429,39,13354,4777
3168,2953,2334,619,303,379,337,312,692,930,20,6668,2973
3169,3167,2563,604,335,435,374,368,716,939,385,7319,3552
3170,1328,991,337,77,177,149,160,328,437,28,3355,1356
3171,2093,1760,333,244,283,244,212,467,643,342,3905,2435
3172,7082,5884,1198,724,939,765,649,1530,2475,0,15884,7082
3173,3470,2765,705,359,516,464,303,825,1003,98,8135,3568
3174,1980,1753,227,201,277,238,204,466,594,0,3828,1980
3175,1759,1507,252,191,238,187,193,394,556,240,3899,1999
3176,2499,2122,377,303,350,282,290,556,718,104,4821,2603
3177,2318,1870,448,266,304,263,303,520,662,60,4630,2378
3178,1640,1278,362,187,219,201,169,413,451,46,3682,1686
3179,1512,994,518,159,213,166,212,335,427,19,4283,1531
3180,1591,1208,383,117,245,181,183,384,481,0,3818,1591
3181,1262,992,270,104,179,132,144,299,404,115,2951,1377
3182,1537,1114,423,162,243,163,213,336,420,144,3997,1681
3183,4968,3465,1503,445,744,583,668,1107,1421,157,13234,5125
3184,3516,3050,466,477,878,467,426,646,622,156,7180,3672
3185,2242,1871,371,203,365,237,282,550,605,0,4711,2242
3186,2149,1713,436,182,325,239,259,501,643,3,4913,2152
3187,281,144,137,25,39,30,37,64,86,68,919,349
3188,793,500,293,62,120,71,92,185,263,25,2262,818
3189,1972,1533,439,167,261,202,235,470,637,230,4851,2202
3190,2844,1743,1101,310,395,293,379,602,865,76,7949,2920
3191,225,163,62,21,31,26,29,49,69,0,571,225
3192,59,44,15,5,10,7,6,13,18,0,154,59
3193,1170,794,376,100,148,114,151,264,393,0,3253,1170
3194,248,193,55,21,33,25,30,59,80,0,611,248
3195,632,325,307,57,88,68,83,143,193,0,2064,632
3196,308,158,150,28,43,33,41,70,93,8,1006,316
3197,1123,708,415,88,170,101,130,262,372,0,3200,1123
3198,1945,1278,667,205,273,213,273,431,550,0,5512,1945
3199,1809,930,879,164,252,194,238,411,550,8,5907,1817
3200,1954,1284,670,206,275,214,275,433,551,0,5537,1954
3201,588,386,202,62,83,65,83,130,165,6,1666,594
3202,1145,753,392,121,161,126,161,254,322,0,3244,1145
3203,352,231,121,37,49,39,49,78,100,6,997,358
3204,316,199,117,25,48,28,37,74,104,0,902,316
3205,476,300,176,37,72,43,55,111,158,0,1357,476
3206,285,180,105,22,43,26,33,67,94,0,813,285
3207,354,223,131,28,54,32,41,83,116,0,1008,354
3208,357,258,99,33,49,41,46,78,110,31,906,388
3209,729,527,202,66,100,84,94,160,225,0,1851,729
3210,727,526,201,66,100,84,94,159,224,0,1846,727
3211,129,96,33,11,22,15,13,29,39,0,334,129
3212,280,208,72,24,47,33,28,64,84,0,727,280
3213,387,288,99,34,65,45,39,88,116,0,1005,387
3214,719,537,182,79,109,80,75,158,218,114,1768,833
3215,1346,1006,340,147,204,151,141,297,406,0,3309,1346
3216,1767,1311,456,200,226,199,198,397,547,0,4819,1767
3217,363,269,94,41,46,41,41,82,112,0,990,363
3218,534,310,224,57,72,66,59,121,159,41,1767,575
3219,408,237,171,43,55,51,45,92,122,2,1350,410
3220,332,193,139,35,45,41,36,75,100,0,1100,332
3221,713,414,299,76,96,88,78,161,214,301,2359,1014
3222,959,807,152,112,129,112,97,214,295,22,1789,981
3223,907,607,300,108,128,110,107,207,247,7,2567,914
3224,1673,1120,553,199,235,204,197,382,456,10,4735,1683
3225,3641,3025,616,372,483,393,334,787,1272,0,8165,3641
3226,435,231,204,47,60,47,54,95,132,21,1527,456
3227,296,157,139,32,41,32,37,64,90,65,1039,361
3228,656,412,244,61,84,77,78,135,221,0,1842,656
3229,434,295,139,37,55,42,56,98,146,0,1208,434
3230,389,315,74,43,46,54,42,82,122,0,1032,389
3231,343,277,66,38,41,47,37,72,108,0,909,343
3232,186,150,36,21,22,26,20,39,58,8,494,194
3233,104,69,35,10,15,11,12,22,34,0,271,104
3234,531,354,177,52,75,57,62,112,173,13,1384,544
3235,377,252,125,37,53,40,44,79,124,0,983,377
3236,590,394,196,57,84,63,69,124,193,0,1536,590
3237,735,462,273,65,114,87,86,157,226,0,2016,735
3238,1011,636,375,89,157,119,118,216,312,0,2771,1011
3239,1645,1035,610,145,256,194,192,351,507,0,4510,1645
3240,1059,771,288,101,132,130,111,216,369,11,2608,1070
3241,575,418,157,55,72,70,60,117,201,0,1415,575
3242,669,487,182,64,83,82,70,137,233,2,1647,671
3243,285,225,60,27,46,31,34,59,88,0,624,285
3244,276,217,59,26,44,30,33,57,86,1,606,277
3245,227,171,56,20,34,25,25,50,73,0,548,227
3246,453,382,71,34,58,48,46,109,158,0,1094,453
3247,397,335,62,30,51,42,40,95,139,0,958,397
3248,354,298,56,27,46,38,36,85,122,0,855,354
3249,387,288,99,28,60,35,46,89,129,6,1008,393
3250,438,275,163,40,56,51,52,90,149,236,1229,674
3251,3616,2345,1271,316,472,409,401,837,1181,287,11156,3903
3252,140,88,52,11,21,13,16,33,46,0,399,140
3253,1701,1513,188,89,97,138,141,345,891,273,3385,1974
3254,2614,1864,750,145,202,231,206,494,1336,122,6800,2736
3255,2688,2038,650,145,197,235,245,497,1369,493,6546,3181
3256,685,578,107,21,43,60,47,153,361,6,1579,691
3257,1007,705,302,37,80,79,62,196,553,0,2497,1007
3258,2748,1924,824,135,196,222,210,513,1472,38,7294,2786
3259,3101,2334,767,174,235,240,236,627,1589,42,7969,3143
3260,2147,1544,603,126,175,193,157,451,1045,18,5354,2165
3261,1503,1201,302,89,104,112,142,240,816,10,3634,1513
3262,3205,2468,737,259,314,295,236,627,1474,0,8169,3205
3263,959,733,226,38,70,62,85,193,511,0,2350,959
3264,723,524,199,42,60,65,53,146,357,0,1907,723
3265,2354,1743,611,130,160,189,183,451,1241,116,6065,2470
3266,1380,1189,191,95,97,145,127,235,681,481,2605,1861
3267,2026,1576,450,120,128,161,167,343,1107,234,4939,2260
3268,2654,2164,490,133,191,227,220,493,1390,53,6529,2707
3269,523,453,70,37,39,52,34,103,258,83,1156,606
3270,1479,1174,305,97,97,104,111,281,789,22,3316,1501
3271,2812,2081,731,158,170,169,241,598,1476,116,7336,2928
3272,186,157,29,7,12,20,9,42,96,0,445,186
3273,1242,1038,204,103,110,141,101,258,529,8,2475,1250
3274,2326,1832,494,293,411,173,169,379,901,38,5267,2364
3275,1699,1282,417,75,125,132,115,338,914,24,3823,1723
3276,2601,2096,505,128,213,220,202,512,1326,10,5817,2611
3277,1382,1060,322,83,107,93,98,277,724,0,3247,1382
3278,2283,1853,430,141,158,163,167,470,1184,35,5036,2318
3279,898,582,316,54,57,43,84,191,469,73,2664,971
3280,2436,2077,359,144,181,184,187,476,1264,0,5357,2436
3281,553,469,84,36,35,36,35,118,293,362,1216,915
3282,2211,1822,389,101,156,126,178,435,1215,0,5333,2211
3283,1529,1290,239,101,126,122,125,311,744,86,3170,1615
3284,613,505,108,39,48,52,43,132,299,10,1446,623
3285,7369,3315,4054,539,798,612,699,1398,3323,89,29777,7458
3286,2257,2014,243,158,168,167,162,475,1127,171,4726,2428
3287,2214,1800,414,141,173,168,180,437,1115,0,5241,2214
3288,2343,1950,393,143,165,192,191,449,1203,343,4947,2686
3289,1212,817,395,97,102,107,79,252,575,0,2854,1212
3290,305,285,20,20,22,27,22,59,155,161,671,466
3291,2017,1553,464,111,142,115,155,420,1074,20,4973,2037
3292,2593,2189,404,161,195,190,186,489,1372,13,5547,2606
3293,1811,1388,423,118,141,127,154,366,905,0,4220,1811
3294,1121,980,141,65,61,59,97,206,633,0,2516,1121
3295,2291,1785,506,140,166,166,197,453,1169,0,5547,2291
3296,0,0,0,0,0,0,0,0,0,0,0,0
3297,2974,2554,420,200,202,194,234,591,1553,53,6796,3027
3298,2618,2040,578,147,184,166,215,559,1347,0,6499,2618
3299,2134,1803,331,161,148,181,159,414,1071,0,4368,2134
3300,2209,1797,412,139,156,154,183,451,1126,8,5106,2217
3301,3419,2667,752,199,292,235,259,697,1737,20,8108,3439
3302,2029,1593,436,117,171,139,161,391,1050,0,4852,2029
3303,5184,4881,303,353,409,440,408,1011,2563,18,8922,5202
3304,286,200,86,11,23,22,17,56,157,0,710,286
3305,530,378,152,29,41,47,42,100,271,0,1380,530
3306,347,247,100,19,27,31,27,66,177,0,903,347
3307,860,613,247,48,66,76,68,162,440,15,2238,875
3308,515,374,141,30,42,46,37,104,256,1,1358,516
3309,4900,3773,1127,396,481,451,361,959,2252,137,12492,5037
3310,823,658,165,49,57,62,78,132,445,0,1988,823
3311,1867,1609,258,128,131,197,172,319,920,0,3523,1867
3312,4520,3913,607,320,337,446,292,887,2238,0,9982,4520
3313,783,678,105,55,58,77,51,154,388,139,1728,922
3314,1030,892,138,73,77,102,67,202,509,25,2274,1055
3315,144,125,19,10,11,14,9,28,72,0,318,144
3316,167,145,22,12,12,16,11,33,83,122,369,289
3317,404,314,90,24,25,32,33,68,222,27,985,431
3318,697,594,103,41,52,53,53,136,362,0,1532,697
3319,887,756,131,52,66,67,68,173,461,28,1951,915
3320,2161,1834,327,141,135,142,137,461,1145,675,4753,2836
3321,1379,620,759,101,149,114,131,262,622,55,5573,1434
3322,1528,1259,269,97,119,130,106,328,748,3,3602,1531
3323,703,627,76,49,52,52,51,148,351,0,1471,703
3324,571,510,61,40,43,42,41,120,285,0,1195,571
3325,178,150,28,11,13,13,13,34,94,0,380,178
3326,265,224,41,16,20,19,19,50,141,0,566,265
3327,279,227,52,18,22,21,23,55,140,0,662,279
3328,1774,1359,415,115,138,125,151,359,886,0,4133,1774
3329,87,67,20,6,7,6,7,18,43,0,202,87
3330,1522,1284,238,101,125,122,124,309,741,464,3156,1986
3331,331,279,52,22,27,26,27,67,162,5,686,336
3332,352,290,62,22,27,30,24,76,173,0,829,352
