TAZ,HHLESSGQ,HHCHILDNO,HHCHILDYES,HHINC1,HHINC2,HHINC3,HHINC4,HHINC5,HHINC6,HHGQYES,HHGQNO,HHBASE
1,700,681,19,204,145,48,45,80,178,4,853,704
2,588,266,322,330,230,12,11,3,2,19,1479,607
3,2506,2362,144,951,563,174,149,173,496,15,4156,2521
4,2201,2078,123,525,294,215,197,222,748,0,3799,2201
5,2993,2940,53,731,411,247,254,265,1085,4,4262,2997
6,1135,1102,33,286,169,117,113,106,344,15,2044,1150
7,433,395,38,164,81,40,39,30,79,0,861,433
8,695,683,12,177,96,64,68,68,222,0,971,695
9,3102,2435,667,179,85,126,235,517,1960,326,8565,3428
10,2267,2231,36,336,124,190,117,280,1220,77,4141,2344
11,787,717,70,299,147,72,72,55,142,0,1371,787
12,612,603,9,201,114,71,67,54,105,0,774,612
13,562,553,9,185,104,65,61,50,97,0,781,562
14,901,881,20,406,141,123,55,61,115,251,1023,1152
15,491,480,11,221,77,67,30,33,63,0,760,491
16,1150,1125,25,518,180,157,70,77,148,217,1344,1367
17,1136,1111,25,512,177,156,69,76,146,0,1201,1136
18,1164,1126,38,667,193,100,31,56,117,291,1344,1455
19,1133,1096,37,649,188,98,30,55,113,156,1415,1289
20,1038,1017,21,511,205,72,45,55,150,75,1424,1113
21,1680,1651,29,396,231,117,92,165,679,114,2425,1794
22,994,977,17,234,137,69,54,98,402,27,1291,1021
23,2421,2382,39,359,133,203,125,299,1302,39,3289,2460
24,884,870,14,291,164,103,96,79,151,303,1122,1187
25,1372,1351,21,452,255,159,149,122,235,0,1742,1372
26,1749,1689,60,702,311,275,114,141,206,63,2496,1812
27,1149,1110,39,461,205,180,75,92,136,0,1610,1149
28,1693,1635,58,679,301,266,111,136,200,530,2277,2223
29,1183,1150,33,525,211,175,69,86,117,11,1665,1194
30,1655,1609,46,734,295,245,96,121,164,102,2458,1757
31,480,467,13,213,86,71,28,35,47,345,563,825
32,574,557,17,145,86,59,57,54,173,0,848,574
33,1046,1015,31,264,156,108,104,98,316,0,1416,1046
34,983,976,7,339,210,49,45,67,273,5,1647,988
35,715,641,74,215,126,76,83,60,155,0,1188,715
36,733,657,76,221,129,78,86,62,157,2,1226,735
37,754,676,78,227,133,80,88,64,162,0,1028,754
38,475,433,42,180,89,44,43,33,86,0,1023,475
39,918,836,82,349,172,85,83,64,165,0,1598,918
40,1650,1604,46,732,294,244,96,120,164,101,2054,1751
41,1194,1161,33,530,213,177,70,87,117,35,1459,1229
42,1617,1564,53,926,269,139,43,78,162,1501,2367,3118
43,1088,1053,35,623,181,94,29,53,108,87,1216,1175
44,1072,972,100,305,186,122,116,90,253,0,1674,1072
45,851,771,80,242,148,97,92,71,201,0,1386,851
46,765,693,72,218,133,87,82,64,181,0,1194,765
47,1060,1042,18,269,147,98,104,103,339,0,1557,1060
48,1138,1119,19,289,158,105,112,111,363,0,1475,1138
49,600,548,52,156,100,56,60,57,171,0,864,600
50,1061,970,91,276,177,100,107,101,300,2,1861,1063
51,1143,1045,98,297,191,107,115,109,324,9,1820,1152
52,1280,1260,20,419,250,118,124,109,260,16,1757,1296
53,1431,1409,22,469,279,132,139,122,290,0,1838,1431
54,720,709,11,236,141,66,70,61,146,2,821,722
55,889,864,25,284,163,88,91,83,180,0,1150,889
56,394,383,11,126,72,39,40,37,80,3,606,397
57,757,736,21,242,139,75,78,71,152,0,1174,757
58,666,602,64,262,133,56,56,50,109,0,1282,666
59,963,871,92,379,193,81,81,73,156,2,1242,965
60,1460,1429,31,392,201,86,82,152,547,20,1884,1480
61,755,739,16,285,149,94,59,56,112,236,1013,991
62,335,324,11,109,19,27,9,33,138,14,474,349
63,202,198,4,66,14,16,8,19,79,5,245,207
64,807,726,81,252,162,79,67,80,167,13,1430,820
65,671,660,11,324,81,67,23,53,123,339,749,1010
66,1300,1279,21,628,157,129,44,102,240,0,1696,1300
67,1979,1947,32,955,239,197,68,155,365,42,2719,2021
68,1273,1260,13,380,313,118,100,113,249,41,1983,1314
69,2161,2124,37,509,297,150,118,213,874,203,3075,2364
70,1454,1425,29,534,237,209,92,128,254,39,1771,1493
71,1316,1289,27,484,215,189,83,116,229,46,1766,1362
72,1615,1581,34,609,319,201,126,120,240,429,2093,2044
73,754,742,12,270,104,51,48,50,231,1,1015,755
74,1162,1043,119,392,236,108,92,97,237,12,2211,1174
75,681,611,70,230,138,63,54,57,139,0,1208,681
76,2201,2159,42,1006,367,293,125,143,267,67,2141,2268
77,1087,1066,21,497,181,144,62,71,132,27,2639,1114
78,1630,1597,33,803,321,114,70,86,236,57,2334,1687
79,831,814,17,409,164,58,36,44,120,3,779,834
80,1490,1460,30,157,118,107,104,175,829,9,2087,1499
81,254,249,5,59,74,25,20,21,55,168,350,422
82,288,284,4,75,37,28,23,34,91,13,325,301
83,190,182,8,62,21,12,5,15,75,4,269,194
84,393,391,2,94,52,31,27,37,152,8,747,401
85,320,311,9,110,39,45,16,22,88,46,452,366
86,86,84,2,35,12,7,3,7,22,7,124,93
87,37,37,0,8,4,3,2,4,16,1,53,38
88,1090,1078,12,325,268,101,85,97,214,183,1913,1273
89,331,324,7,35,26,24,23,39,184,165,453,496
90,378,370,8,88,110,36,30,31,83,15,568,393
91,311,305,6,73,90,30,24,26,68,6,531,317
92,2189,2122,67,420,258,245,226,257,783,16,3038,2205
93,4021,3954,67,821,553,366,339,423,1519,79,5656,4100
94,3322,3248,74,654,421,350,328,444,1125,28,4527,3350
95,2541,2463,78,561,311,285,247,265,872,3,4122,2544
96,672,656,16,163,82,66,59,69,233,0,1081,672
97,2457,2130,327,388,385,236,242,302,904,96,5026,2553
98,1678,1439,239,279,261,157,147,186,648,17,3505,1695
99,1707,1463,244,236,259,178,170,198,666,0,3398,1707
100,60,54,6,6,10,6,6,10,22,0,84,60
101,290,234,56,25,30,29,31,40,135,0,638,290
102,807,693,114,134,119,77,71,80,326,0,1389,807
103,831,721,110,140,117,68,69,85,352,0,1629,831
104,442,384,58,74,62,36,37,45,188,0,848,442
105,431,374,57,72,61,35,36,44,183,3,847,434
106,616,535,81,104,87,51,51,63,260,0,1087,616
107,741,639,102,123,99,69,65,80,305,0,1370,741
108,682,588,94,113,91,63,60,74,281,23,1294,705
109,518,447,71,86,69,48,46,56,213,12,1029,530
110,829,715,114,137,111,77,73,90,341,0,1556,829
111,941,808,133,159,148,85,92,101,356,17,1591,958
112,958,823,135,162,151,87,94,103,361,31,1638,989
113,886,761,125,149,140,80,87,96,334,0,1499,886
114,219,176,43,19,22,22,23,30,103,0,490,219
115,453,365,88,39,46,45,48,62,213,0,926,453
116,698,601,97,119,115,57,59,77,271,0,1438,698
117,689,593,96,117,114,56,59,76,267,6,1350,695
118,1119,963,156,190,185,92,95,123,434,7,2067,1126
119,603,512,91,95,90,56,57,63,242,2,1136,605
120,874,742,132,138,130,81,83,92,350,0,1616,874
121,490,416,74,78,73,46,47,51,195,0,920,490
122,523,444,79,83,78,49,50,55,208,0,1116,523
123,806,684,122,128,120,75,77,85,321,6,1407,812
124,753,644,109,110,119,68,66,87,303,3,1420,756
125,617,528,89,90,98,56,54,72,247,6,1327,623
126,516,441,75,75,82,47,45,60,207,2,1056,518
127,701,600,101,103,111,64,61,81,281,0,1306,701
128,573,488,85,95,77,64,57,65,215,0,1200,573
129,788,677,111,131,116,75,69,78,319,5,1397,793
130,611,525,86,102,90,58,54,60,247,0,1143,611
131,688,586,102,114,93,76,68,78,259,3,1360,691
132,451,391,60,71,71,43,44,56,166,9,1123,460
133,761,727,34,228,202,70,54,60,147,35,1136,796
134,851,623,228,53,42,116,97,163,380,7,2129,858
135,589,563,26,177,156,54,42,46,114,6,845,595
136,876,837,39,263,232,81,63,69,168,9,1153,885
137,480,409,71,80,65,53,47,54,181,0,1095,480
138,1058,1040,18,267,165,98,102,114,312,112,1411,1170
139,1533,1506,27,387,239,142,148,166,451,2,1995,1535
140,877,862,15,221,136,81,85,95,259,55,1186,932
141,809,795,14,204,126,75,78,88,238,0,1156,809
142,163,143,20,39,29,14,13,15,53,0,302,163
143,927,812,115,222,167,81,73,86,298,0,1685,927
144,796,698,98,191,144,70,62,74,255,152,1578,948
145,774,678,96,186,140,68,61,72,247,57,1317,831
146,943,826,117,226,170,83,74,88,302,56,1532,999
147,751,692,59,166,149,74,58,73,231,57,1375,808
148,622,573,49,138,123,61,48,61,191,0,1045,622
149,657,605,52,146,130,65,51,64,201,0,837,657
150,1010,930,80,224,200,99,78,99,310,24,1256,1034
151,612,564,48,136,121,60,47,60,188,134,1027,746
152,661,609,52,146,131,65,51,65,203,80,864,741
153,675,606,69,97,101,71,61,78,267,0,1136,675
154,577,518,59,83,87,61,52,66,228,135,1014,712
155,691,621,70,100,104,73,62,80,272,3,1132,694
156,348,313,35,50,52,37,31,40,138,0,643,348
157,879,790,89,127,132,93,79,101,347,24,1546,903
158,652,637,15,158,80,64,58,67,225,0,1010,652
159,693,677,16,168,85,68,61,71,240,0,1056,693
160,878,858,20,213,107,86,78,90,304,0,1225,878
161,447,382,65,58,46,48,48,54,193,0,802,447
162,654,605,49,99,54,72,83,85,261,45,1170,699
163,335,310,25,51,28,37,43,43,133,4,541,339
164,1352,1252,100,205,112,149,172,175,539,0,1641,1352
165,321,274,47,41,33,35,35,39,138,0,693,321
166,531,454,77,69,55,57,57,64,229,323,745,854
167,276,236,40,36,29,30,30,33,118,0,610,276
168,541,462,79,70,56,58,59,66,232,0,911,541
169,776,720,56,131,83,98,97,101,266,0,1312,776
170,792,735,57,134,85,101,99,103,270,0,1228,792
171,479,445,34,81,51,61,60,63,163,0,738,479
172,765,749,16,161,73,87,82,107,255,52,1020,817
173,924,904,20,194,88,105,99,129,309,0,1161,924
174,1130,1129,1,287,195,104,85,114,345,132,1371,1262
175,656,655,1,167,113,60,49,66,201,14,787,670
176,477,461,16,151,109,41,41,33,102,0,772,477
177,841,813,28,266,192,72,72,59,180,0,1324,841
178,1229,1188,41,388,280,105,105,86,265,0,1551,1229
179,601,562,39,88,81,61,52,72,247,0,1029,601
180,499,466,33,73,67,50,43,60,206,36,848,535
181,651,584,67,132,102,52,50,66,249,0,1030,651
182,625,561,64,127,98,50,48,64,238,0,1019,625
183,514,461,53,104,81,41,39,52,197,0,832,514
184,979,879,100,199,153,79,75,100,373,0,1399,979
185,835,749,86,169,131,67,64,85,319,2,1453,837
186,360,352,8,100,67,23,27,34,109,6,663,366
187,1300,1271,29,362,241,84,99,122,392,149,1516,1449
188,987,965,22,275,183,64,75,92,298,0,1131,987
189,482,439,43,79,72,46,48,48,189,2,873,484
190,413,376,37,68,62,39,41,41,162,16,722,429
191,671,611,60,110,101,64,66,66,264,0,1199,671
192,513,492,21,75,75,39,42,53,229,3180,893,3693
193,585,561,24,85,86,44,47,61,262,3,1146,588
194,1068,1024,44,156,156,81,87,111,477,19,1979,1087
195,733,703,30,107,107,56,59,76,328,9,1237,742
196,1054,947,107,350,267,76,65,90,206,9,1720,1063
197,1195,1074,121,397,302,86,74,102,234,0,2042,1195
198,1925,1887,38,623,491,172,164,136,339,20,2450,1945
199,775,685,90,380,279,19,18,20,59,0,1399,775
200,1157,1023,134,568,417,28,27,31,86,0,1684,1157
201,413,365,48,203,149,10,10,11,30,13,871,426
202,405,358,47,199,146,10,10,11,29,0,745,405
203,397,355,42,84,89,36,33,32,123,0,666,397
204,657,587,70,139,148,60,55,54,201,17,1157,674
205,1206,1077,129,255,271,110,101,98,371,103,2204,1309
206,886,844,42,141,167,92,94,89,303,11,1470,897
207,1228,1170,58,196,231,128,130,123,420,30,1920,1258
208,540,501,39,102,98,58,51,57,174,36,938,576
209,663,616,47,125,121,71,63,70,213,68,1242,731
210,556,516,40,105,101,60,53,59,178,26,1047,582
211,728,676,52,137,132,78,69,77,235,179,1453,907
212,809,756,53,145,195,79,72,87,231,12,1454,821
213,493,461,32,88,119,48,44,53,141,68,1012,561
214,636,594,42,114,153,62,57,68,182,12,1238,648
215,763,713,50,136,184,75,68,82,218,21,1280,784
216,692,639,53,86,114,67,55,82,288,25,1155,717
217,878,811,67,109,145,85,70,104,365,0,1531,878
218,878,758,120,130,126,92,93,100,337,5,1497,883
219,1092,943,149,161,156,114,116,124,421,0,1893,1092
220,508,439,69,75,73,53,54,58,195,3,896,511
221,530,458,72,78,76,55,56,60,205,2,987,532
222,578,499,79,85,83,60,61,66,223,2,1080,580
223,583,500,83,97,91,54,51,65,225,6,1163,589
224,814,698,116,136,127,76,71,90,314,0,1666,814
225,544,466,78,91,85,51,48,60,209,69,1067,613
226,499,461,38,62,82,49,40,59,207,84,774,583
227,338,312,26,42,56,33,27,40,140,2,637,340
228,961,918,43,176,175,95,74,98,343,0,1559,961
229,567,542,25,104,103,56,44,58,202,0,928,567
230,1634,1569,65,200,228,184,128,191,703,0,2220,1634
231,529,508,21,65,74,60,41,62,227,0,818,529
232,673,646,27,83,94,76,53,79,288,0,1073,673
233,0,0,0,0,0,0,0,0,0,0,0,0
234,75,55,20,5,4,10,9,14,33,9,188,84
235,550,494,56,79,83,58,50,63,217,0,938,550
236,0,0,0,0,0,0,0,0,0,0,0,0
237,47,47,0,9,7,2,8,4,17,115,55,162
238,516,495,21,75,75,39,42,53,232,74,892,590
239,1252,1197,55,153,171,165,139,174,450,0,1946,1252
240,1469,1311,158,153,187,169,143,196,621,9,2610,1478
241,635,575,60,87,61,81,63,90,253,0,1018,635
242,735,550,185,75,64,101,72,114,309,102,1947,837
243,1565,1495,70,252,222,172,116,177,626,141,2735,1706
244,1221,1067,154,110,106,156,123,169,557,0,2201,1221
245,1151,825,326,119,129,153,113,168,469,50,3177,1201
246,1354,1237,117,103,121,156,125,197,652,0,2888,1354
247,1946,909,1037,268,165,194,130,250,939,0,5835,1946
248,659,592,67,137,122,56,41,62,241,7,974,666
249,1310,1093,217,294,202,122,94,131,467,70,1714,1380
250,1480,1330,150,308,275,126,91,140,540,50,2497,1530
251,1384,1312,72,197,253,120,79,158,577,21,2037,1405
252,465,441,24,66,85,40,27,53,194,5,791,470
253,949,900,49,135,173,82,54,108,397,32,1498,981
254,497,472,25,83,67,56,47,63,181,0,812,497
255,488,464,24,82,66,55,46,62,177,8,729,496
256,985,936,49,165,132,111,93,124,360,4,1381,989
257,903,858,45,151,121,102,85,114,330,0,1430,903
258,538,493,45,74,100,52,37,59,216,3,873,541
259,1146,1050,96,158,212,111,79,127,459,45,1822,1191
260,1497,1372,125,207,277,144,103,165,601,16,2473,1513
261,1163,1004,159,334,92,88,93,124,432,137,2120,1300
262,873,754,119,251,69,66,70,93,324,46,1449,919
263,751,649,102,216,59,57,60,80,279,0,1398,751
264,662,572,90,190,52,50,53,70,247,1,1398,663
265,484,446,38,151,44,28,39,46,176,0,1016,484
266,461,425,36,144,42,27,37,43,168,1,1046,462
267,719,662,57,225,66,41,57,68,262,1,1345,720
268,947,872,75,296,86,54,76,89,346,79,2125,1026
269,520,461,59,77,61,51,39,69,223,211,1014,731
270,885,847,38,133,149,76,84,101,342,0,1756,885
271,484,422,62,142,1,18,80,56,187,29,1334,513
272,484,315,169,59,54,82,46,57,186,14,1628,498
273,462,268,194,95,72,68,37,49,141,102,1395,564
274,455,206,249,255,178,9,9,2,2,0,1038,455
275,844,748,96,124,99,83,63,112,363,47,1400,891
276,563,499,64,83,66,56,42,75,241,0,1065,563
277,561,497,64,83,66,55,42,75,240,9,1075,570
278,415,371,44,51,68,51,40,51,154,0,806,415
279,502,448,54,62,82,61,48,62,187,0,946,502
280,618,552,66,77,102,75,60,76,228,0,1186,618
281,508,454,54,63,83,62,49,63,188,2,834,510
282,433,384,49,61,66,51,42,56,157,4,776,437
283,739,655,84,105,113,87,72,95,267,0,1347,739
284,631,559,72,89,96,75,61,81,229,0,1231,631
285,618,544,74,87,103,86,58,68,216,0,1080,618
286,439,386,53,62,73,61,41,48,154,0,732,439
287,490,431,59,69,81,68,46,54,172,0,812,490
288,504,443,61,71,84,70,48,55,176,0,861,504
289,534,470,64,75,89,75,50,59,186,87,909,621
290,842,763,79,115,81,107,84,119,336,0,1539,842
291,674,611,63,92,65,86,67,96,268,0,1113,674
292,675,646,29,102,114,58,64,77,260,0,1170,675
293,423,405,18,64,71,36,40,48,164,0,912,423
294,505,476,29,73,53,60,52,66,201,0,919,505
295,345,326,19,50,36,41,36,45,137,0,669,345
296,495,345,150,54,51,71,54,66,199,71,1571,566
297,630,442,188,71,89,92,66,72,240,9,1951,639
298,206,120,86,54,27,32,14,26,53,251,485,457
299,3930,2185,1745,1647,1273,254,314,140,302,0,8600,3930
300,569,537,32,82,60,68,59,74,226,41,981,610
301,555,524,31,80,59,66,57,72,221,0,983,555
302,1089,1035,54,138,66,74,76,137,598,1,2306,1090
303,624,593,31,79,38,42,44,78,343,3,923,627
304,939,739,200,238,89,68,71,100,373,21,1964,960
305,919,723,196,233,87,66,70,98,365,26,2151,945
306,605,579,26,101,44,57,45,80,278,1,1174,606
307,931,733,198,236,88,67,70,100,370,12,2210,943
308,741,566,175,199,71,49,67,74,281,21,2023,762
309,869,757,112,255,1,32,144,101,336,9,1906,878
310,465,405,60,137,1,17,77,54,179,0,1217,465
311,608,465,143,163,58,40,55,61,231,31,1820,639
312,213,186,27,48,32,22,19,19,73,11,402,224
313,498,380,118,134,48,33,45,50,188,0,1582,498
314,452,315,137,68,63,61,41,57,162,95,1146,547
315,413,288,125,62,58,56,37,52,148,33,1072,446
316,490,319,171,60,55,83,46,58,188,45,1649,535
317,390,276,114,82,64,54,31,46,113,14,896,404
318,352,229,123,43,39,60,33,42,135,0,1125,352
319,317,249,68,29,39,36,30,45,138,0,746,317
320,395,310,85,27,50,61,32,65,160,7,991,402
321,328,257,71,22,42,51,27,54,132,0,825,328
322,437,240,197,88,68,60,35,53,133,31,1269,468
323,527,289,238,106,81,72,43,63,162,14,1597,541
324,541,448,93,52,72,65,56,74,222,84,1338,625
325,485,402,83,47,64,59,50,67,198,30,1109,515
326,527,314,213,51,97,50,46,63,220,0,1386,527
327,589,306,283,148,127,44,28,56,186,0,1952,589
328,375,195,180,94,81,28,18,36,118,0,1217,375
329,318,266,52,35,47,46,28,43,119,30,777,348
330,625,524,101,68,92,90,56,84,235,50,1478,675
331,420,352,68,46,62,61,37,57,157,44,935,464
332,497,412,85,48,66,60,52,68,203,196,1225,693
333,597,470,127,54,73,67,56,85,262,6,1478,603
334,509,401,108,46,62,57,47,73,224,0,1237,509
335,549,446,103,59,80,63,52,74,221,0,1165,549
336,758,615,143,81,111,87,71,103,305,0,1677,758
337,588,477,111,63,86,68,55,80,236,0,1442,588
338,503,408,95,54,74,58,47,68,202,5,1211,508
339,267,217,50,29,39,31,25,36,107,0,674,267
340,486,323,163,43,60,64,56,64,199,28,1463,514
341,254,169,85,23,32,33,29,34,103,0,750,254
342,428,285,143,38,53,56,49,57,175,31,1278,459
343,397,264,133,35,49,52,46,53,162,18,1189,415
344,417,277,140,37,52,55,48,55,170,78,1330,495
345,647,536,111,63,86,78,67,89,264,48,1316,695
346,748,624,124,83,146,84,69,95,271,21,1596,769
347,509,424,85,56,99,57,47,64,186,22,1025,531
348,378,315,63,42,74,42,35,48,137,11,920,389
349,388,323,65,43,76,43,36,49,141,63,782,451
350,377,296,81,26,48,58,31,62,152,7,887,384
351,665,500,165,68,92,101,54,93,257,0,1917,665
352,681,511,170,124,247,68,51,44,147,5,1708,686
353,801,603,198,82,111,122,65,111,310,30,2463,831
354,431,323,108,78,156,43,32,28,94,0,1173,431
355,608,486,122,45,54,88,72,78,271,47,1619,655
356,477,350,127,49,76,50,52,64,186,35,1278,512
357,403,296,107,42,64,42,44,54,157,0,1132,403
358,465,341,124,48,74,48,50,62,183,0,1385,465
359,585,429,156,60,93,61,63,78,230,0,1566,585
360,362,266,96,37,58,38,39,49,141,63,1082,425
361,324,238,86,33,51,34,35,43,128,8,931,332
362,477,344,133,45,42,66,47,65,212,9,1432,486
363,456,329,127,43,40,63,45,62,203,0,1352,456
364,344,248,96,32,31,48,34,47,152,5,929,349
365,347,250,97,33,31,48,34,47,154,0,955,347
366,263,190,73,38,27,34,21,30,113,41,631,304
367,388,280,108,57,40,49,31,45,166,0,951,388
368,553,414,139,57,48,76,54,86,232,12,1544,565
369,172,129,43,18,15,24,17,27,71,0,469,172
370,735,484,251,84,90,104,60,101,296,0,2389,735
371,738,515,223,89,100,93,75,92,289,0,2319,738
372,810,557,253,82,103,102,108,105,310,0,2526,810
373,541,356,185,62,66,76,44,75,218,7,1775,548
374,384,307,77,28,34,55,46,49,172,0,1089,384
375,827,624,203,143,224,54,59,87,260,4,2580,831
376,264,199,65,46,72,17,19,28,82,0,738,264
377,533,402,131,92,145,35,38,56,167,0,1691,533
378,365,275,90,63,99,24,26,38,115,0,1070,365
379,505,348,157,50,69,57,56,69,204,18,1602,523
380,379,261,118,37,52,43,42,52,153,13,1239,392
381,343,236,107,34,47,39,38,47,138,0,1168,343
382,337,232,105,33,46,38,37,46,137,25,1135,362
383,316,217,99,31,43,36,35,43,128,51,1065,367
384,297,206,91,29,24,45,32,39,128,0,994,297
385,371,259,112,45,50,47,38,46,145,13,1106,384
386,373,259,114,36,30,57,40,49,161,0,1367,373
387,363,260,103,38,41,48,36,53,147,0,1078,363
388,297,207,90,36,40,37,30,37,117,2,911,299
389,464,322,142,45,37,70,50,62,200,0,1610,464
390,660,458,202,71,61,90,60,82,296,0,1780,660
391,498,332,166,64,83,79,44,54,174,32,1413,530
392,547,364,183,70,91,87,48,59,192,0,1616,547
393,465,424,41,64,86,48,41,50,176,49,940,514
394,658,600,58,90,121,68,58,70,251,134,1234,792
395,467,426,41,64,86,48,41,50,178,2,938,469
396,760,693,67,104,140,78,67,81,290,19,1245,779
397,1075,1024,51,165,127,129,105,134,415,668,1736,1743
398,858,817,41,131,101,103,84,107,332,0,1543,858
399,522,506,16,69,29,40,27,65,292,12,695,534
400,485,475,10,96,19,41,19,72,238,0,779,485
401,555,535,20,130,49,42,34,59,241,0,962,555
402,416,396,20,64,49,50,41,52,160,0,739,416
403,1558,1126,432,142,252,137,101,208,718,0,3278,1558
404,534,386,148,49,86,47,34,71,247,0,1504,534
405,228,201,27,50,31,30,28,19,70,0,436,228
406,1484,1419,65,181,203,195,165,207,533,0,2289,1484
407,532,468,64,117,72,71,65,45,162,24,1218,556
408,647,619,28,108,47,61,48,85,298,0,1189,647
409,12,10,2,3,2,1,1,1,4,173,21,185
410,500,353,147,105,82,69,39,58,147,2,1358,502
411,316,223,93,66,52,44,25,37,92,69,751,385
412,859,568,291,107,92,120,76,107,357,0,2362,859
413,423,280,143,53,45,59,37,53,176,0,1146,423
414,434,326,108,79,157,43,33,28,94,26,1087,460
415,611,420,191,58,50,91,65,86,261,0,1994,611
416,754,519,235,72,62,112,81,107,320,0,2266,754
417,852,586,266,86,108,108,114,111,325,8,2584,860
418,771,540,231,87,108,112,81,89,294,21,2510,792
419,560,388,172,60,51,76,51,69,253,19,1677,579
420,402,219,183,48,53,63,30,47,161,12,1471,414
421,296,162,134,36,39,47,22,35,117,0,1020,296
422,523,287,236,105,81,71,42,63,161,94,1692,617
423,619,592,27,76,85,81,69,86,222,0,1026,619
424,479,458,21,59,65,63,53,67,172,0,742,479
425,765,732,33,93,105,101,85,106,275,2,1367,767
426,971,930,41,196,81,96,77,130,391,5,1652,976
427,887,849,38,179,74,87,70,119,358,0,1611,887
428,541,377,164,59,56,78,59,72,217,33,1615,574
429,377,263,114,41,39,54,41,50,152,2,1134,379
430,360,251,109,39,37,52,39,48,145,16,1152,376
431,416,290,126,46,43,60,45,55,167,14,1226,430
432,789,562,227,86,107,87,73,97,339,27,2536,816
433,617,440,177,67,84,68,57,76,265,33,1861,650
434,292,208,84,32,40,32,27,36,125,13,858,305
435,386,275,111,42,52,43,36,47,166,0,1171,386
436,469,334,135,51,64,52,43,58,201,0,1490,469
437,534,381,153,58,72,59,49,66,230,0,1763,534
438,913,537,376,164,137,116,61,101,334,164,2716,1077
439,733,681,52,188,103,71,67,71,233,8,1346,741
440,1635,1364,271,367,253,152,118,164,581,109,1904,1744
441,979,817,162,220,151,91,70,98,349,124,1931,1103
442,58,54,4,15,8,6,5,6,18,156,99,214
443,900,751,149,202,139,84,65,90,320,17,1663,917
444,1688,1517,171,352,314,143,104,160,615,78,2527,1766
445,1336,1187,149,364,37,125,90,163,557,5,2891,1341
446,1472,1308,164,401,41,138,99,180,613,10,2804,1482
447,674,599,75,184,19,63,45,82,281,0,1324,674
448,12,11,1,2,1,2,1,2,4,29,14,41
449,567,396,171,62,58,81,62,75,229,2,1732,569
450,0,0,0,0,0,0,0,0,0,0,0,0
451,72,66,6,10,8,11,5,11,27,13,134,85
452,2513,2421,92,587,224,191,155,267,1089,106,4388,2619
453,585,544,41,150,82,57,53,56,187,68,1372,653
454,330,307,23,85,46,32,30,32,105,5,623,335
455,0,0,0,0,0,0,0,0,0,0,0,0
456,63,59,4,16,9,6,6,6,20,12,143,75
457,676,662,14,133,27,57,27,101,331,114,1080,790
458,1416,1364,52,331,126,108,87,151,613,19,2257,1435
459,164,159,5,22,9,13,9,20,91,132,197,296
460,174,152,22,39,27,18,16,16,58,0,383,174
461,336,294,42,75,51,35,30,30,115,0,782,336
462,15,14,1,2,1,1,1,2,8,0,50,15
463,1395,1326,69,176,85,94,98,175,767,20,3198,1415
464,303,288,15,38,18,20,21,38,168,2,694,305
465,278,264,14,35,17,19,19,35,153,0,344,278
466,0,0,0,0,0,0,0,0,0,0,0,0
467,141,129,12,19,16,22,10,22,52,0,150,141
468,0,0,0,0,0,0,0,0,0,0,0,0
469,0,0,0,0,0,0,0,0,0,2,1,2
470,46,42,4,6,5,7,3,7,18,3,80,49
471,8,7,1,1,1,1,1,1,3,12,12,20
472,0,0,0,0,0,0,0,0,0,0,0,0
473,67,61,6,9,8,10,5,10,25,0,154,67
474,560,333,227,194,139,84,44,35,64,0,1469,560
475,970,576,394,336,240,145,76,61,112,12,2301,982
476,1029,466,563,577,403,20,20,5,4,2,3110,1031
477,226,135,91,22,41,21,20,27,95,0,671,226
478,813,485,328,79,149,77,71,98,339,0,2397,813
479,399,207,192,100,86,30,19,38,126,0,1048,399
480,484,251,233,122,104,37,23,46,152,0,1502,484
481,241,132,109,49,37,33,19,29,74,1,690,242
482,63,44,19,6,5,10,7,8,27,0,221,63
483,1612,1165,447,147,260,142,104,215,744,0,3222,1612
484,886,641,245,81,143,78,57,118,409,5,2552,891
485,313,236,77,54,85,21,22,33,98,13,985,326
486,382,288,94,66,104,25,27,40,120,0,1060,382
487,259,190,69,27,41,27,28,35,101,0,739,259
488,710,649,61,54,63,82,66,103,342,0,1518,710
489,682,623,59,52,61,79,63,99,328,0,1472,682
490,360,347,13,84,32,27,22,38,157,991,630,1351
491,612,494,118,43,50,64,73,69,313,0,1312,612
492,849,749,100,70,54,61,74,124,466,0,1766,849
493,806,649,157,89,126,82,75,85,349,46,1693,852
494,246,198,48,27,39,25,23,26,106,7,575,253
495,302,243,59,34,47,31,28,32,130,0,769,302
496,317,255,62,35,50,32,29,33,138,11,748,328
497,411,317,94,39,52,47,42,51,180,2,1058,413
498,293,226,67,28,37,34,30,36,128,0,643,293
499,312,240,72,30,39,36,32,38,137,0,718,312
500,347,267,80,33,44,40,35,43,152,0,807,347
501,520,401,119,50,66,60,53,64,227,11,1188,531
502,285,220,65,27,36,33,29,35,125,0,669,285
503,325,250,75,31,41,37,33,40,143,8,772,333
504,329,271,58,32,57,39,31,38,132,3,765,332
505,585,482,103,57,101,69,55,68,235,0,1189,585
506,329,271,58,32,57,39,31,38,132,8,788,337
507,492,406,86,48,85,58,47,57,197,0,1157,492
508,314,259,55,31,54,37,30,37,125,0,737,314
509,302,249,53,30,52,35,29,35,121,0,722,302
510,289,238,51,28,50,34,27,34,116,0,683,289
511,457,359,98,40,61,55,39,56,206,0,1085,457
512,470,369,101,41,63,56,40,58,212,0,1142,470
513,537,421,116,47,72,64,45,66,243,14,1212,551
514,407,319,88,36,54,49,34,50,184,0,971,407
515,576,452,124,51,77,69,49,71,259,36,1356,612
516,446,350,96,39,60,53,38,55,201,6,1073,452
517,544,463,81,38,62,65,44,76,259,6,1232,550
518,298,254,44,21,34,36,24,42,141,0,610,298
519,382,325,57,27,43,46,31,53,182,0,847,382
520,230,196,34,16,26,28,19,32,109,0,516,230
521,772,650,122,108,127,86,71,92,288,0,1568,772
522,631,531,100,88,104,70,58,75,236,45,1282,676
523,551,446,105,58,72,56,58,70,237,0,1247,551
524,532,430,102,56,70,54,56,67,229,5,1270,537
525,424,343,81,45,55,43,45,54,182,0,1013,424
526,311,252,59,33,41,32,33,39,133,5,841,316
527,349,282,67,37,46,35,37,44,150,0,892,349
528,338,273,65,36,44,34,36,43,145,0,853,338
529,487,394,93,51,64,49,51,62,210,0,1335,487
530,594,500,94,83,98,66,55,71,221,0,1218,594
531,384,308,76,35,40,47,42,54,166,0,977,384
532,342,274,68,31,36,42,37,48,148,0,909,342
533,386,309,77,35,41,47,42,54,167,0,968,386
534,342,274,68,31,36,42,37,48,148,0,899,342
535,523,420,103,52,71,60,51,72,217,0,1230,523
536,364,292,72,36,50,41,36,50,151,24,811,388
537,574,461,113,57,78,65,56,79,239,0,1277,574
538,378,303,75,38,52,43,37,52,156,6,866,384
539,499,401,98,50,68,57,49,69,206,0,1082,499
540,335,269,66,33,46,38,33,46,139,0,748,335
541,485,389,96,52,67,52,54,59,201,0,988,485
542,478,384,94,52,66,51,53,59,197,0,1053,478
543,506,406,100,55,70,54,56,62,209,0,1204,506
544,463,372,91,50,64,50,51,57,191,6,1003,469
545,989,874,115,141,190,100,80,113,365,0,1702,989
546,534,472,62,76,103,54,43,61,197,5,992,539
547,792,682,110,84,100,97,82,105,324,0,1537,792
548,610,539,71,87,117,62,50,70,224,0,1230,610
549,780,694,86,113,159,101,63,90,254,0,1276,780
550,843,750,93,122,172,109,68,97,275,23,1312,866
551,492,424,68,52,62,60,51,65,202,0,1027,492
552,1494,1448,46,153,173,107,98,249,714,1,3168,1495
553,708,610,98,75,89,87,74,94,289,19,1337,727
554,502,412,90,45,56,60,55,64,222,0,1125,502
555,477,411,66,51,60,58,50,63,195,0,922,477
556,498,408,90,45,55,59,55,63,221,0,1129,498
557,282,227,55,27,38,34,28,35,120,0,664,282
558,534,430,104,52,72,65,52,66,227,0,1180,534
559,458,369,89,44,61,56,45,56,196,0,995,458
560,362,292,70,35,49,44,35,45,154,0,778,362
561,309,249,60,22,25,32,37,35,158,11,682,320
562,678,546,132,75,106,69,63,71,294,6,1638,684
563,674,600,74,97,137,87,55,78,220,17,1112,691
564,485,398,87,44,54,58,53,61,215,0,979,485
565,420,314,106,35,43,46,45,64,187,16,1058,436
566,632,473,159,52,65,69,68,96,282,10,1536,642
567,520,389,131,43,54,57,56,79,231,0,1290,520
568,557,417,140,46,57,61,60,85,248,0,1455,557
569,542,406,136,45,56,59,58,82,242,0,1445,542
570,509,381,128,42,52,55,55,77,228,0,1308,509
571,806,676,130,104,131,94,65,93,319,5,1706,811
572,713,598,115,92,116,83,58,82,282,0,1588,713
573,653,548,105,84,107,76,53,75,258,6,1473,659
574,822,689,133,106,134,96,66,95,325,21,1879,843
575,574,481,93,74,94,67,46,66,227,0,1266,574
576,461,387,74,60,75,54,37,53,182,8,1085,469
577,544,448,96,59,71,63,51,69,231,0,1273,544
578,621,511,110,67,80,72,58,79,265,2,1357,623
579,449,369,80,49,58,52,42,57,191,0,1006,449
580,533,439,94,58,69,61,50,68,227,0,1113,533
581,567,467,100,62,73,65,53,72,242,0,1293,567
582,462,380,82,50,60,53,44,59,196,0,1130,462
583,406,325,81,38,53,46,40,54,175,0,1073,406
584,443,355,88,41,58,50,43,59,192,0,1113,443
585,467,374,93,43,61,53,46,62,202,0,1219,467
586,596,478,118,55,78,68,58,80,257,12,1467,608
587,408,327,81,38,53,46,40,55,176,0,1053,408
588,451,361,90,42,59,51,44,60,195,13,1189,464
589,473,379,94,44,62,54,46,63,204,0,1165,473
590,1060,935,125,88,67,76,92,154,583,0,2202,1060
591,422,372,50,35,27,30,37,61,232,0,901,422
592,1147,1012,135,95,72,82,100,167,631,0,2447,1147
593,647,571,76,54,41,46,56,94,356,0,1354,647
594,540,433,107,49,57,66,58,75,235,0,1197,540
595,666,535,131,72,93,72,74,82,273,0,1482,666
596,318,309,9,93,66,22,21,36,80,4,412,322
597,0,0,0,0,0,0,0,0,0,0,0,0
598,321,240,81,27,33,35,34,49,143,0,895,321
599,704,621,83,58,44,50,61,103,388,0,1376,704
600,64,62,2,7,7,5,4,11,30,2871,143,2935
601,145,117,28,16,23,15,13,15,63,0,306,145
602,503,405,98,49,67,61,49,62,215,0,1133,503
603,339,329,10,45,19,26,18,42,189,0,359,339
604,46,45,1,6,3,4,2,6,25,0,148,46
605,1595,1547,48,210,90,122,84,199,890,0,2922,1595
606,21,20,1,3,1,2,1,3,11,0,68,21
607,596,583,13,240,81,49,22,48,156,35,702,631
608,163,159,4,66,22,13,6,13,43,10,257,173
609,136,133,3,55,19,11,5,11,35,5,117,141
610,536,533,3,128,71,42,37,50,208,37,343,573
611,0,0,0,0,0,0,0,0,0,0,0,0
612,176,175,1,42,23,14,12,16,69,0,110,176
613,112,111,1,13,6,9,6,13,65,0,161,112
614,206,204,2,24,11,16,11,23,121,1,220,207
615,313,311,2,71,32,25,19,32,134,9,352,322
616,1040,768,272,103,146,134,123,170,364,0,2300,1040
617,540,443,97,73,61,66,58,83,199,0,1148,540
618,1551,1122,429,167,173,222,198,248,543,256,4071,1807
619,1553,1104,449,105,169,216,183,275,605,0,3669,1553
620,2566,1792,774,61,107,410,322,471,1195,16,5477,2582
621,7,4,3,1,1,1,1,0,3,0,18,7
622,3074,2544,530,72,144,445,431,571,1411,18,5548,3092
623,1269,928,341,102,133,159,155,214,506,0,2942,1269
624,1264,850,414,108,125,166,151,210,504,41,3243,1305
625,2071,1613,458,246,269,292,231,319,714,18,5385,2089
626,1395,976,419,77,81,190,166,273,608,34,4372,1429
627,343,255,88,38,52,53,41,55,104,0,869,343
628,1939,1333,606,191,327,256,252,295,618,7,5204,1946
629,634,416,218,87,102,89,77,85,194,35,1617,669
630,3624,2429,1195,436,519,498,460,616,1095,8,8464,3632
631,1662,1118,544,106,167,227,170,306,686,49,3917,1711
632,1560,1214,346,19,51,246,188,304,752,14,2708,1574
633,1866,1569,297,175,196,282,220,310,683,80,3228,1946
634,1215,900,315,19,36,157,142,252,609,0,2540,1215
635,1414,994,420,17,48,205,189,285,670,0,2805,1414
636,1892,1388,504,67,116,314,268,345,782,0,3925,1892
637,2225,1525,700,63,98,225,262,462,1115,39,5361,2264
638,1668,1178,490,31,65,206,168,309,889,491,3867,2159
639,329,274,55,11,16,39,47,67,149,0,715,329
640,930,762,168,8,16,82,150,250,424,0,2139,930
641,629,501,128,6,10,64,83,163,303,36,1253,665
642,529,455,74,15,21,64,80,111,238,5,975,534
643,310,248,62,28,33,35,36,52,126,16,700,326
644,1999,1340,659,194,333,285,242,277,668,52,5170,2051
645,821,548,273,119,173,91,90,106,242,1,1879,822
646,1237,842,395,172,226,161,131,153,394,121,2948,1358
647,623,360,263,92,149,72,72,67,171,0,1806,623
648,659,513,146,38,46,79,70,118,308,0,1376,659
649,422,314,108,22,33,57,42,73,195,0,893,422
650,313,233,80,16,25,43,31,54,144,2,670,315
651,422,314,108,22,33,57,42,73,195,0,953,422
652,2147,1942,205,380,411,148,132,251,825,0,2345,2147
653,566,394,172,43,52,64,69,93,245,175,1345,741
654,650,376,274,96,156,75,75,70,178,0,1732,650
655,783,533,250,109,143,102,83,97,249,15,1928,798
656,1641,1275,366,224,468,95,129,190,535,1,3565,1642
657,735,500,235,102,134,95,78,91,235,17,1818,752
658,1007,806,201,92,107,113,118,168,409,125,2290,1132
659,331,230,101,25,30,38,40,55,143,86,808,417
660,438,305,133,33,40,50,53,72,190,0,1068,438
661,1563,1141,422,71,102,166,159,284,781,47,3696,1610
662,440,237,203,45,55,61,50,67,162,0,1000,440
663,290,156,134,29,36,40,33,44,108,0,787,290
664,2133,1727,406,129,155,185,205,338,1121,42,4085,2175
665,303,251,52,40,109,31,41,28,54,0,706,303
666,813,554,259,77,112,130,87,116,291,75,1914,888
667,727,626,101,21,29,88,110,153,326,60,1548,787
668,309,247,62,28,33,35,36,52,125,0,674,309
669,295,159,136,30,37,41,33,45,109,45,844,340
670,2321,1523,798,320,373,324,280,311,713,120,6126,2441
671,912,748,164,124,103,112,98,141,334,43,1804,955
672,963,771,192,88,102,108,112,161,392,13,1744,976
673,426,341,85,39,45,48,50,71,173,0,926,426
674,1664,1380,284,221,599,169,223,154,298,0,2680,1664
675,223,167,56,16,42,18,37,33,77,0,505,223
676,373,279,94,27,70,30,62,55,129,0,809,373
677,354,264,90,26,66,29,59,52,122,30,767,384
678,610,450,160,60,85,79,72,100,214,0,1358,610
679,639,430,209,55,63,84,76,106,255,0,1863,639
680,383,290,93,85,119,27,29,36,87,14,848,397
681,302,229,73,67,94,21,23,29,68,0,712,302
682,321,240,81,23,60,26,54,48,110,0,727,321
683,533,331,202,64,60,66,59,82,202,0,1411,533
684,795,493,302,96,89,99,88,122,301,0,2242,795
685,366,246,120,31,36,48,44,61,146,0,1066,366
686,805,513,292,117,207,101,84,95,201,0,2232,805
687,839,535,304,122,216,105,88,99,209,0,2356,839
688,632,403,229,68,244,65,58,63,134,16,1726,648
689,511,326,185,55,197,52,47,51,109,3,1344,514
690,1011,645,366,108,390,104,92,100,217,146,2662,1157
691,498,318,180,53,192,51,45,49,108,10,1362,508
692,1946,1474,472,250,248,262,210,290,686,9,3906,1955
693,788,627,161,114,156,119,57,101,241,0,1666,788
694,2223,1489,734,406,727,177,161,201,551,11,5709,2234
695,873,651,222,83,128,124,95,131,312,0,2032,873
696,332,247,85,32,49,47,36,50,118,8,758,340
697,2451,1855,596,546,765,173,186,232,549,0,4290,2451
698,1068,796,272,101,157,152,117,160,381,13,2395,1081
699,800,656,144,109,90,98,86,124,293,20,1670,820
700,840,573,267,80,116,134,90,120,300,0,1790,840
701,738,503,235,70,102,118,79,106,263,41,1731,779
702,451,334,117,31,41,61,50,75,193,0,1112,451
703,863,638,225,59,79,117,96,144,368,14,2126,877
704,756,559,197,51,69,103,84,126,323,50,2011,806
705,1043,960,83,151,108,150,106,185,343,0,1893,1043
706,1210,899,311,133,185,186,144,196,366,18,2681,1228
707,821,639,182,47,58,99,87,147,383,11,1702,832
708,1109,862,247,152,316,64,87,128,362,0,2106,1109
709,608,473,135,83,173,35,48,70,199,0,1092,608
710,758,632,126,25,37,90,108,154,344,16,1519,774
711,232,193,39,8,11,28,33,47,105,25,512,257
712,342,272,70,3,6,35,45,89,164,0,727,342
713,516,353,163,46,75,69,62,80,184,31,1497,547
714,428,293,135,38,62,57,51,67,153,11,1291,439
715,829,568,261,74,120,110,99,129,297,0,2375,829
716,663,527,136,96,131,100,48,85,203,0,1398,663
717,431,338,93,42,58,37,69,70,155,0,871,431
718,951,746,205,92,128,82,153,154,342,0,1869,951
719,549,431,118,53,74,47,88,89,198,11,1064,560
720,183,148,35,21,25,20,14,26,77,0,398,183
721,398,271,127,38,55,64,43,57,141,156,932,554
722,548,367,181,100,179,44,40,50,135,23,1332,571
723,522,350,172,95,171,42,38,47,129,0,1332,522
724,0,0,0,0,0,0,0,0,0,0,0,0
725,0,0,0,0,0,0,0,0,0,0,0,0
726,415,284,131,37,60,55,50,65,148,0,1039,415
727,940,761,179,105,127,105,71,134,398,0,2589,940
728,1175,871,304,111,127,155,134,197,451,106,3067,1281
729,996,738,258,94,108,131,114,167,382,70,2547,1066
730,1395,1018,377,64,91,148,142,253,697,0,3837,1395
731,431,353,78,59,48,53,46,67,158,43,956,474
732,336,262,74,19,24,40,36,60,157,24,679,360
733,603,469,134,34,42,73,64,108,282,23,1232,626
734,4077,3300,777,246,296,354,391,647,2143,0,18302,4077
735,2068,1870,198,366,396,142,127,242,795,0,4737,2068
736,161,146,15,29,31,11,10,19,61,0,513,161
737,1560,1041,519,227,328,172,172,201,460,13,4048,1573
738,352,294,58,5,10,40,48,57,192,0,770,352
739,1257,1017,240,19,18,165,152,216,687,14,2764,1271
740,1592,1368,224,30,47,188,214,302,811,0,3262,1592
741,253,208,45,6,9,27,31,45,135,0,608,253
742,834,548,286,16,24,93,93,158,450,136,2325,970
743,379,277,102,4,16,36,36,69,218,49,1013,428
744,1613,1476,137,76,83,189,177,271,817,0,2406,1613
745,1349,1098,251,116,173,171,176,219,494,0,2643,1349
746,1429,1113,316,19,42,184,212,266,706,0,3110,1429
747,3672,3076,596,211,238,474,452,669,1628,0,7558,3672
748,531,378,153,4,12,66,75,100,274,4,1309,535
749,1343,1035,308,68,78,172,202,239,584,70,3155,1413
750,2168,1737,431,57,225,220,170,390,1106,0,5266,2168
751,3047,2644,403,160,287,396,276,534,1394,0,5831,3047
752,405,316,89,8,12,41,55,84,205,0,1060,405
753,1349,1016,333,13,26,129,168,296,717,0,3479,1349
754,639,496,143,32,39,47,84,112,325,5,1505,644
755,1904,1415,489,95,82,141,172,333,1081,8,4240,1912
756,375,237,138,5,17,27,32,85,209,76,1045,451
757,1509,1076,433,58,76,209,182,274,710,11,3203,1520
758,1480,1145,335,48,63,170,180,316,703,0,3299,1480
759,1402,1117,285,29,59,188,185,299,642,23,3199,1425
760,2314,1671,643,20,69,346,298,510,1071,28,5636,2342
761,1595,1128,467,44,78,188,163,332,790,45,4023,1640
762,2588,1811,777,64,129,301,266,564,1264,19,6279,2607
763,4212,3185,1027,302,339,471,424,742,1934,100,8830,4312
764,2058,1569,489,211,361,206,190,292,798,15,4401,2073
765,396,310,86,26,46,53,53,68,150,0,848,396
766,324,254,70,21,38,43,43,56,123,0,769,324
767,273,214,59,18,32,36,37,47,103,0,666,273
768,1268,1108,160,207,277,122,135,136,391,208,2138,1476
769,835,730,105,136,182,80,89,90,258,24,1666,859
770,390,319,71,55,102,45,45,47,96,56,884,446
771,1157,979,178,88,213,103,88,180,485,8,2102,1165
772,736,623,113,56,135,66,56,114,309,35,1700,771
773,721,610,111,55,133,64,55,112,302,0,1631,721
774,658,575,83,107,144,63,70,71,203,7,1091,665
775,812,680,132,43,52,96,125,168,328,0,1995,812
776,616,407,209,11,22,85,67,125,306,15,1758,631
777,433,286,147,7,16,60,47,88,215,0,1231,433
778,313,207,106,5,11,43,34,64,156,11,1020,324
779,419,239,180,24,36,54,52,76,177,0,971,419
780,640,366,274,37,55,83,80,116,269,202,1977,842
781,632,361,271,37,54,82,79,115,265,54,1907,686
782,422,357,65,32,78,38,32,65,177,563,984,985
783,403,230,173,23,34,52,50,73,171,0,1093,403
784,628,543,85,85,91,58,54,94,246,76,908,704
785,603,522,81,81,87,56,52,90,237,7,1034,610
786,486,389,97,57,64,37,40,67,221,0,973,486
787,1007,871,136,136,145,93,87,151,395,0,2321,1007
788,389,320,69,10,15,41,48,70,205,0,896,389
789,441,363,78,11,17,47,54,79,233,0,1086,441
790,553,457,96,65,92,59,54,69,214,0,1190,553
791,656,542,114,77,110,70,64,81,254,0,1328,656
792,319,249,70,6,9,32,43,66,163,0,816,319
793,1321,1106,215,69,84,156,203,273,536,20,2340,1341
794,1734,1357,377,87,106,169,161,267,944,47,4084,1781
795,1493,1235,258,248,306,99,117,176,547,78,3065,1571
796,1081,894,187,180,222,71,85,128,395,0,2073,1081
797,732,575,157,30,38,68,102,124,370,28,1647,760
798,627,512,115,88,164,72,73,75,155,45,1228,672
799,684,559,125,96,179,79,80,82,168,2,1297,686
800,305,249,56,43,80,35,36,36,75,10,723,315
801,779,609,170,101,195,76,84,91,232,0,1462,779
802,465,363,102,60,116,46,50,55,138,8,953,473
803,807,631,176,105,202,79,87,95,239,0,1695,807
804,893,698,195,116,223,88,96,105,265,0,1906,893
805,424,331,93,55,106,42,46,50,125,0,907,424
806,619,486,133,25,32,57,86,105,314,62,1401,681
807,559,471,88,77,68,58,53,78,225,45,1235,604
808,1196,1008,188,164,145,124,114,167,482,72,2249,1268
809,319,269,50,44,39,33,31,45,127,29,717,348
810,2871,2334,537,324,303,196,250,407,1391,10,6219,2881
811,1698,1557,141,327,599,112,112,158,390,1,2491,1699
812,1176,1078,98,226,415,77,77,110,271,12,2139,1188
813,548,502,46,105,193,36,36,51,127,0,1300,548
814,642,470,172,6,26,60,62,116,372,112,1771,754
815,420,276,144,8,12,47,47,79,227,27,1183,447
816,357,226,131,4,16,26,30,81,200,99,1041,456
817,1124,883,241,35,69,109,113,210,588,0,2783,1124
818,1782,1401,381,56,109,173,179,333,932,0,3803,1782
819,612,466,146,59,80,63,66,99,245,23,1359,635
820,582,443,139,56,76,59,63,94,234,30,1474,612
821,347,264,83,34,45,35,37,56,140,44,839,391
822,382,291,91,37,50,39,41,62,153,0,977,382
823,1099,923,176,160,204,138,88,166,343,0,2132,1099
824,336,262,74,7,10,34,45,70,170,0,887,336
825,430,324,106,4,8,41,53,94,230,0,1060,430
826,976,922,54,157,210,83,94,116,316,0,1348,976
827,893,696,197,17,25,91,121,186,453,0,2301,893
828,697,583,114,10,20,79,94,113,381,0,1423,697
829,630,595,35,101,136,53,61,75,204,0,961,630
830,459,434,25,74,99,39,44,54,149,5,1030,464
831,690,652,38,111,149,58,66,82,224,63,1227,753
832,253,196,57,13,15,19,33,44,129,0,612,253
833,417,323,94,21,25,31,55,73,212,0,920,417
834,467,374,93,55,62,35,39,64,212,24,1034,491
835,1176,942,234,138,155,89,98,162,534,0,2594,1176
836,179,154,25,23,44,16,11,22,63,0,436,179
837,1997,1637,360,34,129,201,194,384,1055,186,4176,2183
838,1627,1234,393,15,49,199,183,350,831,45,3867,1672
839,689,575,114,70,107,60,62,97,293,0,1479,689
840,1680,948,732,19,87,179,182,383,830,28,4788,1708
841,1449,764,685,150,287,190,134,208,480,158,4549,1607
842,1138,875,263,82,108,140,141,160,507,0,2847,1138
843,672,565,107,27,79,73,60,131,302,0,1520,672
844,1829,1488,341,88,164,239,256,297,785,37,4205,1866
845,3053,2307,746,110,419,340,333,568,1283,0,6490,3053
846,426,193,233,26,58,68,44,76,154,0,1406,426
847,1836,1224,612,93,187,259,257,339,701,0,4478,1836
848,990,778,212,59,104,126,137,128,436,44,2231,1034
849,820,582,238,41,64,106,86,153,370,110,1957,930
850,1296,481,815,122,187,142,82,212,551,70,5243,1366
851,1604,593,1011,89,112,259,178,349,617,27,6180,1631
852,1559,1194,365,28,50,235,230,360,656,198,3377,1757
853,678,536,142,71,81,107,74,100,245,0,1699,678
854,1082,813,269,13,42,155,105,234,533,11,2974,1093
855,1848,1513,335,21,80,244,197,393,913,9,4012,1857
856,1428,1287,141,22,67,185,159,291,704,9,3129,1437
857,2644,2123,521,39,99,329,286,589,1302,27,5833,2671
858,1037,810,227,34,36,135,102,226,504,0,2588,1037
859,1217,959,258,12,36,152,123,287,607,0,2803,1217
860,2190,1752,438,193,268,347,252,308,822,58,4756,2248
861,2138,1655,483,43,121,292,245,427,1010,41,4906,2179
862,2470,2025,445,141,279,282,245,439,1084,71,5645,2541
863,1971,1561,410,25,85,281,215,405,960,20,4432,1991
864,752,593,159,29,55,87,89,154,338,0,1831,752
865,1674,728,946,164,273,248,181,313,495,1,5443,1675
866,2911,1360,1551,145,248,473,283,550,1212,81,9280,2992
867,2742,1549,1193,80,200,471,362,621,1008,45,7198,2787
868,843,766,77,191,195,101,69,89,198,45,1494,888
869,212,167,45,8,15,25,25,43,96,654,503,866
870,471,371,100,18,34,54,56,96,213,0,1058,471
871,746,503,243,71,130,64,55,105,321,0,1832,746
872,409,324,85,8,21,46,61,62,211,0,1011,409
873,269,203,66,35,32,30,27,48,97,0,674,269
874,331,250,81,43,39,37,33,59,120,0,824,331
875,440,332,108,58,52,49,45,78,158,0,1046,440
876,837,630,207,32,62,103,112,122,406,46,2019,883
877,1073,814,259,21,109,110,99,204,530,0,2546,1073
878,822,624,198,16,83,84,76,156,407,3,1963,825
879,336,257,79,12,16,42,34,69,163,0,727,336
880,545,470,75,69,133,50,34,67,192,0,1286,545
881,1216,1048,168,154,297,112,77,150,426,11,2468,1227
882,1043,899,144,132,255,96,66,129,365,11,2171,1054
883,419,331,88,44,50,66,46,62,151,0,1077,419
884,288,183,105,27,29,25,29,59,119,225,624,513
885,629,400,229,59,63,54,64,130,259,0,1372,629
886,1142,953,189,116,177,99,103,161,486,0,1868,1142
887,426,355,71,43,66,37,39,60,181,17,931,443
888,1132,1029,103,256,262,136,93,120,265,1,2325,1133
889,450,345,105,16,22,56,46,92,218,3,1074,453
890,669,619,50,144,148,71,61,64,181,0,1509,669
891,647,599,48,139,143,69,59,62,175,0,1047,647
892,638,591,47,137,141,68,58,62,172,1,1116,639
893,969,580,389,76,155,102,99,126,411,13,2933,982
894,526,315,211,42,84,56,54,68,222,0,1592,526
895,2485,2191,294,415,490,143,169,259,1009,6,4570,2491
896,1200,876,324,135,180,174,132,180,399,0,3352,1200
897,470,213,257,28,65,75,49,84,169,0,1729,470
898,972,837,135,123,237,89,61,120,342,22,1447,994
899,687,411,276,54,110,73,70,89,291,0,1884,687
900,961,835,126,111,166,133,111,132,308,95,2291,1056
901,421,366,55,48,73,58,49,58,135,0,806,421
902,478,323,155,45,83,41,35,67,207,7,1067,485
903,1368,1116,252,43,127,121,134,254,689,0,3057,1368
904,613,485,128,12,32,68,92,93,316,14,1474,627
905,431,366,65,60,91,44,34,54,148,36,984,467
906,1066,906,160,148,224,108,83,133,370,11,1909,1077
907,522,444,78,73,110,53,41,65,180,9,1059,531
908,834,584,250,85,197,94,88,102,268,0,1863,834
909,617,280,337,37,85,99,64,110,222,418,1551,1035
910,692,386,306,56,136,72,87,96,245,7,1944,699
911,779,562,217,70,145,96,81,97,290,0,1618,779
912,405,368,37,92,94,49,33,43,94,0,889,405
913,656,607,49,141,145,69,59,63,179,0,1176,656
914,570,318,252,46,112,59,71,79,203,173,1919,743
915,432,312,120,39,80,53,45,54,161,0,870,432
916,885,638,247,79,165,109,92,110,330,38,2078,923
917,825,595,230,74,154,101,85,103,308,41,1978,866
918,1167,934,233,93,169,134,123,209,439,0,2779,1167
919,359,287,72,29,52,41,38,64,135,0,722,359
920,722,619,103,6,24,126,70,173,323,0,1679,722
921,2423,1986,437,263,344,330,256,447,783,19,5405,2442
922,2078,1595,483,31,79,302,238,464,964,11,5735,2089
923,1572,1211,361,12,69,269,141,372,709,2,4328,1574
924,1748,1511,237,15,105,295,192,377,764,0,3947,1748
925,589,474,115,25,57,78,47,114,268,0,1529,589
926,2072,1640,432,169,283,298,250,331,741,0,5139,2072
927,470,376,94,42,62,61,55,80,170,0,1034,470
928,996,782,214,6,40,159,87,216,488,0,2652,996
929,0,0,0,0,0,0,0,0,0,3542,0,3542
930,1498,1197,301,4,59,244,121,357,713,13,3769,1511
931,546,499,47,60,65,67,71,87,196,22,1037,568
932,589,485,104,41,57,84,80,114,213,23,1449,612
933,1449,1114,335,9,62,223,138,325,692,13,3669,1462
934,1057,842,215,5,36,170,83,249,514,0,2619,1057
935,933,795,138,22,67,153,91,190,410,0,2201,933
936,1495,1172,323,18,88,247,147,319,676,10,3627,1505
937,1193,885,308,33,63,152,145,250,550,0,2860,1193
938,900,709,191,2,37,151,73,215,422,0,2302,900
939,0,0,0,0,0,0,0,0,0,0,0,0
940,916,877,39,7,50,184,93,200,382,404,2291,1320
941,2944,2460,484,22,114,446,303,720,1339,144,6516,3088
942,1353,1104,249,201,287,139,119,188,419,10,3253,1363
943,940,776,164,47,76,123,121,200,373,0,1932,940
944,991,782,209,129,162,118,113,155,314,0,1881,991
945,2248,1970,278,553,883,135,162,164,351,15,4413,2263
946,778,667,111,74,89,89,122,133,271,0,1415,778
947,781,683,98,110,123,76,107,119,246,0,1379,781
948,1668,1388,280,267,257,199,149,239,557,13,3354,1681
949,742,649,93,105,117,72,102,113,233,0,1626,742
950,685,570,115,109,105,82,61,98,230,0,2030,685
951,677,592,85,96,107,66,93,103,212,0,1145,677
952,2390,2260,130,463,491,234,298,309,595,62,3864,2452
953,0,0,0,0,0,0,0,0,0,0,0,0
954,0,0,0,0,0,0,0,0,0,0,0,0
955,2805,2790,15,567,285,253,201,352,1147,10,3434,2815
956,1486,1154,332,18,60,243,140,319,706,7,3733,1493
957,1254,1186,68,243,258,123,156,162,312,6,2124,1260
958,333,264,69,27,45,48,40,53,120,0,661,333
959,1011,848,163,140,194,107,100,155,315,0,1904,1011
960,922,810,112,78,91,156,123,191,283,2078,1808,3000
961,528,436,92,27,43,69,68,112,209,0,1294,528
962,643,492,151,35,52,86,59,137,274,0,1458,643
963,688,577,111,22,77,138,59,122,270,1,1710,689
964,757,621,136,78,122,88,90,132,247,0,1578,757
965,938,770,168,97,151,110,111,163,306,0,2180,938
966,459,377,82,47,74,54,54,80,150,10,1089,469
967,692,542,150,8,41,114,68,148,313,0,1441,692
968,756,609,147,104,111,72,73,133,263,0,1757,756
969,558,464,94,89,86,67,50,80,186,0,1050,558
970,541,445,96,37,53,77,73,104,197,0,1176,541
971,943,755,188,76,136,108,99,169,355,5,1700,948
972,108,93,15,10,12,12,17,18,39,1,211,109
973,544,466,78,51,62,62,85,93,191,0,1093,544
974,714,563,151,93,117,85,82,112,225,0,1584,714
975,244,214,30,60,96,15,18,18,37,0,480,244
976,838,697,141,134,129,100,75,120,280,0,1925,838
977,1547,1221,326,201,252,184,177,243,490,18,3332,1565
978,174,159,15,19,21,22,22,28,62,0,251,174
979,521,444,77,12,37,86,51,106,229,8,1192,529
980,588,537,51,65,70,73,76,94,210,0,1066,588
981,556,508,48,61,66,69,72,89,199,0,970,556
982,416,340,76,21,48,51,48,85,163,0,757,416
983,354,289,65,18,41,44,41,72,138,0,843,354
984,774,682,92,127,151,75,84,104,233,0,1328,774
985,811,662,149,40,93,100,94,165,319,0,1616,811
986,1034,912,122,170,201,100,112,139,312,0,1289,1034
987,1526,1230,296,210,224,145,148,268,531,0,3059,1526
988,955,842,113,157,186,92,103,128,289,0,1909,955
989,777,685,92,127,151,75,84,104,236,2,1597,779
990,369,301,68,18,42,46,43,75,145,21,1010,390
991,0,0,0,0,0,0,0,0,0,0,0,0
992,810,601,209,22,43,103,98,170,374,6,1749,816
993,505,424,81,70,97,53,50,77,158,0,1162,505
994,391,305,86,21,36,51,41,74,168,0,893,391
995,453,353,100,24,42,60,47,86,194,0,1086,453
996,237,185,52,13,22,31,25,45,101,0,539,237
997,227,177,50,12,21,30,24,43,97,0,526,227
998,638,603,35,124,131,62,80,82,159,24,1606,662
999,414,353,61,10,30,68,40,84,182,0,982,414
1000,0,0,0,0,0,0,0,0,0,0,0,0
1001,848,712,136,117,162,90,84,130,265,0,1353,848
1002,364,283,81,4,15,59,34,78,174,0,989,364
1003,433,340,93,2,18,69,38,94,212,0,1171,433
1004,402,315,87,2,16,64,35,87,198,16,1121,418
1005,875,704,171,38,84,115,70,169,399,0,2030,875
1006,563,431,132,31,45,75,52,120,240,0,1386,563
1007,710,543,167,39,57,95,65,151,303,97,1640,807
1008,527,421,106,47,70,68,61,90,191,0,1103,527
1009,448,333,115,12,24,57,54,94,207,0,1095,448
1010,1112,933,179,186,453,77,35,91,270,2,2573,1114
1011,1105,1099,6,223,112,100,79,139,452,0,2316,1105
1012,0,0,0,0,0,0,0,0,0,0,0,0
1013,2950,2267,683,150,184,371,383,578,1284,27,7469,2977
1014,1427,1060,367,24,65,162,229,287,660,0,3508,1427
1015,2005,1488,517,113,134,218,338,338,864,4,4993,2009
1016,1303,961,342,101,62,170,224,228,518,0,3186,1303
1017,936,725,211,29,54,134,180,133,406,11,2174,947
1018,169,133,36,17,17,22,24,24,65,0,452,169
1019,1320,1036,284,129,135,172,190,190,504,0,3213,1320
1020,3240,2632,608,605,531,486,352,471,795,22,7261,3262
1021,3552,3123,429,358,536,406,406,598,1248,8,6734,3560
1022,3128,2290,838,325,438,428,382,511,1044,0,6580,3128
1023,3662,3172,490,591,607,597,542,491,834,0,7432,3662
1024,813,501,312,38,83,122,101,156,313,53,2736,866
1025,1543,1098,445,113,202,211,203,261,553,11,3750,1554
1026,819,577,242,45,100,120,119,146,289,2,2185,821
1027,2572,1967,605,185,387,394,310,466,830,0,5594,2572
1028,2929,2126,803,206,355,402,363,551,1052,10,6785,2939
1029,1384,892,492,82,109,267,160,249,517,0,3522,1384
1030,1175,938,237,87,97,188,150,211,442,38,2484,1213
1031,1830,1358,472,178,249,282,199,364,558,0,4096,1830
1032,3162,2242,920,498,434,493,392,435,910,70,7431,3232
1033,2539,1999,540,116,151,329,408,483,1052,28,6137,2567
1034,1077,898,179,32,58,146,169,201,471,27,2621,1104
1035,2831,2406,425,799,674,279,249,282,548,7,6904,2838
1036,874,722,152,89,99,126,122,142,296,0,1562,874
1037,607,470,137,35,44,87,83,106,252,0,1154,607
1038,1665,1086,579,91,124,271,221,334,624,0,4419,1665
1039,627,537,90,343,230,22,4,7,21,0,3476,627
1040,1117,782,335,76,138,170,117,202,414,0,2215,1117
1041,11177,8989,2188,1457,1193,1063,780,1713,4971,8,19088,11185
1042,475,394,81,37,31,61,51,92,203,0,964,475
1043,2020,1389,631,832,589,196,67,117,219,0,4626,2020
1044,771,537,234,266,125,76,57,110,137,0,1414,771
1045,1309,759,550,399,423,46,152,99,190,0,2997,1309
1046,18034,16310,1724,2106,2990,1758,1601,2896,6683,20,32429,18054
1047,3857,2575,1282,552,753,387,364,525,1276,0,12082,3857
1048,281,204,77,61,115,16,19,25,45,4,730,285
1049,740,542,198,63,86,99,106,145,241,17,2421,757
1050,0,0,0,0,0,0,0,0,0,0,0,0
1051,3539,3073,466,413,579,234,319,538,1456,0,7227,3539
1052,2283,1305,978,733,842,351,149,172,36,0,3979,2283
1053,4,4,0,0,0,1,1,0,2,0,7,4
1054,3368,2003,1365,693,900,167,201,399,1008,0,7714,3368
1055,1231,976,255,211,248,180,167,194,231,0,2578,1231
1056,842,508,334,49,85,73,108,177,350,0,2778,842
1057,2529,2233,296,411,573,303,291,317,634,0,5631,2529
1058,971,615,356,54,131,147,120,202,317,620,3264,1591
1059,240,149,91,28,53,32,26,37,64,0,700,240
1060,2096,1438,658,136,245,308,320,415,672,0,5116,2096
1061,879,639,240,41,72,117,101,171,377,0,1921,879
1062,1391,1023,368,107,188,197,167,235,497,22,3299,1413
1063,1659,1299,360,95,170,241,215,303,635,45,3907,1704
1064,1524,1175,349,155,163,192,201,267,546,0,2805,1524
1065,1187,915,272,121,127,149,156,208,426,0,3055,1187
1066,1262,773,489,141,237,82,78,181,543,0,1456,1262
1067,32,21,11,5,6,3,3,4,11,0,63,32
1068,5706,3810,1896,817,1114,573,538,777,1887,0,9217,5706
1069,1309,1055,254,148,192,199,154,202,414,0,2659,1309
1070,3707,2475,1232,530,724,372,350,505,1226,0,12944,3707
1071,723,525,198,57,100,94,66,120,286,0,2009,723
1072,692,502,190,55,95,90,63,115,274,0,1305,692
1073,832,687,145,120,66,109,105,115,317,0,1064,832
1074,481,350,131,22,40,64,55,93,207,8,1088,489
1075,718,522,196,33,59,95,83,139,309,17,1781,735
1076,334,243,91,15,27,44,38,65,145,0,857,334
1077,2163,1830,333,817,1150,30,15,30,121,0,4683,2163
1078,234,194,40,21,21,30,33,44,85,0,382,234
1079,300,211,89,16,36,44,44,54,106,0,854,300
1080,595,475,120,44,49,95,76,107,224,4,1463,599
1081,1364,1179,185,186,253,115,122,205,483,0,2920,1364
1082,419,260,159,49,92,57,45,65,111,0,1182,419
1083,229,142,87,27,50,31,25,35,61,0,586,229
1084,706,600,106,199,168,70,62,70,137,0,1461,706
1085,530,342,188,31,42,102,61,95,199,80,1475,610
1086,561,362,199,33,44,108,65,101,210,0,1617,561
1087,785,569,216,88,106,131,84,130,246,0,1554,785
1088,978,757,221,56,71,140,133,170,408,0,2172,978
1089,509,394,115,29,37,73,69,89,212,0,1083,509
1090,688,499,189,77,93,115,74,114,215,27,1727,715
1091,608,471,137,35,44,87,83,106,253,0,1365,608
1092,319,279,40,82,73,28,27,31,78,0,701,319
1093,2113,1391,722,651,1102,134,59,99,68,0,8180,2113
1094,912,662,250,72,126,119,83,152,360,0,2114,912
1095,4203,3355,848,569,446,640,666,730,1152,25,9195,4228
1096,768,595,173,44,55,110,105,134,320,0,1385,768
1097,712,623,89,182,162,64,61,69,174,8,1673,720
1098,1830,1602,228,469,417,163,156,177,448,0,3175,1830
1099,587,467,120,91,132,74,53,67,170,219,1540,806
1100,528,420,108,82,118,66,47,60,155,0,1285,528
1101,566,451,115,87,127,71,51,64,166,0,1224,566
1102,488,403,85,50,56,70,68,79,165,0,1089,488
1103,306,236,70,31,33,38,40,54,110,0,766,306
1104,539,445,94,55,61,78,75,87,183,0,1393,539
1105,991,694,297,67,123,151,104,179,367,20,2211,1011
1106,512,425,87,40,33,65,55,100,219,0,1112,512
1107,209,173,36,16,14,27,22,41,89,0,343,209
1108,62,50,12,12,10,9,7,9,15,0,124,62
1109,941,738,203,92,96,122,136,136,359,13,2193,954
1110,1037,455,582,27,62,177,115,228,428,10,3119,1047
1111,596,473,123,75,67,86,76,97,195,193,1081,789
1112,4,4,0,1,0,0,0,1,2,0,8,4
1113,8693,6297,2396,1889,3573,507,593,759,1372,0,26102,8693
1114,924,573,351,108,203,125,100,143,245,7,2548,931
1115,429,331,98,44,46,54,57,75,153,0,1003,429
1116,0,0,0,0,0,0,0,0,0,0,0,0
1117,452,373,79,65,36,59,57,63,172,8,655,460
1118,618,511,107,89,49,81,78,86,235,0,1490,618
1119,2232,1681,551,88,138,267,327,478,934,45,5175,2277
1120,1542,1003,539,93,208,157,233,301,550,0,4062,1542
1121,1119,739,380,17,50,141,201,232,478,0,2775,1119
1122,1424,936,488,21,58,188,205,281,671,27,3817,1451
1123,3206,2334,872,456,433,285,343,547,1142,23,8152,3229
1124,634,518,116,71,85,84,74,89,231,0,1140,634
1125,2578,1901,677,172,264,347,349,457,989,0,6234,2578
1126,2449,1603,846,337,333,368,323,405,683,49,5681,2498
1127,2216,1701,515,296,368,329,312,351,560,209,4846,2425
1128,2843,2364,479,484,529,349,309,396,776,11,5384,2854
1129,2472,1939,533,388,512,386,305,315,566,0,5109,2472
1130,1377,961,416,74,137,216,198,232,520,0,3443,1377
1131,4251,2937,1314,590,1077,520,623,464,977,35,10413,4286
1132,1436,945,491,96,127,188,208,294,523,0,3670,1436
1133,2041,1364,677,111,183,299,267,408,773,56,5579,2097
1134,2450,1849,601,81,132,321,344,510,1062,29,5676,2479
1135,1942,1472,470,42,100,299,249,472,780,76,4800,2018
1136,1327,1026,301,8,68,213,187,315,536,0,3158,1327
1137,2680,2057,623,43,155,375,391,593,1123,0,6794,2680
1138,3060,2680,380,80,123,427,431,705,1294,357,5958,3417
1139,1051,809,242,19,54,128,145,291,414,354,2546,1405
1140,1274,1008,266,54,88,180,187,304,461,0,2797,1274
1141,947,709,238,16,45,109,138,222,417,0,2189,947
1142,2499,1996,503,143,255,353,368,459,921,41,5696,2540
1143,1103,859,244,21,65,138,176,238,465,0,2760,1103
1144,1486,1161,325,94,135,177,246,308,526,106,3519,1592
1145,1970,1494,476,22,106,232,296,485,829,0,4800,1970
1146,1152,822,330,38,79,138,157,252,488,0,2676,1152
1147,2041,1389,652,20,90,236,299,480,916,0,5153,2041
1148,2933,2220,713,108,169,385,419,616,1236,64,7321,2997
1149,2286,1487,799,224,166,236,300,418,942,0,6106,2286
1150,1772,1153,619,28,69,170,280,397,828,0,4514,1772
1151,1601,1084,517,21,75,231,252,291,731,0,4222,1601
1152,2251,1534,717,110,185,301,353,354,948,0,5739,2251
1153,3393,2572,821,303,303,369,428,624,1366,50,7606,3443
1154,2844,1925,919,151,271,341,387,607,1087,156,7622,3000
1155,2231,1753,478,427,358,148,165,296,837,5,5030,2236
1156,3212,2618,594,321,459,456,398,522,1056,32,6127,3244
1157,1798,1403,395,77,212,262,242,381,624,95,3961,1893
1158,2020,1616,404,188,328,265,258,354,627,0,4354,2020
1159,2517,1895,622,200,258,368,322,493,876,18,5981,2535
1160,4468,3303,1165,635,803,491,576,544,1419,0,10696,4468
1161,2276,1671,605,182,241,340,294,375,844,0,4732,2276
1162,1061,809,252,122,137,136,105,180,381,99,1857,1160
1163,2382,1553,829,344,351,359,334,375,619,0,6191,2382
1164,4731,3385,1346,632,780,379,452,647,1841,0,11117,4731
1165,1560,1068,492,53,96,240,236,322,613,49,3536,1609
1166,1604,1156,448,137,183,253,244,298,489,0,3842,1604
1167,1412,1084,328,116,157,209,194,260,476,53,3460,1465
1168,2338,1657,681,50,103,372,324,568,921,142,6089,2480
1169,1213,1016,197,36,54,173,176,268,506,4,2286,1217
1170,1880,1589,291,83,115,266,256,451,709,0,4009,1880
1171,1926,1441,485,19,90,233,276,473,835,27,4901,1953
1172,2050,1492,558,27,92,243,306,500,882,4,4947,2054
1173,1617,1234,383,21,76,193,233,423,671,86,3850,1703
1174,2095,1660,435,275,385,311,256,320,548,67,4461,2162
1175,3200,2460,740,98,207,484,394,743,1274,125,6632,3325
1176,2847,2280,567,255,343,249,292,411,1297,17,6373,2864
1177,1731,1255,476,84,150,268,234,319,676,136,3770,1867
1178,1632,1114,518,89,200,249,247,290,557,176,4161,1808
1179,2089,1462,627,149,196,330,313,347,754,48,4968,2137
1180,1558,1059,499,29,76,229,218,360,646,0,4084,1558
1181,58,52,6,7,15,10,7,8,11,0,145,58
1182,868,512,356,47,70,113,154,187,297,45,2973,913
1183,830,307,523,54,73,130,132,154,287,12,3776,842
1184,1094,580,514,86,126,148,185,181,368,60,3684,1154
1185,520,249,271,32,66,84,79,95,164,50,2041,570
1186,826,505,321,154,255,139,96,74,108,107,2171,933
1187,2049,1407,642,274,393,344,292,328,418,79,5472,2128
1188,228,212,16,28,36,46,35,28,55,87,595,315
1189,755,549,206,143,141,138,106,106,121,28,2019,783
1190,3041,2203,838,359,432,426,319,544,961,83,7205,3124
1191,1480,1270,210,149,142,248,184,259,498,0,2665,1480
1192,1188,1060,128,44,69,198,133,264,480,9,2359,1197
1193,2232,1736,496,134,251,364,286,421,776,41,5083,2273
1194,643,368,275,121,115,120,85,73,129,55,1753,698
1195,3274,2051,1223,570,896,446,294,388,680,30,7488,3304
1196,585,260,325,48,46,73,114,100,204,23,2156,608
1197,2772,1552,1220,387,655,462,335,349,584,130,8476,2902
1198,1017,824,193,219,281,122,110,119,166,4,1496,1021
1199,2078,1678,400,324,421,292,183,309,549,53,4534,2131
1200,3294,2716,578,477,604,493,402,458,860,0,6432,3294
1201,2574,2167,407,212,346,363,329,464,860,15,5250,2589
1202,605,496,109,31,59,97,82,111,225,3,1319,608
1203,2042,1677,365,111,184,325,251,423,748,24,4686,2066
1204,3978,3448,530,576,706,434,395,609,1258,21,7203,3999
1205,1069,882,187,112,175,182,103,185,312,0,2373,1069
1206,566,270,296,81,84,103,92,81,125,8,1982,574
1207,2076,1599,477,264,312,346,262,355,537,12,4693,2088
1208,3156,2416,740,191,288,436,379,631,1231,39,7371,3195
1209,1939,1587,352,105,166,354,231,399,684,13,4489,1952
1210,1614,1349,265,84,162,324,210,275,559,31,3363,1645
1211,2492,1276,1216,290,372,423,317,392,698,0,7522,2492
1212,1050,369,681,178,281,159,115,113,204,0,4069,1050
1213,1068,446,622,105,132,152,180,175,324,89,4447,1157
1214,881,769,112,119,191,113,107,146,205,171,2000,1052
1215,554,454,100,28,54,89,75,102,206,15,1211,569
1216,848,630,218,207,248,88,75,76,154,71,1326,919
1217,1698,1262,436,414,496,176,151,152,309,383,4767,2081
1218,723,372,351,136,197,118,96,85,91,0,1814,723
1219,773,649,124,99,133,109,92,119,221,0,1826,773
1220,1966,1651,315,251,339,277,234,302,563,0,3538,1966
1221,246,194,52,57,40,45,29,40,35,4417,644,4663
1222,657,596,61,228,280,58,35,29,27,29,1113,686
1223,2202,1968,234,261,563,366,264,300,448,0,4269,2202
1224,843,737,106,228,161,117,96,95,146,10,2862,853
1225,461,319,142,48,61,81,49,79,143,0,1409,461
1226,461,319,142,48,61,81,49,79,143,106,1364,567
1227,1188,1039,149,321,227,165,135,134,206,2,1687,1190
1228,797,626,171,119,137,140,111,118,172,22,1675,819
1229,2115,1573,542,515,618,219,188,189,386,1,4751,2116
1230,937,463,474,188,296,132,84,90,147,0,2869,937
1231,1844,1174,670,292,358,291,246,252,405,31,5156,1875
1232,500,343,157,67,96,84,71,80,102,0,1526,500
1233,657,542,115,69,108,112,64,113,191,0,1366,657
1234,1232,651,581,221,248,187,205,153,218,0,3937,1232
1235,422,217,205,79,115,69,56,49,54,281,1389,703
1236,2171,1924,247,548,558,307,275,232,251,31,4338,2202
1237,335,264,71,78,54,61,40,54,48,0,781,335
1238,384,279,105,73,72,70,54,54,61,32,786,416
1239,1165,916,249,174,201,204,162,173,251,1,3125,1166
1240,1438,879,559,351,523,166,145,107,146,26,4313,1464
1241,423,315,108,103,124,44,38,38,76,228,1003,651
1242,417,342,75,23,38,66,51,86,153,0,952,417
1243,1421,1147,274,216,309,165,180,198,353,1494,3171,2915
1244,507,416,91,26,49,81,69,93,189,0,1067,507
1245,422,346,76,22,41,68,57,78,156,0,941,422
1246,426,349,77,22,41,68,58,78,159,0,867,426
1247,498,402,96,76,108,58,63,69,124,3,1022,501
1248,299,245,54,15,29,48,41,55,111,0,667,299
1249,497,221,276,41,39,62,97,85,173,10,1924,507
1250,798,647,151,172,221,96,86,93,130,0,1931,798
1251,425,294,131,44,56,75,45,73,132,0,960,425
1252,240,223,17,30,38,49,37,29,57,564,609,804
1253,425,294,131,44,56,75,45,73,132,0,987,425
1254,454,234,220,85,124,74,60,53,58,29,1598,483
1255,302,151,151,60,87,28,44,26,57,0,1317,302
1256,1751,1070,681,327,541,294,203,158,228,48,5832,1799
1257,241,80,161,38,58,25,26,32,62,9,886,250
1258,401,134,267,63,96,42,43,53,104,0,1418,401
1259,1427,1215,212,220,272,228,143,208,356,54,2300,1481
1260,245,126,119,46,67,40,33,29,30,0,886,245
1261,652,474,178,124,122,119,91,92,104,128,1644,780
1262,540,393,147,102,101,98,76,76,87,127,1428,667
1263,516,375,141,98,96,94,72,72,84,0,1587,516
1264,539,257,282,77,80,98,88,77,119,58,1778,597
1265,721,441,280,176,262,83,73,54,73,0,2121,721
1266,645,394,251,158,235,74,65,48,65,0,1922,645
1267,763,403,360,128,151,128,95,105,156,21,3078,784
1268,620,207,413,97,148,65,66,82,162,0,2404,620
1269,1044,552,492,175,207,175,129,144,214,0,3012,1044
1270,446,368,78,47,73,76,43,77,130,0,1040,446
1271,629,535,94,97,120,101,63,92,156,14,1240,643
1272,625,517,108,74,66,97,84,100,204,56,1225,681
1273,485,450,35,60,77,98,75,59,116,404,1313,889
1274,535,359,176,103,108,80,68,66,110,0,1543,535
1275,273,253,20,34,43,55,42,33,66,31,695,304
1276,329,221,108,63,66,49,42,41,68,0,793,329
1277,188,126,62,36,38,28,24,23,39,12,569,200
1278,864,679,185,129,149,151,120,128,187,266,1691,1130
1279,411,276,135,79,83,62,52,51,84,3,1215,414
1280,426,260,166,104,155,49,43,32,43,0,1067,426
1281,516,357,159,93,137,85,50,58,93,0,1364,516
1282,546,270,276,110,172,77,49,53,85,138,1936,684
1283,991,686,305,179,262,163,96,112,179,0,1971,991
1284,619,549,70,156,159,88,79,66,71,0,1437,619
1285,0,0,0,0,0,0,0,0,0,0,0,0
1286,1073,951,122,271,276,152,136,115,123,121,2331,1194
1287,483,395,88,120,115,82,56,53,57,36,925,519
1288,588,462,126,88,101,103,82,87,127,9,1529,597
1289,973,797,176,243,232,166,114,107,111,31,1820,1004
1290,505,413,92,126,121,86,59,56,57,0,732,505
1291,432,354,78,108,103,74,50,48,49,0,704,432
1292,558,457,101,139,133,95,65,61,65,13,1215,571
1293,1575,1440,135,382,451,217,175,184,166,17,2404,1592
1294,1110,1015,95,269,318,153,123,130,117,107,1992,1217
1295,555,472,83,86,106,89,56,81,137,0,1080,555
1296,479,368,111,127,223,29,29,29,42,109,933,588
1297,428,354,74,51,45,66,57,69,140,62,953,490
1298,192,101,91,32,38,32,24,26,40,0,692,192
1299,604,489,115,50,83,98,81,104,188,0,1390,604
1300,785,635,150,65,107,128,105,135,245,72,2293,857
1301,493,399,94,41,67,80,66,85,154,0,1113,493
1302,271,143,128,45,54,46,34,37,55,3,851,274
1303,805,403,402,159,233,75,118,71,149,17,2687,822
1304,420,340,80,35,57,68,56,72,132,0,1080,420
1305,387,338,49,52,84,50,47,64,90,1312,734,1699
1306,50,45,5,6,13,8,6,7,10,0,123,50
1307,982,878,104,117,251,163,118,134,199,0,2056,982
1308,1649,1442,207,445,315,229,188,187,285,0,1535,1649
1309,4749,2623,2126,811,703,866,738,705,926,32,17316,4781
1310,5968,2933,3035,852,1024,697,679,823,1893,14,24267,5982
1311,1042,726,316,15,24,145,189,231,438,9,3342,1051
1312,3235,1721,1514,168,284,409,507,705,1162,32,12462,3267
1313,1774,849,925,45,72,251,299,428,679,253,6314,2027
1314,3268,1672,1596,53,125,469,533,821,1267,92,11456,3360
1315,1091,601,490,33,75,173,170,226,414,58,4369,1149
1316,1008,592,416,12,33,153,156,221,433,101,3719,1109
1317,896,526,370,13,31,135,151,213,353,30,3184,926
1318,1062,491,571,19,45,145,159,280,414,58,3772,1120
1319,1726,1077,649,238,240,211,204,294,539,17,5258,1743
1320,1509,892,617,28,56,217,167,371,670,45,4848,1554
1321,696,550,146,66,78,99,68,126,259,0,1608,696
1322,2164,1392,772,160,134,257,181,415,1017,9,6870,2173
1323,489,300,189,9,16,77,53,108,226,0,1436,489
1324,751,415,336,10,38,93,95,189,326,0,2470,751
1325,1260,618,642,43,59,193,148,290,527,24,4383,1284
1326,1398,847,551,43,54,188,160,324,629,15,4056,1413
1327,1094,650,444,141,110,164,120,171,388,22,3676,1116
1328,1680,1058,622,155,144,249,186,314,632,19,5335,1699
1329,217,161,56,48,81,12,14,17,45,0,529,217
1330,1742,1368,374,307,458,84,148,194,551,0,4567,1742
1331,1908,1074,834,287,217,349,264,260,531,41,6426,1949
1332,1264,789,475,23,34,202,215,288,502,0,3976,1264
1333,3877,3507,370,78,217,686,573,898,1425,13,7899,3890
1334,1179,679,500,13,30,186,173,271,506,90,4272,1269
1335,919,316,603,92,87,153,136,160,291,9,4086,928
1336,1139,510,629,286,271,155,130,94,203,15,5083,1154
1337,1169,399,770,103,115,178,209,204,360,11,5563,1180
1338,417,122,295,46,22,77,57,62,153,21,2544,438
1339,876,407,469,15,29,165,99,213,355,0,3639,876
1340,865,433,432,49,82,146,108,172,308,0,3457,865
1341,1635,815,820,307,318,301,211,173,325,21,6709,1656
1342,426,220,206,52,81,89,55,63,86,0,1650,426
1343,1765,1263,502,120,146,277,243,301,678,53,5334,1818
1344,1394,694,700,245,190,245,174,186,354,0,5920,1394
1345,1825,1313,512,88,159,283,303,323,669,42,5056,1867
1346,578,400,178,49,68,79,61,114,207,0,1596,578
1347,1263,735,528,25,65,192,154,287,540,58,4301,1321
1348,845,534,311,56,59,139,104,176,311,64,2624,909
1349,1798,874,924,22,46,250,274,498,708,0,6610,1798
1350,1412,858,554,26,48,203,192,358,585,39,4407,1451
1351,4082,2291,1791,68,162,578,662,1023,1589,52,12679,4134
1352,1207,439,768,196,154,230,166,172,289,21,5425,1228
1353,1253,509,744,47,78,257,139,282,450,13,5824,1266
1354,1258,577,681,105,151,230,139,224,409,43,5080,1301
1355,209,123,86,35,29,44,25,24,52,4,796,213
1356,858,309,549,123,119,152,122,131,211,0,3485,858
1357,2401,1710,691,585,351,453,265,269,478,0,6033,2401
1358,198,118,80,35,26,41,28,23,45,0,671,198
1359,2229,1499,730,84,142,392,387,422,802,133,7391,2362
1360,1390,902,488,80,105,179,261,267,498,30,4255,1420
1361,2369,1449,920,159,225,412,318,451,804,97,7986,2466
1362,1562,835,727,139,231,278,202,254,458,0,5851,1562
1363,1014,573,441,64,61,174,125,208,382,732,3712,1746
1364,1314,683,631,54,97,225,195,255,488,13,5425,1327
1365,1673,1353,320,33,50,228,290,352,720,43,4578,1716
1366,1495,1136,359,21,48,231,268,306,621,40,4335,1535
1367,1485,1140,345,58,85,232,250,281,579,4,3830,1489
1368,766,542,224,107,187,87,80,100,205,0,1698,766
1369,1973,1166,807,37,88,314,253,480,801,41,5825,2014
1370,715,446,269,49,44,101,93,137,291,28,2257,743
1371,1248,635,613,30,38,200,146,281,553,0,4318,1248
1372,1511,914,597,33,62,206,154,360,696,4,4830,1515
1373,1372,832,540,133,105,203,162,251,518,11,4692,1383
1374,2274,1692,582,223,194,317,222,429,889,0,6556,2274
1375,1773,1256,517,249,432,202,185,232,473,0,4834,1773
1376,292,201,91,41,56,28,33,53,81,0,941,292
1377,263,165,98,32,26,27,22,42,114,17,794,280
1378,462,230,232,87,90,85,60,49,91,121,1558,583
1379,102,56,46,26,36,14,8,9,9,2,282,104
1380,98,54,44,25,35,13,7,9,9,0,252,98
1381,1096,776,320,154,267,125,114,143,293,0,3115,1096
1382,685,423,262,59,54,102,82,145,243,32,2509,717
1383,1820,1289,531,255,444,208,190,238,485,0,4054,1820
1384,506,308,198,51,41,71,66,102,175,0,1586,506
1385,2519,1978,541,444,662,122,214,280,797,18,5642,2537
1386,570,334,236,97,80,120,69,64,140,0,1835,570
1387,1698,929,769,439,598,225,129,151,156,0,5435,1698
1388,514,305,209,90,69,105,73,58,119,15,1647,529
1389,906,468,438,110,172,190,117,134,183,117,3475,1023
1390,447,262,185,76,63,94,54,50,110,0,1598,447
1391,353,182,171,43,67,74,46,52,71,0,1195,353
1392,740,509,231,179,238,88,67,65,103,52,2262,792
1393,363,249,114,88,117,43,33,32,50,99,1047,462
1394,587,360,227,10,19,92,63,130,273,24,1825,611
1395,705,430,275,70,57,100,91,143,244,19,2362,724
1396,595,410,185,98,130,101,69,91,106,56,1866,651
1397,2550,1759,791,420,559,434,296,392,449,0,7598,2550
1398,635,446,189,69,119,69,129,119,130,36,1911,671
1399,552,341,211,48,43,82,66,117,196,28,1880,580
1400,240,150,90,17,15,34,31,46,97,0,737,240
1401,2442,1537,905,294,245,249,203,388,1063,0,6628,2442
1402,434,271,163,30,27,61,56,83,177,19,1511,453
1403,747,529,218,105,182,85,78,98,199,91,2253,838
1404,1525,1056,469,131,179,210,162,300,543,1,4264,1526
1405,801,504,297,96,80,82,66,127,350,13,2270,814
1406,975,673,302,161,214,166,113,150,171,10,3123,985
1407,287,197,90,40,55,28,32,52,80,0,778,287
1408,876,607,269,75,103,120,93,172,313,0,1912,876
1409,67,50,17,15,25,4,4,5,14,0,219,67
1410,1865,1465,400,328,490,90,159,207,591,0,4356,1865
1411,2681,1749,932,178,239,474,350,555,885,45,6514,2726
1412,1213,863,350,18,37,173,155,324,506,0,3104,1213
1413,2847,1902,945,22,91,451,505,632,1146,0,7162,2847
1414,1961,1423,538,123,142,334,249,414,699,10,4369,1971
1415,1756,1125,631,16,54,257,292,427,710,3,4609,1759
1416,1996,1465,531,29,81,275,266,507,838,35,5109,2031
1417,1094,618,476,44,59,156,162,273,400,0,2610,1094
1418,1078,809,269,16,35,170,140,289,428,0,2747,1078
1419,925,706,219,11,29,152,124,227,382,0,2420,925
1420,1438,1026,412,12,48,211,227,322,618,17,3728,1455
1421,2589,1711,878,328,795,275,205,374,612,32,6864,2621
1422,1725,1124,601,115,166,255,207,366,616,48,4999,1773
1423,755,366,389,102,141,106,125,113,168,1,2499,756
1424,1993,1296,697,136,232,326,257,425,617,42,5265,2035
1425,1828,1114,714,133,263,306,233,321,572,16,4496,1844
1426,1392,958,434,78,136,234,168,292,484,0,3675,1392
1427,402,267,135,25,35,70,52,86,134,26,1086,428
1428,991,654,337,59,79,173,142,180,358,0,2485,991
1429,704,412,292,68,111,107,87,136,195,10,2151,714
1430,949,646,303,160,308,97,78,112,194,27,2219,976
1431,1396,909,487,147,139,215,189,265,441,0,3880,1396
1432,1839,1214,625,127,167,282,236,360,667,42,5005,1881
1433,3778,2816,962,610,876,500,516,444,832,74,9046,3852
1434,1568,872,696,136,182,206,272,292,480,27,5575,1595
1435,755,525,230,76,151,106,80,148,194,0,2070,755
1436,1881,1317,564,212,451,286,229,279,424,35,4705,1916
1437,934,636,298,36,88,153,105,216,336,26,2470,960
1438,4419,3263,1156,682,792,665,411,653,1216,0,11093,4419
1439,1973,1280,693,196,351,297,206,367,556,21,5603,1994
1440,952,588,364,56,70,152,115,202,357,0,2581,952
1441,1377,845,532,62,107,204,198,324,482,14,3797,1391
1442,1621,1120,501,56,124,251,235,358,597,30,3997,1651
1443,2109,1601,508,92,136,375,269,453,784,10,4673,2119
1444,1289,964,325,24,58,218,202,279,508,94,3211,1383
1445,1311,963,348,24,43,206,145,342,551,129,3179,1440
1446,2307,1658,649,49,117,344,317,574,906,49,5961,2356
1447,1436,1098,338,78,124,263,183,287,501,13,3007,1449
1448,1798,1263,535,27,90,264,236,439,742,0,4557,1798
1449,556,314,242,22,30,79,82,138,205,19,1839,575
1450,265,150,115,11,14,38,39,66,97,1,772,266
1451,437,247,190,17,23,62,65,109,161,0,1431,437
1452,340,237,103,34,68,48,36,67,87,14,975,354
1453,1552,751,801,209,289,219,258,233,344,16,5420,1568
1454,2212,1507,705,374,718,225,182,261,452,0,6732,2212
1455,304,225,79,32,51,49,34,59,79,19,1089,323
1456,1362,1008,354,142,227,221,154,265,353,0,3178,1362
1457,1800,1038,762,18,62,216,277,470,757,35,5177,1835
1458,494,289,205,48,78,75,61,96,136,6,1378,500
1459,362,241,121,23,31,63,47,78,120,0,553,362
1460,454,302,152,29,39,79,59,97,151,39,1268,493
1461,1557,1010,547,155,277,234,162,290,439,28,3672,1585
1462,474,315,159,30,41,82,61,102,158,10,1239,484
1463,708,524,184,74,118,115,80,137,184,75,1838,783
1464,572,318,254,50,66,75,99,106,176,14,2019,586
1465,616,429,187,62,123,86,65,121,159,0,1311,616
1466,603,390,213,37,55,102,89,134,186,26,1894,629
1467,745,482,263,45,68,127,110,166,229,21,1907,766
1468,308,199,109,19,28,52,46,69,94,35,835,343
1469,1396,998,398,77,113,228,206,309,463,3,3583,1399
1470,2052,1117,935,141,197,371,359,416,568,192,6594,2244
1471,545,324,221,46,30,111,54,133,171,69,1548,614
1472,1431,946,485,80,116,238,221,325,451,3,3870,1434
1473,1430,1091,339,21,86,233,205,326,559,0,3321,1430
1474,2673,1763,910,69,182,397,443,603,979,91,7771,2764
1475,313,208,105,50,49,38,39,61,76,15,919,328
1476,2622,1539,1083,35,156,402,472,634,923,0,7569,2622
1477,1305,719,586,203,257,218,168,209,250,601,4361,1906
1478,3286,2061,1225,185,250,567,489,724,1071,44,8474,3330
1479,497,294,203,16,31,89,65,119,177,0,1397,497
1480,1760,1191,569,55,90,295,257,437,626,0,4691,1760
1481,799,549,250,67,59,131,126,167,249,27,2502,826
1482,546,370,176,51,51,87,84,108,165,10,1422,556
1483,346,267,79,14,14,60,44,76,138,16,713,362
1484,1002,640,362,158,228,118,129,139,230,0,2539,1002
1485,649,414,235,104,120,101,88,95,141,0,1752,649
1486,902,576,326,142,206,106,116,125,207,59,2478,961
1487,249,159,90,39,57,29,32,35,57,13,811,262
1488,242,154,88,39,45,38,33,35,52,10,689,252
1489,818,522,296,130,152,127,111,119,179,0,2379,818
1490,546,348,198,87,101,85,74,80,119,20,1318,566
1491,628,432,196,53,47,103,99,131,195,212,1960,840
1492,2087,1333,754,329,476,246,268,290,478,0,5227,2087
1493,162,74,88,40,49,20,20,17,16,70,446,232
1494,627,393,234,35,48,108,93,138,205,8,1894,635
1495,464,211,253,115,142,57,58,50,42,18,1787,482
1496,191,87,104,47,58,23,24,20,19,0,521,191
1497,678,308,370,168,207,83,85,72,63,17,2624,695
1498,316,187,129,10,20,57,41,76,112,3,986,319
1499,1371,913,458,218,216,168,170,266,333,9,4457,1380
1500,1103,788,315,61,89,180,163,244,366,0,2648,1103
1501,326,208,118,52,60,51,44,48,71,29,1031,355
1502,1380,626,754,342,421,168,172,148,129,14,5102,1394
1503,527,357,170,49,50,84,81,105,158,18,1666,545
1504,809,516,293,129,150,126,110,118,176,113,2028,922
1505,613,338,275,95,121,103,79,98,117,198,1961,811
1506,776,525,251,72,73,124,119,154,234,39,2245,815
1507,305,138,167,76,93,37,38,33,28,10,1050,315
1508,568,384,184,53,54,91,87,113,170,0,1381,568
1509,634,518,116,71,85,84,74,89,231,33,1453,667
1510,1114,911,203,125,150,148,131,157,403,0,1929,1114
1511,634,518,116,71,85,84,74,89,231,0,1356,634
1512,1939,1479,460,224,250,248,193,328,696,0,4211,1939
1513,440,352,88,39,53,39,45,63,201,0,990,440
1514,343,275,68,31,41,30,35,49,157,0,815,343
1515,411,329,82,37,49,36,42,59,188,0,831,411
1516,500,344,156,206,146,48,17,29,54,0,1144,500
1517,3551,2371,1180,508,694,357,335,483,1174,0,5029,3551
1518,61,31,30,11,17,10,8,7,8,1,106,62
1519,1553,1358,195,419,297,216,177,176,268,1,2965,1554
1520,91,83,8,32,39,8,5,4,3,3,210,94
1521,1677,1289,388,445,780,101,103,101,147,90,3481,1767
1522,1221,1107,114,425,520,107,65,53,51,2,4134,1223
1523,1416,1147,269,305,392,170,153,165,231,1,2368,1417
1524,327,265,62,70,90,39,35,38,55,0,1107,327
1525,0,0,0,0,0,0,0,0,0,0,0,0
1526,812,658,154,175,225,98,88,95,131,0,1249,812
1527,760,563,197,168,282,42,50,60,158,0,2387,760
1528,760,563,197,168,282,42,50,60,158,0,1198,760
1529,894,563,331,108,90,91,74,142,389,0,3641,894
1530,1284,1017,267,457,299,205,146,89,88,1,1532,1285
1531,1914,1537,377,341,557,183,208,218,407,0,4219,1914
1532,613,410,203,52,89,71,84,110,207,17,1496,630
1533,307,196,111,46,98,27,47,39,50,0,829,307
1534,840,536,304,127,268,73,129,107,136,37,2351,877
1535,1684,1176,508,100,157,176,248,354,649,184,4407,1868
1536,1119,688,431,54,81,114,159,230,481,40,3224,1159
1537,5,3,2,0,0,1,1,1,2,0,11,5
1538,306,185,121,12,19,37,45,68,125,0,778,306
1539,931,562,369,37,59,112,138,207,378,0,2754,931
1540,1977,1322,655,112,160,236,275,390,804,0,5260,1977
1541,7228,5382,1846,720,1168,775,1082,1270,2213,0,20000,7228
1542,3059,2086,973,550,930,235,384,355,605,34,8152,3093
1543,2166,1637,529,190,269,275,327,406,699,0,5258,2166
1544,1325,904,421,14,40,154,203,343,571,37,3528,1362
1545,1059,673,386,163,271,97,137,151,240,43,2778,1102
1546,1093,712,381,79,134,149,159,202,370,68,2841,1161
1547,1086,853,233,120,164,147,153,176,326,0,3008,1086
1548,385,271,114,32,48,50,54,67,134,21,930,406
1549,1523,1225,298,188,209,179,197,256,494,25,3498,1548
1550,2918,2035,883,109,108,338,465,651,1247,0,7718,2918
1551,0,0,0,0,0,0,0,0,0,0,0,0
1552,331,218,113,32,51,40,52,61,95,9,952,340
1553,1177,849,328,22,48,142,158,291,516,0,3180,1177
1554,407,309,98,13,15,47,53,87,192,0,861,407
1555,1774,1256,518,262,389,150,203,272,498,18,5240,1792
1556,614,459,155,25,45,84,82,126,252,12,1331,626
1557,335,215,120,22,39,39,53,71,111,0,940,335
1558,855,550,305,56,99,101,137,180,282,0,2446,855
1559,2704,1833,871,205,270,340,368,585,936,42,6617,2746
1560,1193,747,446,133,175,131,155,202,397,25,3057,1218
1561,1080,724,356,49,75,141,150,243,422,432,2747,1512
1562,1106,721,385,80,136,150,161,205,374,12,2928,1118
1563,382,239,143,43,56,42,50,65,126,0,1087,382
1564,1032,785,247,32,39,120,135,220,486,0,2711,1032
1565,1220,885,335,85,142,160,170,235,428,37,3090,1257
1566,4533,3209,1324,670,993,382,518,695,1275,0,9145,4533
1567,633,470,163,77,126,80,78,94,178,0,1467,633
1568,319,239,80,13,23,44,42,65,132,37,854,356
1569,790,574,216,62,88,87,109,153,291,72,1655,862
1570,461,308,153,39,67,54,64,83,154,38,1215,499
1571,609,408,201,68,107,85,108,98,143,0,1644,609
1572,719,522,197,50,84,94,100,139,252,31,1489,750
1573,976,785,191,120,134,115,126,164,317,0,1639,976
1574,3690,3292,398,655,970,204,244,418,1199,0,9227,3690
1575,664,493,171,81,132,83,82,99,187,31,1715,695
1576,1816,1154,662,279,465,167,235,259,411,0,3972,1816
1577,25,16,9,2,3,3,4,5,8,0,51,25
1578,918,590,328,60,106,108,147,194,303,0,2563,918
1579,839,516,323,41,60,86,119,172,361,0,2052,839
1580,571,459,112,70,78,67,74,96,186,0,1099,571
1581,459,299,160,33,56,62,67,85,156,0,1463,459
1582,2742,1839,903,305,481,383,488,442,643,0,7653,2742
1583,1176,709,467,47,74,141,174,261,479,0,3178,1176
1584,1451,1186,265,213,249,178,173,220,418,0,2817,1451
1585,267,188,79,22,34,35,38,47,91,0,646,267
1586,4,4,0,1,1,0,0,0,2,0,9,4
1587,748,530,218,111,164,63,85,115,210,0,1892,748
1588,1769,1286,483,140,198,194,244,342,651,0,4496,1769
1589,659,518,141,73,99,89,93,107,198,83,1315,742
1590,724,592,132,106,124,89,86,110,209,362,1760,1086
1591,1636,1459,177,290,430,91,108,186,531,0,4367,1636
1592,337,203,134,13,21,40,50,75,138,0,759,337
1593,1050,702,348,60,85,125,146,207,427,184,2209,1234
1594,333,223,110,19,27,40,46,66,135,0,826,333
1595,441,284,157,29,51,52,70,93,146,9,1107,450
1596,4200,2630,1570,470,614,459,544,712,1401,0,10587,4200
1597,649,406,243,73,95,71,84,110,216,0,1713,649
1598,680,490,190,13,28,82,91,168,298,0,1559,680
1599,733,529,204,14,30,88,98,181,322,25,1779,758
1600,3096,2111,985,557,941,238,389,359,612,0,8904,3096
1601,0,0,0,0,0,0,0,0,0,0,0,0
1602,346,225,121,25,43,47,50,64,117,0,851,346
1603,250,176,74,21,31,33,35,44,86,12,669,262
1604,1237,789,448,187,394,107,190,158,201,20,3522,1257
1605,456,341,115,18,33,62,61,93,189,0,1110,456
1606,1065,701,364,102,165,129,167,195,307,84,2646,1149
1607,1016,681,335,113,178,142,181,164,238,0,2740,1016
1608,643,478,165,79,128,81,79,96,180,0,1420,643
1609,757,550,207,60,85,83,105,146,278,193,1731,950
1610,1752,1171,581,149,253,204,241,316,589,42,4790,1794
1611,1177,829,348,97,148,153,167,205,407,27,3148,1204
1612,738,550,188,74,119,79,110,130,226,0,1354,738
1613,23,21,2,4,6,1,2,3,7,0,95,23
1614,0,0,0,0,0,0,0,0,0,0,0,0
1615,478,315,163,46,74,58,75,87,138,24,1265,502
1616,248,179,69,5,10,30,33,61,109,0,655,248
1617,3366,2100,1266,72,185,421,433,743,1512,0,9515,3366
1618,659,393,266,9,27,92,81,131,319,84,2409,743
1619,530,385,145,12,28,78,61,118,233,0,1253,530
1620,1082,763,319,38,76,143,116,227,482,25,3019,1107
1621,877,471,406,6,31,125,118,172,425,53,2837,930
1622,460,272,188,13,21,52,69,94,211,17,1449,477
1623,2591,1914,677,260,274,401,332,497,827,0,6713,2591
1624,546,339,207,11,31,77,69,121,237,13,1588,559
1625,744,509,235,47,69,100,83,144,301,50,2005,794
1626,917,594,323,21,52,123,88,220,413,38,2647,955
1627,1257,777,480,25,78,179,135,298,542,21,3857,1278
1628,1258,738,520,36,70,149,173,294,536,0,3743,1258
1629,2110,1489,621,63,112,294,271,452,918,14,6019,2124
1630,1668,939,729,30,77,168,212,312,869,24,4955,1692
1631,79,56,23,15,10,9,10,12,23,0,246,79
1632,1072,656,416,15,49,155,131,264,458,25,3002,1097
1633,716,460,256,17,43,100,78,178,300,0,2044,716
1634,674,456,218,131,225,59,43,71,145,0,1964,674
1635,2267,1392,875,68,168,311,261,499,960,35,6845,2302
1636,1063,790,273,20,65,130,109,227,512,16,2744,1079
1637,1987,1299,688,30,109,294,248,429,877,30,5973,2017
1638,2368,1461,907,76,129,295,290,582,996,145,6552,2513
1639,1212,648,564,12,50,158,157,324,511,162,3428,1374
1640,1219,772,447,12,54,174,142,307,530,0,3544,1219
1641,562,394,168,26,35,66,68,98,269,0,1720,562
1642,2001,1079,922,143,161,195,226,350,926,41,6331,2042
1643,1677,913,764,31,55,199,241,350,801,98,5259,1775
1644,6353,4283,2070,493,510,576,694,1103,2977,14,18019,6367
1645,1876,1121,755,113,124,237,227,318,857,96,5654,1972
1646,1034,799,235,131,119,131,113,127,413,109,2602,1143
1647,1647,1194,453,30,122,261,192,371,671,4,3802,1651
1648,2352,1575,777,56,108,304,280,521,1083,49,7011,2401
1649,1707,1145,562,74,111,222,190,370,740,34,4938,1741
1650,1980,1172,808,64,84,251,243,410,928,18,6147,1998
1651,1461,964,497,16,78,201,178,311,677,42,4501,1503
1652,352,167,185,17,16,42,46,70,161,0,1274,352
1653,249,148,101,3,10,35,30,49,122,28,864,277
1654,1015,757,258,19,60,106,142,191,497,0,2155,1015
1655,1310,1022,288,236,26,157,105,288,498,0,2691,1310
1656,1224,945,279,152,156,143,137,220,416,0,2722,1224
1657,293,173,120,4,14,39,33,72,131,0,815,293
1658,274,193,81,53,36,30,35,41,79,0,664,274
1659,822,508,314,16,51,117,88,195,355,21,2702,843
1660,644,373,271,21,32,71,84,124,312,0,2167,644
1661,813,438,375,11,29,124,108,192,349,17,2447,830
1662,954,749,205,92,102,125,119,189,327,4,2284,958
1663,420,243,177,14,21,46,55,81,203,11,1430,431
1664,384,279,105,46,50,51,49,63,125,0,1125,384
1665,820,520,300,36,47,118,102,184,333,15,2107,835
1666,859,603,256,176,154,98,107,108,216,30,2382,889
1667,1196,842,354,231,157,132,153,181,342,68,3336,1264
1668,1272,895,377,245,167,140,162,193,365,123,2619,1395
1669,516,245,271,26,24,61,67,103,235,0,1808,516
1670,189,108,81,12,15,20,21,31,90,2,755,191
1671,635,364,271,39,50,66,69,103,308,62,2187,697
1672,697,400,297,43,55,73,76,113,337,70,2380,767
1673,1878,1226,652,275,322,136,159,253,733,0,6504,1878
1674,2105,1374,731,308,361,152,178,284,822,0,5237,2105
1675,348,205,143,4,16,46,40,86,156,0,969,348
1676,416,264,152,18,24,60,52,93,169,16,1483,432
1677,829,480,349,27,41,91,108,159,403,27,2751,856
1678,918,666,252,21,49,135,106,205,402,68,2787,986
1679,440,260,180,5,21,58,50,109,197,9,1242,449
1680,1372,962,410,64,86,161,166,239,656,23,3895,1395
1681,609,361,248,18,28,69,91,125,278,8,1987,617
1682,822,596,226,99,108,109,104,134,268,34,2225,856
1683,679,390,289,42,53,71,74,110,329,0,2273,679
1684,7,4,3,0,0,1,1,2,3,55,20,62
1685,832,570,262,53,77,112,93,161,336,0,2286,832
1686,328,238,90,40,43,44,42,54,105,0,1029,328
1687,1856,1462,394,352,462,205,171,219,447,0,4825,1856
1688,459,362,97,87,114,51,42,54,111,0,1021,459
1689,1299,1023,276,246,323,144,120,154,312,0,3270,1299
1690,690,544,146,131,172,76,63,82,166,0,1657,690
1691,463,325,138,95,83,53,58,58,116,25,1407,488
1692,348,181,167,35,41,45,42,53,132,0,1046,348
1693,366,204,162,36,33,48,50,54,145,0,1288,366
1694,424,299,125,15,30,56,45,89,189,28,1071,452
1695,1823,1436,387,346,454,202,168,215,438,0,4789,1823
1696,1372,1081,291,260,342,152,126,162,330,0,2599,1372
1697,501,327,174,73,86,36,42,68,196,0,1276,501
1698,484,316,168,71,83,35,41,65,189,55,1385,539
1699,355,132,223,14,25,46,48,64,158,34,1328,389
1700,713,527,186,72,76,110,91,137,227,3,1490,716
1701,924,593,331,22,55,129,100,230,388,0,2648,924
1702,456,317,139,70,63,59,54,69,141,171,1147,627
1703,991,688,303,153,137,127,117,150,307,18,2346,1009
1704,586,407,179,90,81,75,69,89,182,0,1446,586
1705,485,374,111,60,62,57,54,87,165,0,931,485
1706,616,417,199,120,205,54,39,64,134,0,1777,616
1707,1376,849,527,44,75,171,169,338,579,0,3826,1376
1708,519,290,229,50,46,68,71,77,207,9,1794,528
1709,511,359,152,105,91,58,64,65,128,21,1281,532
1710,353,209,144,10,16,40,53,72,162,15,1094,368
1711,357,133,224,14,25,46,49,64,159,0,1256,357
1712,337,162,175,21,23,43,48,63,139,36,1182,373
1713,633,440,193,98,88,81,75,96,195,0,1572,633
1714,896,613,283,57,83,120,100,174,362,239,2468,1135
1715,659,458,201,102,91,85,78,100,203,13,1898,672
1716,827,574,253,127,114,106,98,125,257,12,2360,839
1717,486,333,153,31,45,65,54,94,197,0,1376,486
1718,877,541,336,28,48,109,107,215,370,0,2336,877
1719,675,473,202,31,42,79,82,118,323,9,1513,684
1720,517,279,238,37,42,50,58,90,240,0,1571,517
1721,648,349,299,46,52,63,73,113,301,15,1968,663
1722,397,246,151,8,22,56,50,88,173,0,1188,397
1723,622,481,141,79,72,79,68,76,248,6,1417,628
1724,205,123,82,12,14,26,25,35,93,23,580,228
1725,381,269,112,13,27,50,41,80,170,13,1186,394
1726,350,224,126,11,22,50,42,76,149,0,1169,350
1727,1320,1019,301,164,168,154,148,238,448,2,3605,1322
1728,1099,797,302,25,58,162,127,246,481,2,2340,1101
1729,573,298,275,57,67,74,69,87,219,0,1892,573
1730,386,272,114,74,51,43,49,58,111,0,1238,386
1731,111,69,42,2,6,14,14,25,50,0,344,111
1732,499,310,189,10,28,70,63,111,217,0,1408,499
1733,484,300,184,9,27,68,61,108,211,0,1491,484
1734,532,360,172,104,177,47,34,56,114,0,1506,532
1735,688,331,357,43,47,89,97,129,283,21,2495,709
1736,888,477,411,6,32,127,119,174,430,53,2969,941
1737,561,394,167,115,100,64,70,71,141,0,1573,561
1738,381,142,239,15,27,49,52,69,169,19,1348,400
1739,376,140,236,15,26,48,51,68,168,0,1335,376
1740,721,462,259,22,44,102,86,157,310,40,2099,761
1741,212,136,76,7,13,30,25,46,91,28,651,240
1742,987,632,355,31,61,140,117,215,423,0,3128,987
1743,453,253,200,44,40,59,62,67,181,29,1582,482
1744,426,251,175,5,20,56,48,105,192,11,1258,437
1745,1051,763,288,127,138,140,133,172,341,6,3091,1057
1746,0,0,0,0,0,0,0,0,0,0,0,0
1747,418,261,157,9,23,52,54,92,188,0,1144,418
1748,361,207,154,22,28,38,39,59,175,0,1031,361
1749,437,285,152,64,75,32,37,59,170,40,1240,477
1750,222,145,77,32,38,16,19,30,87,26,673,248
1751,30,24,6,6,7,3,3,4,7,3,86,33
1752,437,308,129,84,57,48,56,66,126,0,1050,437
1753,53,35,18,14,20,4,1,4,10,0,213,53
1754,1526,1007,519,394,574,103,32,124,299,0,2262,1526
1755,335,221,114,86,126,23,7,27,66,0,955,335
1756,655,432,223,169,246,44,14,53,129,5,1331,660
1757,205,139,66,40,68,18,13,21,45,0,584,205
1758,999,835,164,79,82,168,109,148,413,8,2440,1007
1759,1049,838,211,22,46,147,124,219,491,0,2965,1049
1760,500,349,151,55,72,78,73,59,163,5,1545,505
1761,1417,995,422,25,54,196,192,295,655,158,3812,1575
1762,2866,2107,759,22,81,403,383,659,1318,49,7485,2915
1763,2482,1829,653,27,81,315,298,578,1183,87,5803,2569
1764,736,585,151,8,17,95,96,176,344,0,1910,736
1765,1047,664,383,57,60,163,131,176,460,0,2509,1047
1766,1504,1168,336,27,59,182,163,361,712,36,3719,1540
1767,1713,1309,404,21,71,237,215,355,814,5,4521,1718
1768,1672,1105,567,163,175,261,202,285,586,548,4679,2220
1769,1714,1158,556,136,193,261,229,264,631,45,5089,1759
1770,1427,1017,410,17,53,210,151,318,678,67,3929,1494
1771,1755,1267,488,215,261,259,216,247,557,10,5166,1765
1772,1163,908,255,118,162,174,147,190,372,70,2760,1233
1773,1018,851,167,31,50,134,124,231,448,36,2348,1054
1774,1710,1164,546,120,199,304,212,285,590,20,4622,1730
1775,980,583,397,119,188,116,93,110,354,31,3004,1011
1776,806,560,246,59,95,110,92,121,329,13,2144,819
1777,936,590,346,16,27,152,95,162,484,16,2964,952
1778,306,137,169,18,27,46,40,57,118,0,983,306
1779,1182,895,287,18,35,164,135,224,606,80,3641,1262
1780,1385,841,544,28,69,152,159,242,735,21,5059,1406
1781,719,520,199,46,55,92,86,145,295,17,2176,736
1782,698,519,179,9,26,121,77,129,336,0,1848,698
1783,1459,1078,381,138,188,204,163,225,541,18,3232,1477
1784,1150,968,182,95,128,171,122,193,441,5,2702,1155
1785,1454,1225,229,32,85,232,175,287,643,26,3544,1480
1786,1131,911,220,198,229,168,124,136,276,0,2210,1131
1787,1311,974,337,24,65,176,144,269,633,13,3985,1324
1788,1361,1056,305,31,75,217,170,252,616,26,3853,1387
1789,1076,812,264,83,115,161,115,185,417,0,2692,1076
1790,822,568,254,151,176,127,99,90,179,21,2091,843
1791,2510,1780,730,289,454,196,194,339,1038,34,7199,2544
1792,1595,1486,109,69,111,212,208,274,721,2748,4098,4343
1793,444,322,122,35,40,73,52,78,166,0,1073,444
1794,1081,779,302,60,82,181,139,185,434,34,3183,1115
1795,1629,1237,392,29,52,255,148,364,781,16,4846,1645
1796,731,541,190,79,78,109,81,106,278,0,2027,731
1797,562,322,240,37,70,83,75,88,209,0,1961,562
1798,962,723,239,64,88,110,109,158,433,38,2449,1000
1799,822,630,192,43,62,119,86,130,382,44,2552,866
1800,1166,538,628,42,72,195,169,231,457,80,3945,1246
1801,955,649,306,70,91,131,134,135,394,8,3301,963
1802,1555,979,576,32,58,193,178,307,787,65,4959,1620
1803,907,492,415,47,62,126,120,152,400,105,3548,1012
1804,406,314,92,27,38,69,61,60,151,0,1010,406
1805,679,415,264,110,131,100,93,76,169,26,1842,705
1806,391,319,72,59,58,57,44,52,121,18,970,409
1807,510,398,112,103,135,69,46,52,105,0,1285,510
1808,395,336,59,113,140,38,27,28,49,0,931,395
1809,329,257,72,66,87,44,30,34,68,0,666,329
1810,531,434,97,65,64,71,61,81,189,0,1405,531
1811,818,602,216,84,100,110,100,116,308,15,2128,833
1812,395,273,122,73,85,61,47,43,86,0,1166,395
1813,446,356,90,9,20,62,53,93,209,10,1093,456
1814,792,673,119,227,280,75,53,57,100,7,1576,799
1815,514,382,132,10,25,69,56,105,249,0,1553,514
1816,450,362,88,79,91,67,49,54,110,8,781,458
1817,357,309,48,40,58,55,42,53,109,0,782,357
1818,951,822,129,107,153,147,111,141,292,10,1837,961
1819,578,472,106,71,70,78,67,88,204,129,1707,707
1820,1134,886,248,229,301,152,102,116,234,0,2935,1134
1821,666,520,146,68,93,100,84,109,212,23,1528,689
1822,750,581,169,42,87,128,98,135,260,96,1704,846
1823,1031,717,314,116,159,140,110,167,339,34,3031,1065
1824,484,390,94,85,98,72,53,58,118,0,993,484
1825,349,281,68,61,71,52,38,42,85,0,658,349
1826,897,722,175,157,181,134,98,108,219,0,1750,897
1827,285,212,73,5,14,38,31,58,139,47,881,332
1828,2936,2082,854,338,531,229,227,396,1215,0,5503,2936
1829,269,210,59,27,38,40,34,44,86,10,731,279
1830,1207,839,368,88,142,164,138,181,494,0,3542,1207
1831,479,333,146,35,56,65,55,72,196,0,1577,479
1832,805,617,188,42,60,117,85,127,374,75,2205,880
1833,210,146,64,24,32,29,22,34,69,0,571,210
1834,350,243,107,39,54,48,37,57,115,0,1108,350
1835,853,593,260,96,132,116,91,138,280,0,2455,853
1836,469,326,143,53,72,64,50,76,154,0,1257,469
1837,1064,870,194,130,129,143,123,162,377,38,2263,1102
1838,336,260,76,19,39,57,44,60,117,13,763,349
1839,530,390,140,54,65,71,65,75,200,16,1616,546
1840,709,558,151,15,36,114,79,149,316,43,1466,752
1841,475,344,131,37,42,78,55,84,179,47,1173,522
1842,768,604,164,16,39,124,86,161,342,13,1684,781
1843,687,558,129,161,221,75,58,72,100,0,1535,687
1844,648,481,167,9,25,112,71,119,312,93,1629,741
1845,172,77,95,10,15,26,22,32,67,83,590,255
1846,619,277,342,37,54,93,81,115,239,0,2322,619
1847,732,569,163,31,40,91,86,126,358,134,2119,866
1848,649,505,144,28,36,80,76,112,317,53,1793,702
1849,673,550,123,82,82,90,78,103,238,0,1194,673
1850,1943,1378,565,224,351,152,150,262,804,0,4864,1943
1851,282,200,82,32,51,22,22,38,117,13,708,295
1852,1003,663,340,98,105,157,121,171,351,132,3062,1135
1853,362,252,110,26,43,49,41,54,149,42,1267,404
1854,369,225,144,60,71,54,51,41,92,0,1056,369
1855,717,438,279,116,139,105,98,80,179,18,2039,735
1856,457,365,92,10,20,64,54,95,214,0,1066,457
1857,1040,899,141,117,168,161,121,154,319,20,1987,1060
1858,191,133,58,14,22,26,22,29,78,0,690,191
1859,295,205,90,21,35,40,34,44,121,13,971,308
1860,626,281,345,37,54,94,82,117,242,0,2016,626
1861,582,385,197,57,61,91,70,99,204,0,1547,582
1862,791,469,322,190,117,99,87,87,211,16,2372,807
1863,801,623,178,34,44,99,94,138,392,11,2290,812
1864,361,203,158,35,62,56,39,53,116,0,1126,361
1865,664,374,290,65,113,102,72,97,215,10,2048,674
1866,403,181,222,24,35,61,53,75,155,0,1436,403
1867,423,251,172,102,62,53,46,47,113,21,1033,444
1868,528,348,180,42,73,71,55,78,209,0,1377,528
1869,759,635,124,147,178,109,76,84,165,17,1801,776
1870,509,390,119,26,38,74,53,80,238,20,1518,529
1871,680,529,151,29,37,84,80,117,333,34,2011,714
1872,240,187,53,10,13,30,28,41,118,0,588,240
1873,368,282,86,19,28,53,39,58,171,0,1221,368
1874,603,397,206,48,84,81,63,89,238,60,1772,663
1875,1459,1241,218,419,516,139,98,104,183,0,3254,1459
1876,1603,1363,240,460,567,152,108,115,201,49,2588,1652
1877,628,534,94,180,222,60,42,45,79,98,1224,726
1878,296,179,117,21,29,39,28,43,136,0,1084,296
1879,271,173,98,10,11,34,32,50,134,0,904,271
1880,522,316,206,37,51,68,50,76,240,0,1619,522
1881,1121,681,440,158,297,155,108,124,279,11,2616,1132
1882,746,453,293,105,197,103,72,82,187,103,2173,849
1883,703,427,276,99,186,98,68,78,174,112,2267,815
1884,1117,712,405,41,45,141,131,208,551,99,3242,1216
1885,218,174,44,5,10,31,26,45,101,0,356,218
1886,260,181,79,28,37,41,38,31,85,189,813,449
1887,618,427,191,114,133,95,74,68,134,0,1478,618
1888,361,281,80,58,67,60,44,45,87,15,814,376
1889,405,309,96,5,17,56,51,84,192,0,1014,405
1890,856,695,161,201,275,93,72,90,125,0,1915,856
1891,630,354,276,62,108,97,68,92,203,0,2207,630
1892,368,265,103,21,28,62,47,63,147,0,1143,368
1893,912,523,389,60,114,135,122,144,337,27,2757,939
1894,239,167,72,26,34,37,35,28,79,3,727,242
1895,543,342,201,11,20,67,62,107,276,0,1865,543
1896,939,595,344,51,54,146,117,157,414,80,2228,1019
1897,850,658,192,56,79,145,128,127,315,182,1967,1032
1898,357,281,76,8,18,58,40,75,158,0,851,357
1899,325,256,69,7,17,52,36,68,145,0,733,325
1900,887,623,264,201,382,73,65,57,109,0,2793,887
1901,726,526,200,57,65,119,85,128,272,51,1673,777
1902,427,245,182,28,53,63,57,67,159,13,1468,440
1903,702,493,209,159,302,58,52,45,86,0,1961,702
1904,447,273,174,72,86,66,61,50,112,8,1072,455
1905,409,334,75,62,61,59,46,54,127,18,901,427
1906,296,180,116,42,78,41,28,33,74,0,793,296
1907,739,547,192,80,79,110,82,107,281,0,1677,739
1908,535,417,118,86,99,89,65,67,129,39,1287,574
1909,751,586,165,76,105,112,95,123,240,19,1394,770
1910,199,112,87,20,34,31,21,29,64,0,624,199
1911,523,393,130,35,48,60,59,86,235,36,1195,559
1912,567,392,175,12,31,81,60,120,263,0,1654,567
1913,761,526,235,17,41,108,81,161,353,13,2273,774
1914,471,325,146,10,25,67,50,99,220,0,1573,471
1915,623,474,149,127,186,80,58,73,99,23,1829,646
1916,944,719,225,193,282,122,88,111,148,0,2407,944
1917,317,265,52,25,26,53,34,47,132,0,779,317
1918,945,714,231,72,101,141,101,163,367,0,1986,945
1919,991,810,181,150,148,144,112,131,306,21,2023,1012
1920,1006,842,164,195,236,144,101,112,218,154,1981,1160
1921,1040,870,170,202,244,149,104,115,226,28,2461,1068
1922,616,480,136,98,114,102,75,78,149,38,1481,654
1923,650,456,194,147,280,53,48,42,80,0,1675,650
1924,226,159,67,51,97,19,17,15,27,0,585,226
1925,259,180,79,29,40,35,28,42,85,0,728,259
1926,71,54,17,14,21,9,7,8,12,0,217,71
1927,3640,2772,868,743,1088,469,338,428,574,0,9722,3640
1928,53,38,15,3,4,9,7,9,21,0,205,53
1929,561,434,127,37,52,96,85,84,207,0,1294,561
1930,282,244,38,32,46,44,33,42,85,0,530,282
1931,79,61,18,4,9,13,10,14,29,0,190,79
1932,168,130,38,10,19,29,22,30,58,0,359,168
1933,214,149,65,16,25,29,24,32,88,0,750,214
1934,0,0,0,0,0,0,0,0,0,0,0,0
1935,619,366,253,159,234,55,52,49,70,46,1941,665
1936,544,523,21,106,93,84,61,67,133,0,921,544
1937,2379,2057,322,47,71,317,260,485,1199,0,4875,2379
1938,770,645,125,35,51,96,86,146,356,2,1748,772
1939,300,247,53,25,28,40,34,52,121,0,599,300
1940,1411,1195,216,23,29,179,163,334,683,31,3003,1442
1941,146,135,11,7,8,21,17,24,69,0,182,146
1942,972,900,72,44,52,141,115,162,458,15,2390,987
1943,699,611,88,38,38,114,66,131,312,0,1646,699
1944,2388,2088,300,80,94,325,265,522,1102,12,4805,2400
1945,1860,1590,270,32,45,260,181,429,913,0,4190,1860
1946,498,321,177,78,69,86,53,61,151,62,1426,560
1947,1024,988,36,55,63,179,114,182,431,645,2090,1669
1948,1369,1168,201,45,61,199,161,290,613,0,2888,1369
1949,263,193,70,22,23,36,36,52,94,19,627,282
1950,1151,976,175,50,81,163,143,212,502,0,2992,1151
1951,45,28,17,4,5,8,5,7,16,0,128,45
1952,1571,1203,368,39,38,206,167,307,814,6,3933,1577
1953,330,275,55,39,48,53,37,48,105,0,809,330
1954,1660,1047,613,215,363,244,180,224,434,0,4435,1660
1955,800,687,113,57,86,130,115,125,287,0,1342,800
1956,1468,1260,208,105,157,239,210,230,527,16,3110,1484
1957,662,550,112,105,131,89,76,75,186,0,1498,662
1958,2795,2233,562,252,330,352,298,402,1161,0,6826,2795
1959,3752,2796,956,539,654,403,345,563,1248,3,9394,3755
1960,67,46,21,1,2,8,7,13,36,0,137,67
1961,847,692,155,129,154,128,101,108,227,0,1769,847
1962,339,305,34,27,37,45,36,54,140,0,510,339
1963,238,189,49,22,27,36,28,36,89,0,580,238
1964,439,402,37,41,32,72,51,67,176,1321,986,1760
1965,552,437,115,49,51,81,60,101,210,0,1198,552
1966,457,270,187,74,64,90,44,65,120,54,1338,511
1967,276,163,113,45,39,54,27,39,72,12,829,288
1968,432,316,116,28,23,66,53,77,185,0,977,432
1969,539,440,99,82,98,81,65,68,145,0,1259,539
1970,544,407,137,124,95,100,72,55,98,0,1225,544
1971,236,130,106,35,37,43,26,33,62,0,751,236
1972,516,422,94,78,94,78,62,66,138,0,1199,516
1973,395,295,100,90,69,73,52,40,71,13,823,408
1974,544,407,137,124,95,100,72,55,98,0,1078,544
1975,1855,1772,83,729,464,268,170,111,113,0,2648,1855
1976,333,222,111,154,90,36,28,13,12,0,714,333
1977,137,89,48,48,30,28,15,7,9,4,283,141
1978,1027,980,47,538,197,145,72,37,38,0,1232,1027
1979,0,0,0,0,0,0,0,0,0,0,0,0
1980,1431,959,472,289,367,291,210,134,140,18,2688,1449
1981,414,328,86,54,74,61,46,53,126,0,888,414
1982,1348,1067,281,479,314,215,153,93,94,0,3161,1348
1983,1555,1317,238,178,237,232,183,207,518,0,3356,1555
1984,456,361,95,60,81,67,51,58,139,0,928,456
1985,559,297,262,166,128,85,56,53,71,70,1513,629
1986,476,407,69,80,96,70,58,57,115,0,990,476
1987,494,411,83,78,98,67,57,56,138,0,1133,494
1988,403,296,107,57,46,67,46,64,123,0,909,403
1989,447,222,225,78,78,76,38,58,119,0,1495,447
1990,476,281,195,77,67,94,46,67,125,64,1217,540
1991,708,476,232,144,152,112,57,77,166,7,1952,715
1992,311,154,157,54,54,53,26,40,84,0,1076,311
1993,616,384,232,58,62,116,66,93,221,18,1611,634
1994,1262,1213,49,245,215,196,142,155,309,7,2021,1269
1995,747,677,70,237,151,118,86,65,90,0,1339,747
1996,665,463,202,179,116,125,86,64,95,0,1687,665
1997,1697,1132,565,779,664,80,115,35,24,3,3465,1700
1998,1108,1004,104,352,223,174,128,96,135,0,1727,1108
1999,997,903,94,317,201,157,115,86,121,0,1470,997
2000,636,443,193,171,111,119,82,61,92,0,1287,636
2001,569,396,173,153,99,107,74,55,81,0,1255,569
2002,395,275,120,106,69,74,51,38,57,14,899,409
2003,275,211,64,7,7,36,29,54,142,0,687,275
2004,1539,1477,62,592,393,219,161,98,76,14,2841,1553
2005,883,847,36,340,226,126,92,56,43,129,1573,1012
2006,427,290,137,127,77,89,50,32,52,642,962,1069
2007,600,539,61,99,80,103,81,88,149,0,1228,600
2008,678,507,171,155,118,124,89,69,123,41,1393,719
2009,705,431,274,232,156,106,90,50,71,655,1460,1360
2010,1036,846,190,115,125,144,92,165,395,0,2332,1036
2011,405,316,89,54,55,59,47,52,138,0,912,405
2012,597,466,131,80,81,87,69,77,203,9,1389,606
2013,431,280,151,78,83,81,43,52,94,27,1057,458
2014,414,267,147,65,57,72,44,51,125,0,1114,414
2015,376,253,123,76,81,59,30,41,89,0,1057,376
2016,314,196,118,29,32,59,34,47,113,0,766,314
2017,433,248,185,97,72,77,61,45,81,14,1459,447
2018,528,303,225,119,88,94,75,55,97,9,1720,537
2019,363,186,177,77,96,67,43,32,48,23,1360,386
2020,237,188,49,80,49,49,30,10,19,9,494,246
2021,450,302,148,91,115,91,66,42,45,0,1019,450
2022,358,307,51,25,31,53,49,59,141,0,678,358
2023,690,620,70,54,76,92,74,110,284,8,1352,698
2024,442,308,134,119,77,83,57,43,63,0,877,442
2025,410,235,175,92,68,73,58,43,76,20,1417,430
2026,288,165,123,65,48,51,41,30,53,17,966,305
2027,722,464,258,121,110,141,70,87,193,0,1899,722
2028,444,285,159,75,67,87,43,53,119,143,1214,587
2029,325,219,106,49,45,59,33,38,101,17,1005,342
2030,552,372,180,84,77,100,57,65,169,0,1494,552
2031,596,401,195,90,83,108,61,70,184,0,1448,596
2032,334,225,109,51,46,61,34,39,103,0,781,334
2033,445,300,145,67,62,81,46,52,137,59,1130,504
2034,435,293,142,66,60,79,45,51,134,0,1236,435
2035,384,314,70,20,23,51,39,74,177,0,945,384
2036,817,738,79,210,204,125,74,88,116,41,1562,858
2037,533,479,54,88,71,92,72,78,132,0,931,533
2038,485,296,189,160,107,73,62,35,48,12,1039,497
2039,438,394,44,72,58,75,59,64,110,0,703,438
2040,996,970,26,199,132,184,117,139,225,0,1622,996
2041,662,598,64,171,165,101,60,71,94,130,1238,792
2042,1289,757,532,494,439,146,100,62,48,0,3922,1289
2043,694,411,283,22,40,123,64,141,304,110,2193,804
2044,566,314,252,101,91,108,53,69,144,57,1727,623
2045,392,252,140,62,54,68,42,48,118,0,915,392
2046,373,243,130,67,72,70,37,45,82,0,1118,373
2047,356,278,78,48,48,52,41,46,121,0,804,356
2048,453,274,179,96,81,83,37,57,99,0,1194,453
2049,649,381,268,249,221,73,51,31,24,0,1765,649
2050,319,201,118,67,63,62,30,37,60,132,1098,451
2051,816,482,334,210,309,73,69,65,90,20,2513,836
2052,386,236,150,94,92,58,41,40,61,146,873,532
2053,588,361,227,108,109,115,54,65,137,0,1839,588
2054,446,274,172,82,83,87,41,49,104,0,1128,446
2055,555,341,214,102,103,109,51,61,129,0,1483,555
2056,248,152,96,46,46,49,23,27,57,0,748,248
2057,256,157,99,47,47,50,24,28,60,0,816,256
2058,281,173,108,52,52,55,26,31,65,0,768,281
2059,284,146,138,60,75,53,34,25,37,8,1032,292
2060,150,95,55,19,33,22,16,20,40,0,406,150
2061,499,313,186,172,121,86,56,23,41,2,1170,501
2062,324,203,121,112,78,56,36,15,27,0,697,324
2063,489,299,190,161,108,73,63,35,49,5222,1158,5711
2064,295,163,132,44,46,54,32,41,78,0,888,295
2065,767,482,285,165,186,139,84,76,117,35,2258,802
2066,472,296,176,101,114,85,52,47,73,5,1518,477
2067,1054,1043,11,605,235,106,52,32,24,331,1410,1385
2068,810,543,267,164,208,165,119,76,78,6,1434,816
2069,697,512,185,98,80,116,80,111,212,0,1652,697
2070,318,207,111,57,61,60,32,38,70,0,1006,318
2071,399,236,163,65,56,79,39,57,103,0,1031,399
2072,406,243,163,60,57,95,40,53,101,4,1264,410
2073,452,277,175,90,62,85,46,58,111,0,1111,452
2074,304,187,117,61,42,57,31,39,74,0,833,304
2075,266,137,129,41,40,51,31,35,68,0,1010,266
2076,683,645,38,92,68,108,67,107,241,12,995,695
2077,717,598,119,84,103,114,81,104,231,35,1614,752
2078,678,532,146,261,147,110,81,32,47,19,1578,697
2079,378,233,145,139,78,66,42,26,27,8,822,386
2080,552,340,212,203,114,96,61,38,40,82,1236,634
2081,295,216,79,25,26,41,41,58,104,0,692,295
2082,424,219,205,65,64,81,49,55,110,2,1588,426
2083,651,336,315,99,98,124,75,85,170,9,2365,660
2084,699,358,341,147,186,130,83,62,91,0,2254,699
2085,258,142,116,38,40,47,28,36,69,0,779,258
2086,353,195,158,32,38,65,36,56,126,67,1129,420
2087,329,241,88,21,18,50,41,58,141,22,948,351
2088,777,655,122,130,144,96,89,92,226,12,1568,789
2089,1029,900,129,477,271,132,83,33,33,3,1936,1032
2090,401,383,18,158,100,58,37,24,24,20,560,421
2091,0,0,0,0,0,0,0,0,0,147,0,147
2092,559,308,251,50,60,103,57,89,200,0,1788,559
2093,246,232,14,33,25,39,24,39,86,0,560,246
2094,260,129,131,46,45,44,22,34,69,0,864,260
2095,441,304,137,7,15,52,49,83,235,0,1137,441
2096,318,190,128,47,45,74,32,42,78,0,987,318
2097,321,235,86,21,17,49,40,57,137,0,814,321
2098,783,516,267,324,280,46,62,32,39,35,2477,818
2099,245,200,45,12,14,32,25,47,115,0,543,245
2100,803,726,77,207,201,123,73,87,112,0,1293,803
2101,466,421,45,120,116,71,42,50,67,0,853,466
2102,1880,1793,87,986,360,265,132,67,70,98,3151,1978
2103,787,766,21,119,71,139,100,131,227,10,1213,797
2104,382,269,113,51,54,60,38,54,125,0,904,382
2105,292,176,116,62,52,54,24,37,63,0,877,292
2106,1192,1144,48,458,305,170,124,76,59,8,1845,1200
2107,418,347,71,66,83,56,48,47,118,0,816,418
2108,782,662,120,90,119,117,92,104,260,0,1522,782
2109,656,545,111,104,130,88,75,74,185,0,1322,656
2110,354,221,133,33,36,67,38,53,127,0,887,354
2111,448,278,170,150,136,70,45,25,22,0,1186,448
2112,345,214,131,116,105,54,35,19,16,14,1029,359
2113,377,337,40,44,42,60,39,53,139,0,765,377
2114,348,306,42,29,32,56,33,59,139,0,855,348
2115,511,341,170,234,200,24,35,11,7,0,1157,511
2116,1348,689,659,375,214,174,156,165,264,0,3126,1348
2117,612,485,127,80,109,90,69,78,186,0,1450,612
2118,457,373,84,51,55,64,41,73,173,0,965,457
2119,1040,907,133,379,357,130,90,44,40,1,2619,1041
2120,374,373,1,170,94,46,33,17,14,113,371,487
2121,360,245,115,107,65,75,42,27,44,0,790,360
2122,373,254,119,111,67,78,44,28,45,0,828,373
2123,398,350,48,33,37,64,38,67,159,0,916,398
2124,662,505,157,167,98,118,74,60,145,0,1117,662
2125,165,158,7,82,34,25,14,6,4,13,263,178
2126,323,318,5,129,83,50,31,18,12,43,371,366
2127,585,501,84,98,118,85,72,70,142,0,1280,585
2128,341,292,49,57,69,50,42,41,82,0,652,341
2129,1195,989,206,213,319,140,127,128,268,0,2101,1195
2130,751,633,118,125,140,93,86,89,218,0,1428,751
2131,619,522,97,103,115,77,71,73,180,0,1247,619
2132,539,450,89,63,78,86,61,78,173,0,1325,539
2133,574,445,129,126,89,116,77,64,102,0,1074,574
2134,333,264,69,44,60,49,37,43,100,41,747,374
2135,1104,946,158,77,95,163,152,182,435,10,2056,1114
2136,302,247,55,46,55,46,36,38,81,0,746,302
2137,565,505,60,66,63,90,59,79,208,0,1203,565
2138,452,398,54,37,42,73,43,76,181,0,950,452
2139,309,204,105,128,110,18,25,13,15,0,604,309
2140,1052,1025,27,210,139,195,123,147,238,0,1621,1052
2141,861,838,23,130,78,152,109,143,249,23,1362,884
2142,391,369,22,52,39,62,38,61,139,19,566,410
2143,604,542,62,118,89,112,84,63,138,0,1102,604
2144,369,286,83,81,57,75,49,41,66,27,923,396
2145,339,263,76,75,53,69,45,38,59,0,806,339
2146,283,168,115,57,41,51,43,30,61,0,861,283
2147,391,320,71,20,23,52,40,75,181,0,950,391
2148,274,209,65,43,32,43,44,32,80,0,696,274
2149,402,239,163,80,58,72,61,43,88,0,1225,402
2150,384,261,123,57,55,67,36,45,124,36,907,420
2151,498,391,107,192,108,81,60,24,33,0,967,498
2152,400,221,179,59,62,73,43,56,107,0,1242,400
2153,3218,3183,35,1847,719,322,160,99,71,36,4841,3254
2154,2164,2056,108,781,449,372,248,157,157,26,3108,2190
2155,628,536,92,95,71,82,75,86,219,4,1174,632
2156,552,455,97,47,51,73,62,96,223,19,1168,571
2157,343,283,60,29,32,45,38,59,140,0,687,343
2158,379,301,78,34,42,57,45,57,144,0,834,379
2159,264,218,46,22,24,35,30,46,107,0,518,264
2160,412,308,104,94,72,76,54,42,74,0,909,412
2161,422,316,106,97,74,77,56,43,75,0,936,422
2162,1330,1264,66,480,276,229,152,96,97,27,2102,1357
2163,391,372,19,141,81,67,45,28,29,0,663,391
2164,471,448,23,170,98,81,54,34,34,0,662,471
2165,623,592,31,225,129,107,71,45,46,45,969,668
2166,1887,1723,164,490,379,315,229,191,283,89,3136,1976
2167,586,572,14,184,118,100,68,48,68,33,858,619
2168,974,950,24,305,196,167,114,80,112,0,1388,974
2169,485,473,12,152,97,83,57,40,56,0,828,485
2170,836,816,20,262,168,143,97,68,98,0,1200,836
2171,1168,1122,46,227,199,181,131,143,287,0,1466,1168
2172,455,437,18,88,78,71,51,56,111,0,587,455
2173,619,394,225,150,172,89,89,58,61,3,1780,622
2174,406,256,150,85,81,78,38,47,77,0,1484,406
2175,287,210,77,19,16,44,35,51,122,12,768,299
2176,772,611,161,68,71,113,83,141,296,15,1764,787
2177,433,317,116,28,23,66,54,77,185,0,1043,433
2178,731,603,128,62,67,97,82,127,296,0,1474,731
2179,465,299,166,73,64,80,50,57,141,0,1012,465
2180,749,669,80,87,83,120,78,105,276,4,1499,753
2181,403,240,163,80,58,72,61,43,89,0,1108,403
2182,639,583,56,166,128,107,77,65,96,0,1158,639
2183,239,142,97,48,34,43,36,26,52,0,705,239
2184,602,545,57,191,121,95,70,52,73,2,950,604
2185,459,263,196,103,76,82,65,48,85,0,1418,459
2186,566,301,265,168,130,86,57,54,71,0,1827,566
2187,257,158,99,58,37,45,34,29,54,16,880,273
2188,539,346,193,91,82,105,52,65,144,0,1511,539
2189,1086,642,444,279,411,97,92,86,121,0,2460,1086
2190,367,203,164,14,27,68,32,73,153,8,1359,375
2191,262,208,54,24,29,39,31,39,100,0,603,262
2192,350,282,68,36,38,56,36,57,127,42,789,392
2193,413,328,85,38,46,62,49,62,156,0,963,413
2194,311,246,65,28,29,45,34,57,118,0,729,311
2195,470,379,91,49,51,75,49,77,169,0,1057,470
2196,288,232,56,30,31,46,30,47,104,8,690,296
2197,385,319,66,68,103,45,41,41,87,0,731,385
2198,325,298,27,30,23,54,38,50,130,0,696,325
2199,400,222,178,71,65,76,38,49,101,14,1371,414
2200,344,269,75,46,47,50,40,44,117,0,758,344
2201,1364,868,496,331,380,196,195,128,134,2,3830,1366
2202,497,312,185,107,120,90,55,49,76,22,1642,519
2203,274,152,122,49,44,52,26,33,70,15,883,289
2204,473,308,165,85,91,89,47,57,104,0,1565,473
2205,469,275,194,180,160,53,37,23,16,0,1008,469
2206,673,407,266,143,120,124,55,85,146,0,2025,673
2207,645,473,172,91,74,107,74,103,196,0,1423,645
2208,1425,1216,209,47,63,207,168,302,638,0,2934,1425
2209,1452,916,536,305,289,280,135,167,276,0,4272,1452
2210,423,282,141,196,115,46,36,16,14,4,971,427
2211,368,203,165,33,40,68,37,59,131,0,980,368
2212,253,151,102,37,35,59,25,33,64,0,769,253
2213,369,348,21,49,37,58,36,58,131,0,536,369
2214,252,151,101,37,35,59,25,33,63,0,846,252
2215,355,196,159,32,38,65,36,57,127,0,1035,355
2216,3488,3041,447,1271,1196,436,302,148,135,46,5707,3534
2217,648,409,239,136,129,125,60,75,123,0,1916,648
2218,420,258,162,84,58,79,43,54,102,0,1149,420
2219,366,219,147,54,51,86,36,48,91,0,1118,366
2220,433,291,142,88,93,68,35,47,102,0,1058,433
2221,613,375,238,199,176,82,56,42,58,199,1768,812
2222,368,239,129,66,71,70,37,44,80,0,1082,368
2223,439,285,154,79,85,83,44,52,96,0,1187,439
2224,420,377,43,82,62,78,59,44,95,23,829,443
2225,475,426,49,93,70,88,66,50,108,0,965,475
2226,1221,1192,29,585,274,168,103,59,32,0,3096,1221
2227,547,386,161,73,77,86,54,78,179,19,1297,566
2228,653,586,67,127,96,121,91,68,150,0,1032,653
2229,316,259,57,16,19,42,32,61,146,0,767,316
2230,492,417,75,56,75,73,58,66,164,0,1143,492
2231,390,299,91,10,9,51,42,76,202,0,988,390
2232,830,508,322,269,239,111,76,57,78,6,2298,836
2233,405,394,11,61,37,71,51,67,118,33,674,438
2234,252,127,125,59,52,44,29,23,45,0,672,252
2235,525,341,184,183,116,106,57,26,37,0,1196,525
2236,537,479,58,78,81,76,62,71,169,0,962,537
2237,558,308,250,21,40,103,48,111,235,0,1760,558
2238,264,216,48,13,16,35,27,51,122,0,619,264
2239,435,388,47,63,66,62,50,58,136,0,787,435
2240,318,176,142,47,50,58,34,45,84,13,900,331
2241,538,483,55,42,59,72,57,86,222,8,968,546
2242,433,371,62,72,87,63,53,52,106,0,945,433
2243,481,412,69,80,97,70,59,57,118,135,908,616
2244,564,413,151,47,50,78,78,111,200,244,1348,808
2245,282,215,67,71,42,50,31,26,62,0,642,282
2246,502,365,137,93,64,89,69,56,131,0,1287,502
2247,263,204,59,58,41,53,35,29,47,0,719,263
2248,1583,1043,540,655,565,94,126,64,79,6,4768,1589
2249,438,334,104,111,65,78,49,40,95,0,1040,438
2250,470,342,128,87,60,83,65,52,123,29,975,499
2251,386,280,106,71,49,68,53,43,102,0,1022,386
2252,441,393,48,64,67,63,51,59,137,0,866,441
2253,579,516,63,84,87,82,67,77,182,0,1073,579
2254,496,378,118,77,57,77,79,57,149,70,1176,566
2255,378,191,187,89,77,66,43,35,68,0,1147,378
2256,340,234,106,5,11,40,37,64,183,0,809,340
2257,577,398,179,9,19,68,64,108,309,0,1537,577
2258,999,658,341,413,357,59,79,40,51,4,2735,1003
2259,619,528,91,94,70,81,74,84,216,0,1250,619
2260,483,244,239,113,99,84,55,45,87,0,1197,483
2261,327,165,162,77,67,57,37,30,59,0,994,327
2262,327,174,153,97,75,50,33,31,41,0,971,327
2263,306,188,118,69,45,54,40,35,63,70,990,376
2264,367,225,142,83,54,65,48,42,75,0,901,367
2265,417,284,133,62,60,73,39,49,134,0,1009,417
2266,294,180,114,67,43,52,39,34,59,0,905,294
2267,247,159,88,42,38,48,24,30,65,0,735,247
2268,465,317,148,69,67,81,43,55,150,0,1249,465
2269,429,276,153,67,59,74,46,53,130,30,1078,459
2270,480,327,153,71,69,84,44,56,156,0,1355,480
2271,323,220,103,48,46,56,30,38,105,8,829,331
2272,1670,981,689,641,569,189,130,80,61,0,4170,1670
2273,494,310,184,106,120,89,54,49,76,0,1744,494
2274,119,110,9,5,6,17,14,20,57,288,164,407
2275,101,94,7,5,5,15,12,17,47,0,213,101
2276,862,860,2,393,217,106,76,39,31,75,1515,937
2277,1644,1605,39,787,369,226,139,80,43,49,1789,1693
2278,123,117,6,48,31,18,11,7,8,45,167,168
2279,292,189,103,152,84,26,19,7,4,51,720,343
2280,577,373,204,300,166,51,37,13,10,9,1108,586
2281,57,46,11,6,6,9,6,9,21,12,144,69
2282,234,154,80,97,84,14,19,9,11,3,574,237
2283,854,789,65,7,20,100,118,189,420,0,1693,854
2284,854,821,33,15,22,86,125,151,455,0,1776,854
2285,1247,1202,45,63,48,147,194,217,578,0,2576,1247
2286,620,598,22,60,45,77,76,102,260,0,1392,620
2287,1636,1584,52,53,54,174,222,314,819,33,3332,1669
2288,968,941,27,64,60,134,123,163,424,0,1913,968
2289,508,481,27,126,102,68,62,50,100,0,972,508
2290,766,742,24,134,107,98,85,96,246,45,1513,811
2291,15,11,4,2,3,2,2,3,3,1688,34,1703
2292,244,234,10,45,36,38,33,29,63,1574,496,1818
2293,568,539,29,107,78,87,95,75,126,1328,1264,1896
2294,273,259,14,51,37,42,45,36,62,784,748,1057
2295,1553,1541,12,523,276,198,211,122,223,75,3236,1628
2296,278,233,45,69,30,52,41,23,63,8,560,286
2297,727,704,23,146,90,92,85,99,215,26,1492,753
2298,282,265,17,70,48,38,41,27,58,0,500,282
2299,569,564,5,192,101,72,77,45,82,2,1092,571
2300,16,15,1,4,3,2,2,2,3,0,16,16
2301,367,337,30,96,67,55,41,37,71,0,472,367
2302,742,680,62,194,136,112,82,74,144,0,848,742
2303,2422,2221,201,634,442,365,268,241,472,0,3197,2422
2304,589,560,29,106,59,70,84,64,206,0,1322,589
2305,382,362,20,95,77,51,47,38,74,0,828,382
2306,681,655,26,173,105,107,90,70,136,0,1357,681
2307,422,402,20,112,76,55,52,38,89,0,829,422
2308,402,380,22,100,81,54,49,40,78,8,994,410
2309,419,395,24,76,63,70,63,37,110,0,971,419
2310,260,250,10,91,69,24,19,18,39,8,438,268
2311,680,644,36,169,137,92,84,67,131,119,1625,799
2312,405,370,35,91,56,65,51,43,99,0,911,405
2313,361,329,32,82,50,58,45,39,87,0,715,361
2314,998,915,83,261,182,151,111,99,194,0,1279,998
2315,1034,948,86,271,189,156,115,103,200,0,1810,1034
2316,1640,1504,136,429,300,247,182,163,319,3,2561,1643
2317,2019,1851,168,528,369,305,224,201,392,0,3158,2019
2318,862,846,16,205,94,138,160,90,175,1,1822,863
2319,633,576,57,107,90,91,63,96,186,0,1251,633
2320,253,227,26,57,54,25,15,29,73,0,519,253
2321,1090,991,99,185,155,156,108,166,320,41,1814,1131
2322,1104,1007,97,249,152,178,138,119,268,140,2197,1244
2323,479,463,16,99,73,62,58,55,132,12,843,491
2324,419,405,14,87,64,54,51,48,115,0,754,419
2325,478,461,17,77,48,55,56,63,179,0,987,478
2326,594,520,74,107,67,87,69,76,188,16,1137,610
2327,496,398,98,102,57,88,67,58,124,3,924,499
2328,1895,1738,157,496,346,286,210,189,368,42,2549,1937
2329,271,214,57,54,34,50,35,28,70,0,571,271
2330,466,368,98,94,59,86,61,48,118,218,1071,684
2331,504,478,26,117,74,68,69,54,122,0,1019,504
2332,381,303,78,87,51,65,47,43,88,158,787,539
2333,341,270,71,68,43,63,44,35,88,18,754,359
2334,441,419,22,62,28,50,63,60,178,5,993,446
2335,572,452,120,115,72,106,75,59,145,0,1264,572
2336,416,349,67,103,45,77,62,35,94,0,841,416
2337,726,699,27,130,88,102,112,77,217,4,1472,730
2338,765,750,15,182,84,123,142,80,154,85,1563,850
2339,1065,847,218,244,143,182,131,121,244,0,2018,1065
2340,512,473,39,95,64,89,75,53,136,87,1263,599
2341,404,380,24,101,69,55,59,39,81,0,933,404
2342,416,409,7,74,51,63,60,52,116,801,836,1217
2343,762,750,12,208,165,98,88,72,131,0,1455,762
2344,541,533,8,148,117,70,62,51,93,0,901,541
2345,0,0,0,0,0,0,0,0,0,0,0,0
2346,641,561,80,115,73,94,75,82,202,0,1249,641
2347,722,708,14,172,79,116,134,75,146,4,1338,726
2348,330,321,9,22,20,46,42,56,144,10,584,340
2349,557,536,21,100,67,78,86,59,167,15,1065,572
2350,385,378,7,69,47,59,56,48,106,44,835,429
2351,862,755,107,155,98,127,101,110,271,0,1603,862
2352,492,442,50,111,106,48,30,57,140,75,997,567
2353,658,635,23,106,66,76,78,86,246,0,1230,658
2354,563,558,5,178,109,84,74,50,68,2654,1094,3217
2355,1239,1180,59,230,169,193,164,149,334,0,2664,1239
2356,280,257,23,64,55,37,38,29,57,0,723,280
2357,597,574,23,95,58,69,59,87,229,0,1235,597
2358,358,340,18,50,22,40,51,49,146,0,851,358
2359,395,362,33,91,77,52,53,41,81,44,968,439
2360,308,297,11,66,40,36,35,39,92,0,670,308
2361,295,281,14,47,18,37,41,43,109,0,690,295
2362,473,453,20,76,53,61,60,58,165,3,924,476
2363,490,469,21,79,55,63,62,60,171,0,1044,490
2364,416,401,15,89,54,48,47,53,125,0,903,416
2365,390,371,19,70,39,46,56,42,137,0,900,390
2366,525,498,27,73,33,59,74,72,214,6,1275,531
2367,435,419,16,22,17,51,68,76,201,0,858,435
2368,526,507,19,113,68,61,59,67,158,6,1173,532
2369,764,734,30,121,74,88,76,111,294,0,1595,764
2370,607,588,19,106,85,78,67,76,195,1,1134,608
2371,301,284,17,46,33,41,39,39,103,0,645,301
2372,498,478,20,106,79,68,60,61,124,0,987,498
2373,597,574,23,111,87,93,80,71,155,30,1111,627
2374,761,730,31,162,121,103,91,93,191,3,1517,764
2375,1231,1212,19,336,267,158,142,117,211,5,1909,1236
2376,257,246,11,42,29,33,33,31,89,0,508,257
2377,587,567,20,210,132,48,49,44,104,0,1027,587
2378,985,939,46,260,177,129,121,88,210,5,1571,990
2379,339,323,16,90,61,44,41,30,73,34,752,373
2380,436,416,20,115,78,57,53,39,94,0,866,436
2381,288,273,15,54,39,44,48,38,65,267,624,555
2382,569,542,27,106,78,88,75,69,153,0,1154,569
2383,630,582,48,117,79,109,92,65,168,0,1463,630
2384,420,407,13,73,59,54,47,52,135,13,738,433
2385,875,842,33,222,135,138,116,90,174,17,1677,892
2386,397,380,17,64,45,51,51,48,138,0,779,397
2387,237,229,8,38,24,27,28,31,89,0,498,237
2388,563,544,19,201,127,46,47,43,99,75,1077,638
2389,778,748,30,273,208,73,56,53,115,72,1522,850
2390,257,204,53,59,35,44,32,29,58,23,601,280
2391,354,324,30,81,69,47,48,37,72,0,877,354
2392,254,247,7,66,52,42,26,28,40,11,495,265
2393,265,258,7,69,54,44,27,30,41,31,579,296
2394,420,337,83,86,48,75,57,49,105,0,879,420
2395,849,817,32,216,131,134,112,87,169,126,1575,975
2396,306,289,17,47,33,42,39,40,105,0,611,306
2397,613,588,25,131,98,83,73,75,153,0,1063,613
2398,550,541,9,98,67,84,80,69,152,0,1228,550
2399,343,340,3,108,67,51,45,30,42,990,528,1333
2400,291,277,14,46,18,37,41,42,107,0,721,291
2401,868,860,8,274,169,130,114,77,104,553,1769,1421
2402,877,843,34,163,128,137,118,105,226,766,1425,1643
2403,1037,1002,35,371,234,85,86,79,182,5,2077,1042
2404,531,517,14,138,108,89,53,60,83,1,917,532
2405,504,475,29,92,75,84,76,45,132,0,1093,504
2406,450,412,38,103,88,60,61,47,91,93,1057,543
2407,886,858,28,177,110,112,103,120,264,0,1907,886
2408,329,320,9,22,20,46,42,56,143,0,642,329
2409,549,528,21,87,53,63,55,80,211,0,1187,549
2410,432,412,20,68,26,54,61,62,161,0,1024,432
2411,479,464,15,96,59,61,56,65,142,1,1077,480
2412,889,843,46,206,130,120,122,96,215,0,1745,889
2413,9,8,1,2,2,1,1,1,2,0,13,9
2414,469,433,36,4,11,55,65,104,230,3,992,472
2415,0,0,0,0,0,0,0,0,0,0,0,0
2416,163,154,9,25,18,22,21,21,56,0,335,163
2417,198,187,11,30,22,27,26,26,67,0,423,198
2418,233,223,10,38,26,30,30,28,81,4,431,237
2419,436,410,26,109,75,59,63,42,88,0,718,436
2420,350,329,21,87,60,47,51,34,71,0,584,350
2421,0,0,0,0,0,0,0,0,0,0,0,0
2422,605,555,50,158,111,91,67,60,118,0,640,605
2423,459,455,4,155,81,58,62,36,67,0,970,459
2424,275,273,2,93,49,35,37,22,39,2,606,277
2425,462,458,4,156,82,59,63,36,66,150,1138,612
2426,316,313,3,100,61,47,42,28,38,0,669,316
2427,253,246,7,66,51,42,25,28,41,60,473,313
2428,289,281,8,75,59,48,29,32,46,0,544,289
2429,98,95,3,25,20,16,10,11,16,0,186,98
2430,150,146,4,39,31,25,15,17,23,0,206,150
2431,190,185,5,49,39,32,19,21,30,0,357,190
2432,298,282,16,74,60,40,37,30,57,17,671,315
2433,113,104,9,26,22,15,15,12,23,0,273,113
2434,241,232,9,84,64,22,17,16,38,0,475,241
2435,114,110,4,40,30,11,8,8,17,0,206,114
2436,76,70,6,17,15,10,10,8,16,9,145,85
2437,90,71,19,18,11,17,12,9,23,0,229,90
2438,109,86,23,22,14,20,14,11,28,0,237,109
2439,86,68,18,17,11,16,11,9,22,0,212,86
2440,106,84,22,21,13,20,14,11,27,0,232,106
2441,334,300,34,75,72,32,20,39,96,0,635,334
2442,284,258,26,48,40,41,28,43,84,0,558,284
2443,881,801,80,150,125,126,87,134,259,0,1583,881
2444,250,227,23,42,35,36,25,38,74,107,429,357
2445,137,84,53,33,33,20,15,14,22,0,311,137
2446,0,0,0,0,0,0,0,0,0,0,0,0
2447,0,0,0,0,0,0,0,0,0,0,0,0
2448,691,353,338,192,110,89,80,84,136,0,1888,691
2449,0,0,0,0,0,0,0,0,0,0,0,0
2450,314,262,52,37,45,50,35,46,101,0,1015,314
2451,277,231,46,32,40,44,31,40,90,0,709,277
2452,540,450,90,63,78,86,61,78,174,0,1142,540
2453,221,212,9,110,46,34,19,8,4,0,500,221
2454,72,69,3,36,15,11,6,3,1,0,126,72
2455,1970,1941,29,790,505,307,186,110,72,3,7151,1973
2456,51,40,11,18,12,8,6,4,3,0,117,51
2457,408,323,85,145,95,65,46,28,29,5,1083,413
2458,74,73,1,30,19,12,7,4,2,1,168,75
2459,220,174,46,78,51,35,25,15,16,0,354,220
2460,282,278,4,113,72,44,27,16,10,0,639,282
2461,231,228,3,93,59,36,22,13,8,3,276,234
2462,34,32,2,8,6,5,5,3,7,292,99,326
2463,107,101,6,27,18,15,16,10,21,0,383,107
2464,167,157,10,42,29,23,24,16,33,0,230,167
2465,1064,761,303,75,70,165,230,127,397,51,2554,1115
2466,522,424,98,47,40,80,66,86,203,0,1247,522
2467,1369,916,453,125,130,244,166,218,486,0,3945,1369
2468,740,440,300,196,213,105,72,58,96,0,1841,740
2469,1095,944,151,14,54,99,121,200,607,0,2352,1095
2470,869,628,241,46,46,130,120,188,339,0,2163,869
2471,2276,1536,740,226,277,394,323,363,693,10,5868,2286
2472,1481,1069,412,93,131,205,169,293,590,11,3356,1492
2473,1897,1385,512,188,234,254,223,323,675,30,5116,1927
2474,1531,1291,240,40,100,203,215,325,648,0,2968,1531
2475,4069,3046,1023,73,159,533,512,898,1894,80,10310,4149
2476,1560,1174,386,37,97,231,163,280,752,50,3903,1610
2477,1291,959,332,64,86,160,145,267,569,15,3041,1306
2478,3663,2815,848,78,177,461,391,789,1767,83,9473,3746
2479,1830,1383,447,61,106,235,209,350,869,11,4724,1841
2480,1146,956,190,27,37,147,139,241,555,0,2735,1146
2481,945,607,338,86,101,133,122,159,344,12,2608,957
2482,621,474,147,117,114,87,61,76,166,28,1480,649
2483,1094,858,236,82,86,191,143,189,403,6,2587,1100
2484,1613,1199,414,156,157,275,206,246,573,6,4591,1619
2485,1281,1200,81,124,97,192,168,220,480,3,2047,1284
2486,1661,1343,318,222,183,297,192,236,531,0,2656,1661
2487,582,515,67,16,32,70,60,127,277,0,1317,582
2488,357,307,50,6,14,41,48,82,166,0,788,357
2489,407,262,145,10,15,63,51,95,173,0,1322,407
2490,626,372,254,166,181,89,61,49,80,367,1995,993
2491,652,401,251,110,106,137,79,77,143,29,2191,681
2492,1670,1205,465,105,148,231,191,331,664,0,4476,1670
2493,423,305,118,27,37,59,48,84,168,0,1062,423
2494,439,282,157,10,16,68,55,103,187,0,1430,439
2495,617,438,179,40,45,98,81,114,239,0,1529,617
2496,396,281,115,26,29,63,52,73,153,0,1070,396
2497,432,259,173,55,52,67,57,65,136,0,1358,432
2498,528,317,211,67,64,82,70,79,166,13,1760,541
2499,363,218,145,46,44,56,48,54,115,0,1066,363
2500,875,491,384,86,107,146,106,134,296,0,3015,875
2501,396,281,115,94,75,62,43,38,84,10,1032,406
2502,1220,866,354,289,230,191,132,117,261,0,3140,1220
2503,774,670,104,120,113,114,88,111,228,0,1677,774
2504,939,813,126,146,137,138,106,135,277,10,2035,949
2505,445,381,64,23,35,52,51,82,202,0,1068,445
2506,465,398,67,24,37,54,54,85,211,0,1012,465
2507,506,325,181,46,54,71,65,85,185,12,1861,518
2508,946,683,263,60,84,131,108,187,376,0,1847,946
2509,500,246,254,50,64,99,63,77,147,249,1893,749
2510,336,295,41,10,15,37,47,63,164,0,829,336
2511,1769,1277,492,111,157,245,202,350,704,0,5796,1769
2512,345,304,41,19,31,39,38,61,157,0,729,345
2513,327,280,47,17,26,38,38,60,148,4,690,331
2514,495,423,72,26,39,58,57,91,224,0,1100,495
2515,1196,1058,138,33,67,144,124,261,567,0,2868,1196
2516,511,446,65,122,150,39,39,49,112,0,1456,511
2517,240,210,30,16,16,31,34,49,94,0,533,240
2518,664,572,92,60,75,72,113,90,254,0,1495,664
2519,512,414,98,68,56,92,59,73,164,4,1434,516
2520,858,637,221,42,57,106,96,177,380,18,2116,876
2521,1219,931,288,229,223,171,121,149,326,12,3208,1231
2522,743,696,47,72,56,111,97,128,279,2,1237,745
2523,695,402,293,193,178,106,62,57,99,0,2271,695
2524,306,267,39,20,20,40,43,63,120,0,608,306
2525,1699,1482,217,404,499,130,130,163,373,0,3837,1699
2526,679,592,87,162,199,52,52,65,149,9,1301,688
2527,282,246,36,67,83,22,22,27,61,0,599,282
2528,366,317,49,40,49,34,43,60,140,12,942,378
2529,278,241,37,30,37,26,33,46,106,18,728,296
2530,565,489,76,61,76,53,67,93,215,0,1279,565
2531,564,486,78,51,63,61,96,76,217,25,1235,589
2532,429,328,101,81,79,60,42,52,115,0,857,429
2533,403,291,112,21,22,60,56,87,157,0,883,403
2534,1733,1406,327,228,231,290,205,237,542,33,5622,1766
2535,663,513,150,101,88,110,74,93,197,0,1101,663
2536,285,231,54,37,38,48,34,39,89,0,447,285
2537,1687,1369,318,222,225,282,200,231,527,0,3645,1687
2538,225,160,65,15,16,36,29,41,88,0,663,225
2539,672,477,195,44,49,107,88,124,260,0,1896,672
2540,285,183,102,7,11,44,36,67,120,17,891,302
2541,696,599,97,11,27,80,93,159,326,0,1510,696
2542,2056,1395,661,198,256,301,266,316,719,39,5712,2095
2543,1088,883,205,143,145,182,129,149,340,0,2864,1088
2544,328,254,74,50,43,54,36,46,99,9,852,337
2545,395,306,89,60,52,66,44,55,118,29,980,424
2546,621,302,319,76,66,121,70,91,197,0,1961,621
2547,210,102,108,26,22,41,24,31,66,0,702,210
2548,438,213,225,54,47,85,49,64,139,92,1333,530
2549,491,239,252,60,53,95,55,72,156,0,1675,491
2550,377,280,97,37,37,64,48,58,133,0,1073,377
2551,271,181,90,25,26,48,33,43,96,6,922,277
2552,396,265,131,36,38,71,48,63,140,0,1266,396
2553,316,212,104,29,30,56,38,50,113,46,991,362
2554,380,215,165,21,23,79,58,68,131,0,1343,380
2555,281,159,122,15,17,59,43,50,97,0,1001,281
2556,447,253,194,24,27,93,68,80,155,0,1598,447
2557,554,433,121,105,93,101,65,64,126,0,1492,554
2558,401,314,87,76,67,73,47,46,92,0,906,401
2559,489,382,107,92,82,89,57,56,113,9,1086,498
2560,508,397,111,96,85,92,59,58,118,36,1217,544
2561,308,148,160,78,110,37,25,22,36,0,1162,308
2562,584,280,304,148,208,70,48,41,69,11,2267,595
2563,1106,530,576,280,394,133,91,78,130,0,3963,1106
2564,417,241,176,116,107,64,37,34,59,0,1305,417
2565,533,308,225,148,137,81,48,44,75,0,1619,533
2566,781,451,330,217,200,119,70,64,111,10,1899,791
2567,828,492,336,220,239,117,81,65,106,0,2562,828
2568,460,273,187,122,133,65,45,36,59,0,1389,460
2569,378,225,153,100,109,54,37,30,48,10,1172,388
2570,408,251,157,69,66,86,50,48,89,0,1284,408
2571,439,270,169,74,71,92,53,52,97,12,1308,451
2572,549,338,211,93,89,115,67,65,120,0,1693,549
2573,788,637,151,105,87,141,91,112,252,1,1975,789
2574,1049,705,344,218,265,141,108,105,212,268,3112,1317
2575,638,429,209,132,161,86,66,64,129,37,1935,675
2576,496,333,163,103,125,67,51,50,100,17,1440,513
2577,703,473,230,146,178,94,72,70,143,4,2032,707
2578,976,693,283,231,184,153,106,94,208,24,2776,1000
2579,655,465,190,155,123,103,71,63,140,47,1608,702
2580,581,503,78,90,85,86,66,83,171,0,1176,581
2581,771,509,262,160,231,125,108,74,73,69,2467,840
2582,456,308,148,45,55,79,65,73,139,0,1105,456
2583,560,378,182,56,68,97,80,89,170,15,1594,575
2584,915,514,401,90,112,153,111,141,308,0,2946,915
2585,642,561,81,155,157,31,69,67,163,0,1334,642
2586,984,861,123,238,241,47,106,103,249,1,2123,985
2587,475,429,46,73,75,63,46,61,157,0,1095,475
2588,559,505,54,86,88,74,54,72,185,3,1236,562
2589,304,148,156,37,33,59,34,44,97,0,1056,304
2590,312,152,160,38,33,61,35,46,99,0,1045,312
2591,381,291,90,72,70,53,38,47,101,6,1276,387
2592,3084,2035,1049,641,924,501,433,295,290,0,9219,3084
2593,243,172,71,16,18,39,32,45,93,0,717,243
2594,530,260,270,53,67,105,67,81,157,0,1786,530
2595,530,260,270,53,67,105,67,81,157,0,1889,530
2596,663,513,150,101,88,110,74,93,197,0,1814,663
2597,296,260,36,9,13,33,41,55,145,4,700,300
2598,301,264,37,9,13,33,42,56,148,0,734,301
2599,434,382,52,24,39,49,48,77,197,25,893,459
2600,540,317,223,55,65,96,60,76,188,0,1786,540
2601,909,534,375,92,109,162,102,128,316,4,2439,913
2602,275,162,113,28,33,49,31,39,95,0,917,275
2603,737,547,190,36,49,91,83,152,326,12,1640,749
2604,284,231,53,25,22,43,36,47,111,0,655,284
2605,341,277,64,30,26,52,43,56,134,17,791,358
2606,1106,762,344,74,87,143,101,183,518,0,3066,1106
2607,687,534,153,27,36,95,104,121,304,43,1509,730
2608,1804,1363,441,34,78,238,233,394,827,30,4390,1834
2609,1371,1100,271,11,47,197,162,292,662,30,3231,1401
2610,2912,2166,746,45,115,441,359,619,1333,34,7425,2946
2611,1278,863,415,15,33,220,133,307,570,0,3389,1278
2612,382,285,97,4,11,63,33,93,178,0,817,382
2613,1884,1559,325,88,96,323,236,375,766,23,4518,1907
2614,1846,1344,502,47,106,272,229,394,798,9,4331,1855
2615,243,182,61,7,12,37,36,53,98,87,547,330
2616,1180,916,264,13,37,137,168,296,529,14,2671,1194
2617,882,682,200,12,35,105,117,203,410,0,1866,882
2618,2588,2098,490,49,115,349,309,605,1161,30,5867,2618
2619,1602,1408,194,170,211,181,164,252,624,6,3317,1608
2620,1656,1299,357,28,74,216,185,374,779,253,3849,1909
2621,1452,1124,328,59,105,224,171,300,593,51,3888,1503
2622,587,455,132,60,61,78,76,100,212,0,1273,587
2623,224,173,51,23,23,30,29,38,81,6,505,230
2624,2733,2065,668,47,111,394,345,613,1223,0,7029,2733
2625,2027,1568,459,41,93,309,254,451,879,128,4794,2155
2626,1512,1209,303,67,85,237,155,329,639,11,3689,1523
2627,3071,2392,679,171,216,510,352,611,1211,37,6828,3108
2628,2675,1564,1111,186,245,474,261,506,1003,23,8256,2698
2629,534,404,130,9,19,92,65,125,224,20,1396,554
2630,975,636,339,18,37,147,139,221,413,0,2465,975
2631,370,267,103,8,13,54,54,88,153,0,950,370
2632,3298,2501,797,154,190,505,352,765,1332,30,8010,3328
2633,1455,1155,300,13,45,155,216,345,681,31,3410,1486
2634,3100,2259,841,100,139,470,358,704,1329,25,7857,3125
2635,1472,1138,334,32,62,227,173,369,609,0,3752,1472
2636,993,743,250,33,52,86,82,133,607,0,2459,993
2637,426,330,96,17,31,66,50,88,174,128,1946,554
2638,2731,1883,848,184,214,354,249,453,1277,0,8355,2731
2639,882,857,25,316,248,47,114,61,96,118,1418,1000
2640,485,410,75,55,83,73,56,91,127,407,885,892
2641,1122,986,136,119,148,127,115,177,436,20,2247,1142
2642,640,472,168,33,42,102,76,129,258,5,1550,645
2643,754,549,205,19,43,111,93,161,327,0,1838,754
2644,373,319,54,13,28,59,48,76,149,0,782,373
2645,608,514,94,68,104,92,70,114,160,3,1216,611
2646,613,525,88,21,46,97,79,125,245,0,1358,613
2647,711,535,176,13,20,106,74,170,328,0,1599,711
2648,524,394,130,9,15,78,55,125,242,3,1151,527
2649,520,391,129,9,15,77,54,124,241,0,1336,520
2650,786,588,198,26,41,68,65,105,481,0,1455,786
2651,647,452,195,72,101,118,91,106,159,0,1405,647
2652,314,276,38,33,41,35,32,49,124,0,753,314
2653,1528,1343,185,162,201,173,157,241,594,0,2407,1528
2654,1963,1725,238,208,259,222,201,309,764,19,3035,1982
2655,952,599,353,183,368,110,93,83,115,0,2955,952
2656,8835,5502,3333,1077,1920,826,751,1255,3006,0,29298,8835
2657,5175,3223,1952,631,1125,484,440,735,1760,0,16794,5175
2658,792,593,199,21,41,122,117,172,319,0,1707,792
2659,1071,832,239,43,56,148,163,189,472,80,2203,1151
2660,408,285,123,46,64,74,57,67,100,0,1017,408
2661,554,414,140,18,29,48,46,74,339,0,1258,554
2662,834,662,172,7,26,89,124,198,390,14,1998,848
2663,721,542,179,13,20,107,75,173,333,54,1722,775
2664,789,613,176,8,25,92,112,198,354,0,1814,789
2665,247,191,56,3,10,29,33,57,115,0,562,247
2666,589,457,132,23,31,81,90,104,260,0,1360,589
2667,1076,833,243,43,78,166,127,223,439,0,2062,1076
2668,3193,3054,139,1073,891,497,198,274,260,2,5727,3195
2669,1912,1829,83,643,533,298,119,164,155,60,2863,1972
2670,570,421,149,32,38,99,70,115,216,84,1333,654
2671,466,344,122,27,31,81,57,94,176,14,1145,480
2672,548,424,124,56,57,73,71,93,198,26,1305,574
2673,560,434,126,58,58,75,72,95,202,57,1170,617
2674,445,345,100,46,46,59,57,76,161,15,1063,460
2675,564,443,121,9,25,74,63,127,266,0,1176,564
2676,600,419,181,67,94,109,85,98,147,0,1707,600
2677,730,460,270,141,282,84,71,64,88,0,2115,730
2678,702,491,211,78,110,128,99,115,172,0,1716,702
2679,1015,796,219,238,335,71,71,104,196,33,2580,1048
2680,496,389,107,116,164,35,35,51,95,0,1217,496
2681,548,469,79,18,41,87,70,112,220,6,1232,554
2682,306,200,106,6,12,46,44,69,129,236,737,542
2683,755,565,190,20,39,116,111,164,305,3,1926,758
2684,708,530,178,19,36,109,104,153,287,0,1804,708
2685,467,366,101,109,154,33,33,48,90,31,1136,498
2686,502,379,123,9,18,87,61,117,210,26,1256,528
2687,127,105,22,6,6,22,16,25,52,0,252,127
2688,79,65,14,4,4,14,10,16,31,40,174,119
2689,1133,938,195,53,58,195,142,225,460,129,2369,1262
2690,380,284,96,10,19,58,56,82,155,0,798,380
2691,287,215,72,8,15,44,42,62,116,6,644,293
2692,4111,3074,1037,137,214,356,338,551,2515,126,9819,4237
2693,582,452,130,6,18,68,83,146,261,14,1471,596
2694,665,514,151,9,26,79,88,153,310,26,1496,691
2695,433,315,118,11,25,64,54,92,187,51,919,484
2696,583,431,152,33,39,101,72,118,220,27,1580,610
2697,616,455,161,35,42,107,76,124,232,6,1613,622
2698,375,276,99,19,25,60,44,76,151,9,1045,384
2699,574,423,151,29,38,91,68,116,232,37,1610,611
2700,364,268,96,19,24,58,43,74,146,6,954,370
2701,691,535,156,71,71,92,89,117,251,0,1364,691
2702,1012,942,70,160,206,75,89,128,354,0,1664,1012
2703,2384,2065,319,96,140,377,308,480,983,62,5513,2446
2704,2271,1818,453,30,60,316,311,506,1048,21,5311,2292
2705,1151,950,201,21,35,135,111,295,554,13,2706,1164
2706,2140,1735,405,24,47,262,272,526,1009,55,5577,2195
2707,1732,1473,259,63,86,212,225,341,805,36,3572,1768
2708,1369,1147,222,25,50,197,193,280,624,23,3214,1392
2709,582,501,81,60,69,66,71,109,207,4,1391,586
2710,1469,1184,285,20,52,209,211,311,666,15,3527,1484
2711,6199,6197,2,224,415,992,642,1194,2732,0,7257,6199
2712,979,866,113,48,49,92,134,232,424,1921,2295,2900
2713,583,488,95,97,158,81,77,62,108,0,1585,583
2714,177,148,29,30,48,24,23,19,33,0,525,177
2715,753,577,176,4,17,98,105,194,335,0,1989,753
2716,1954,1702,252,66,96,223,246,461,862,1191,4997,3145
2717,3040,2511,529,157,154,367,362,656,1344,0,7014,3040
2718,1389,1238,151,78,108,194,153,263,593,0,3108,1389
2719,494,388,106,35,43,60,71,98,187,0,1299,494
2720,1287,1061,226,274,274,103,123,181,332,0,3263,1287
2721,1215,908,307,12,33,127,177,318,548,15,3147,1230
2722,275,223,52,8,10,35,40,70,112,0,691,275
2723,718,593,125,4,15,88,116,174,321,0,1855,718
2724,974,893,81,113,135,84,96,128,418,0,2144,974
2725,1921,1716,205,58,124,314,225,379,821,61,4382,1982
2726,1082,851,231,76,94,132,156,214,410,0,2854,1082
2727,2414,2246,168,383,491,179,211,304,846,36,4066,2450
2728,1212,1109,103,212,273,123,129,128,347,12,2176,1224
2729,3414,3123,291,598,770,348,364,361,973,0,6690,3414
2730,678,625,53,22,35,88,82,131,320,0,1226,678
2731,432,398,34,14,22,56,52,83,205,0,1032,432
2732,929,856,73,30,48,121,113,179,438,2,1691,931
2733,1981,1812,169,347,447,202,211,209,565,42,3103,2023
2734,1574,1444,130,183,218,135,155,207,676,0,3250,1574
2735,1254,1049,205,91,111,162,153,200,537,5,2713,1259
2736,573,487,86,21,29,70,74,113,266,0,1410,573
2737,406,374,32,13,21,53,49,78,192,2,748,408
2738,566,518,48,99,128,58,60,60,161,0,1075,566
2739,1720,1347,373,358,454,133,153,223,399,3,4438,1723
2740,286,232,54,8,10,36,41,73,118,0,730,286
2741,451,366,85,12,16,57,65,114,187,0,1175,451
2742,278,233,45,20,25,36,34,44,119,0,705,278
2743,520,435,85,38,46,67,63,83,223,0,1236,520
2744,661,553,108,48,58,85,81,105,284,24,1525,685
2745,1084,933,151,112,129,123,133,203,384,4,2027,1088
2746,780,655,125,61,58,75,83,165,338,51,1869,831
2747,1828,1535,293,143,137,177,193,386,792,9,4410,1837
2748,1308,1200,108,152,181,112,129,172,562,0,2254,1308
2749,269,229,40,10,13,33,35,53,125,21,663,290
2750,727,618,109,26,36,89,95,143,338,0,1768,727
2751,799,670,129,15,29,115,113,163,364,14,1597,813
2752,346,300,46,14,20,55,45,70,142,13,989,359
2753,549,473,76,57,65,62,67,103,195,0,1219,549
2754,641,527,114,70,92,76,85,101,217,0,1658,641
2755,1354,1134,220,226,367,187,179,144,251,0,3072,1354
2756,743,582,161,155,196,57,66,96,173,33,1951,776
2757,885,728,157,96,128,105,118,140,298,11,1919,896
2758,1113,915,198,121,161,132,148,176,375,0,2657,1113
2759,2096,1756,340,350,569,290,276,223,388,0,3904,2096
2760,439,337,102,2,10,57,61,113,196,0,1187,439
2761,875,671,204,5,20,113,122,225,390,0,2279,875
2762,558,453,105,15,20,71,80,141,231,6,1475,564
2763,1972,1626,346,419,419,157,188,277,512,10,3755,1982
2764,607,500,107,129,129,48,58,85,158,0,1526,607
2765,647,519,128,53,71,94,66,122,241,0,1636,647
2766,2183,1511,672,47,94,305,264,506,967,45,6381,2228
2767,2635,1848,787,75,105,392,298,594,1171,75,7147,2710
2768,367,236,131,2,10,45,56,88,166,0,1056,367
2769,1885,1373,512,70,103,303,260,391,758,44,4822,1929
2770,1318,1051,267,20,41,161,192,319,585,0,3108,1318
2771,14613,9626,4987,532,1045,1780,2215,3400,5641,348,42284,14961
2772,3967,2923,1044,28,98,545,527,990,1779,19,9736,3986
2773,2551,2131,420,119,132,254,326,519,1201,0,5268,2551
2774,2798,2041,757,108,116,317,326,593,1338,0,7870,2798
2775,5358,4200,1158,271,395,852,648,1082,2110,37,13050,5395
2776,1675,1334,341,74,107,186,186,339,783,0,3594,1675
2777,1936,1413,523,10,63,260,302,455,846,55,5124,1991
2778,2793,2077,716,28,84,417,411,648,1205,11,6535,2804
2779,4023,2705,1318,50,121,612,562,975,1703,16,10286,4039
2780,1331,801,530,30,56,179,184,283,599,0,3956,1331
2781,1194,951,243,52,76,132,132,242,560,0,3105,1194
2782,235,171,64,9,10,27,27,50,112,0,680,235
2783,534,321,213,12,22,72,74,113,241,0,1418,534
2784,443,266,177,10,19,60,61,94,199,17,1268,460
2785,1104,879,225,48,71,122,122,224,517,0,1991,1104
2786,562,338,224,13,24,76,77,119,253,8,1462,570
2787,347,223,124,2,10,42,53,83,157,3,990,350
2788,526,338,188,3,14,64,80,126,239,11,1521,537
2789,3048,2546,502,142,158,304,390,620,1434,0,7284,3048
2790,1244,908,336,48,52,141,145,264,594,0,2677,1244
2791,2076,1515,561,80,86,235,242,440,993,0,5640,2076
2792,1615,1210,405,30,80,278,251,396,580,47,4589,1662
2793,1478,1118,360,163,187,276,195,206,451,9,4249,1487
2794,1079,701,378,177,152,200,125,132,293,139,3119,1218
2795,1356,818,538,226,238,238,159,180,315,2,3476,1358
2796,456,317,139,29,37,70,58,96,166,0,1323,456
2797,1295,916,379,63,119,233,184,238,458,36,3164,1331
2798,338,206,132,9,22,59,46,61,141,6,1109,344
2799,1216,1072,144,101,127,215,166,221,386,30,2552,1246
2800,1314,716,598,37,74,214,191,314,484,23,4458,1337
2801,1891,1137,754,137,208,256,264,391,635,0,6217,1891
2802,2371,1586,785,99,156,346,327,536,907,0,7703,2371
2803,1458,1044,414,83,117,290,201,241,526,0,4321,1458
2804,1278,845,433,26,59,221,153,261,558,13,3931,1291
2805,2342,1549,793,47,108,405,281,479,1022,21,6024,2363
2806,630,487,143,134,162,95,70,65,104,17,1828,647
2807,2859,2071,788,112,205,504,443,541,1054,57,8219,2916
2808,1097,724,373,122,174,171,137,175,318,28,3026,1125
2809,192,127,65,21,30,30,24,31,56,0,600,192
2810,1635,872,763,48,120,302,226,318,621,9,5898,1644
2811,6628,3681,2947,180,309,1005,823,1526,2785,115,20838,6743
2812,2054,1185,869,28,76,287,303,520,840,0,6437,2054
2813,1434,828,606,20,53,200,211,363,587,6,4209,1440
2814,5854,4386,1468,109,292,1007,911,1435,2100,168,15652,6022
2815,227,170,57,4,11,39,35,56,82,0,602,227
2816,372,196,176,14,34,66,49,67,142,4,1337,376
2817,832,487,345,35,59,124,118,180,316,5,2516,837
2818,220,145,75,24,35,34,27,35,65,0,727,220
2819,982,599,383,27,64,171,133,178,409,0,3064,982
2820,437,263,174,32,42,69,62,87,145,92,1334,529
2821,124,82,42,14,20,19,15,20,36,0,367,124
2822,685,412,273,50,75,93,96,142,229,0,2004,685
2823,1729,1013,716,72,122,258,245,373,659,0,5980,1729
2824,616,371,245,45,60,97,87,123,204,13,1266,629
2825,865,520,345,63,84,136,123,173,286,2,2603,867
2826,581,350,231,42,56,91,83,116,193,6,1724,587
2827,1085,591,494,30,61,176,158,259,401,2,3443,1087
2828,889,484,405,25,50,144,129,212,329,0,2764,889
2829,724,436,288,53,70,114,103,145,239,26,2005,750
2830,1120,866,254,238,287,169,125,116,185,0,2952,1120
2831,720,416,304,10,27,101,106,182,294,13,2158,733
2832,788,548,240,51,64,121,100,165,287,18,2354,806
2833,531,374,157,68,69,97,62,79,156,82,1238,613
2834,1045,819,226,158,199,175,143,144,226,59,2561,1104
2835,1968,1153,815,82,139,294,279,425,749,0,6564,1968
2836,449,270,179,33,43,70,64,90,149,0,1325,449
2837,2681,1586,1095,675,1038,199,108,247,414,0,7889,2681
2838,861,509,352,217,333,64,35,79,133,5,2460,866
2839,1019,588,431,14,38,142,150,258,417,0,3468,1019
2840,550,363,187,61,87,86,69,88,159,58,1710,608
2841,206,132,74,40,47,37,20,22,40,0,610,206
2842,532,341,191,102,123,95,52,57,103,4,1722,536
2843,600,340,260,62,80,123,77,99,159,0,2010,600
2844,787,555,232,101,102,144,91,117,232,12,1918,799
2845,444,313,131,57,58,81,52,66,130,198,1072,642
2846,365,257,108,47,47,67,42,54,108,58,979,423
2847,579,432,147,44,54,92,78,114,197,34,1532,613
2848,504,376,128,38,47,80,68,99,172,9,1355,513
2849,793,592,201,60,74,126,107,157,269,82,2272,875
2850,659,492,167,50,61,105,89,130,224,0,1950,659
2851,2908,2147,761,364,439,377,321,518,889,0,7675,2908
2852,230,165,65,13,18,46,32,38,83,0,653,230
2853,532,370,162,34,43,82,67,112,194,0,1513,532
2854,1024,711,313,66,84,157,130,215,372,0,2754,1024
2855,389,224,165,30,41,78,56,62,122,0,1220,389
2856,376,217,159,29,40,75,54,59,119,0,1148,376
2857,780,477,303,130,213,124,84,76,153,48,2475,828
2858,612,375,237,102,167,97,66,60,120,0,2200,612
2859,341,209,132,57,93,54,37,33,67,0,1003,341
2860,853,575,278,150,179,171,102,93,158,0,2198,853
2861,461,356,105,98,118,69,51,48,77,2,1088,463
2862,1480,1144,336,314,380,223,165,153,245,0,3239,1480
2863,441,232,209,16,40,78,58,79,170,6,1429,447
2864,820,446,374,119,179,132,116,101,173,0,2886,820
2865,665,439,226,74,106,103,83,106,193,0,2048,665
2866,390,238,152,11,25,68,53,71,162,0,1180,390
2867,646,456,190,83,84,118,75,96,190,0,1777,646
2868,1528,895,633,64,108,228,217,330,581,2,4704,1530
2869,400,227,173,41,53,82,52,66,106,23,1382,423
2870,1131,641,490,116,151,232,146,187,299,0,3504,1131
2871,404,259,145,78,93,72,39,43,79,0,1281,404
2872,1498,961,537,288,345,268,145,160,292,8,4214,1506
2873,451,336,115,34,42,72,61,89,153,0,1264,451
2874,1165,860,305,146,176,151,129,207,356,1,3606,1166
2875,447,350,97,68,85,75,61,61,97,0,1159,447
2876,1041,600,441,79,110,208,150,165,329,0,3836,1041
2877,365,241,124,41,58,57,46,58,105,0,1002,365
2878,492,259,233,18,45,87,65,88,189,0,1604,492
2879,13,8,5,1,1,2,2,3,4,66,33,79
2880,1177,708,469,86,130,159,164,243,395,0,3656,1177
2881,1662,1000,662,121,183,225,232,343,558,4,4934,1666
2882,1246,749,497,91,137,169,174,257,418,164,3307,1410
2883,1162,699,463,84,128,157,162,240,391,3,3369,1165
2884,826,552,274,35,54,121,114,187,315,15,2587,841
2885,461,308,153,19,30,67,64,104,177,0,1459,461
2886,645,431,214,27,42,94,89,146,247,0,1899,645
2887,422,282,140,18,28,62,58,95,161,0,1212,422
2888,516,345,171,22,34,75,71,117,197,3,1331,519
2889,585,391,194,24,38,85,81,132,225,4,1545,589
2890,1469,982,487,61,97,214,203,332,562,23,4571,1492
2891,2016,1348,668,84,132,294,278,456,772,0,3638,2016
2892,862,577,285,36,57,126,119,195,329,4,2750,866
2893,3300,2207,1093,138,217,482,455,746,1262,24,9457,3324
2894,2753,1841,912,115,181,402,380,623,1052,36,8960,2789
2895,780,522,258,33,51,114,108,176,298,11,2624,791
2896,2548,1388,1160,71,143,414,370,608,942,15,8606,2563
2897,62,46,16,1,3,11,10,15,22,0,172,62
2898,2691,2372,319,223,281,475,368,490,854,0,7896,2691
2899,4589,3051,1538,153,243,720,720,910,1843,49,13606,4638
2900,1226,915,311,31,65,211,158,282,479,26,3384,1252
2901,1330,1031,299,26,63,217,196,287,541,20,3192,1350
2902,1171,896,275,21,48,173,194,251,484,52,3540,1223
2903,1434,932,502,33,65,238,233,293,572,30,4646,1464
2904,3145,2185,960,50,106,472,497,719,1301,31,8060,3176
2905,1504,1112,392,178,169,272,193,271,421,809,3334,2313
2906,312,228,84,19,10,55,46,70,112,0,902,312
2907,856,682,174,17,42,143,126,188,340,0,2213,856
2908,2378,1858,520,42,95,379,366,526,970,58,6531,2436
2909,2032,1554,478,122,146,385,266,405,708,17,5094,2049
2910,805,611,194,14,34,122,121,187,327,56,2169,861
2911,616,427,189,174,223,54,38,51,76,20,1758,636
2912,877,570,307,40,49,175,143,164,306,0,2282,877
2913,347,219,128,7,15,58,45,84,138,30,1224,377
2914,1622,1046,576,23,53,265,230,385,666,38,5175,1660
2915,1285,925,360,22,41,195,194,303,530,0,3104,1285
2916,1453,1111,342,41,53,258,242,321,538,0,3441,1453
2917,273,197,76,13,20,51,32,54,103,118,539,391
2918,1931,1758,173,69,97,281,257,479,748,10,3619,1941
2919,2175,1659,516,61,78,317,273,500,946,34,5254,2209
2920,1639,1196,443,31,70,248,252,355,683,30,4132,1669
2921,1994,1148,846,27,62,294,308,480,823,18,5620,2012
2922,1674,1304,370,33,72,266,217,393,693,0,4080,1674
2923,1220,934,286,88,91,193,179,247,422,13,2679,1233
2924,820,544,276,113,108,158,119,114,208,25,2123,845
2925,849,616,233,40,50,155,135,157,312,0,1910,849
2926,372,235,137,8,16,62,49,90,147,19,1273,391
2927,442,284,158,6,21,72,59,99,185,0,1502,442
2928,2903,2012,891,820,1050,257,179,241,356,4,8207,2907
2929,902,715,187,389,332,65,43,28,45,10,1661,912
2930,1523,1207,316,657,561,109,73,47,76,330,2843,1853
2931,410,316,94,73,61,82,62,50,82,0,983,410
2932,445,359,86,8,20,72,68,100,177,0,943,445
2933,447,344,103,80,66,90,67,55,89,0,1024,447
2934,440,339,101,79,65,89,66,54,87,0,1126,440
2935,367,243,124,50,48,71,53,51,94,0,859,367
2936,321,229,92,9,17,54,38,67,136,10,776,331
2937,316,225,91,9,17,53,37,66,134,20,841,336
2938,505,360,145,14,27,85,59,105,215,0,1346,505
2939,484,391,93,9,22,79,74,109,191,0,1051,484
2940,332,268,64,6,15,54,51,75,131,0,736,332
2941,600,478,122,12,30,100,88,132,238,0,1545,600
2942,389,281,108,23,26,75,59,74,132,0,1147,389
2943,482,348,134,28,32,93,73,92,164,5,1403,487
2944,796,571,225,90,88,158,132,115,213,0,1690,796
2945,296,212,84,33,33,59,49,43,79,18,695,314
2946,588,426,162,28,35,107,93,109,216,92,1510,680
2947,341,219,122,5,16,55,46,76,143,40,1200,381
2948,384,247,137,5,18,62,51,86,162,40,1400,424
2949,829,598,231,40,61,156,97,165,310,98,2029,927
2950,650,469,181,31,48,122,76,130,243,38,1433,688
2951,288,172,116,7,12,47,41,72,109,13,849,301
2952,509,304,205,13,22,84,73,128,189,0,1658,509
2953,236,141,95,6,10,39,34,59,88,13,852,249
2954,552,330,222,14,24,91,79,138,206,30,1897,582
2955,579,418,161,34,39,111,88,111,196,0,1619,579
2956,1449,1268,181,335,271,187,166,153,337,83,2840,1532
2957,365,230,135,8,15,61,48,89,144,36,1241,401
2958,253,163,90,3,12,41,34,57,106,8,731,261
2959,859,684,175,17,42,144,126,189,341,5,2051,864
2960,15,10,5,2,3,2,2,2,4,0,17,15
2961,378,219,159,60,106,39,47,46,80,0,1063,378
2962,1789,1022,767,28,68,304,310,403,676,6,5448,1795
2963,737,345,392,48,85,109,126,175,194,2075,2210,2812
2964,9266,5797,3469,537,1158,1477,1532,2000,2562,0,26447,9266
2965,1201,827,374,30,106,197,184,248,436,0,3492,1201
2966,0,0,0,0,0,0,0,0,0,0,0,0
2967,758,548,210,84,145,114,104,135,176,0,2196,758
2968,1183,832,351,29,97,188,171,289,409,0,3016,1183
2969,2209,1764,445,57,131,364,333,518,806,0,5171,2209
2970,12340,9972,2368,545,1030,2456,1427,2796,4086,8,24180,12348
2971,1253,942,311,15,50,184,204,313,487,0,3001,1253
2972,3440,2791,649,184,279,576,555,670,1176,96,8586,3536
2973,427,265,162,6,19,74,78,88,162,0,1182,427
2974,1523,988,535,114,176,310,246,249,428,47,4134,1570
2975,950,712,238,16,43,142,153,225,371,0,2120,950
2976,608,328,280,14,36,92,94,146,226,0,1814,608
2977,3090,2317,773,142,263,437,506,648,1094,13,8335,3103
2978,5436,4029,1407,105,266,797,754,1164,2350,79,13259,5515
2979,8452,5481,2971,616,1010,1186,1314,1548,2778,18,24829,8470
2980,1797,1167,630,121,182,327,295,332,540,190,5128,1987
2981,1639,1120,519,177,209,294,251,283,425,57,5116,1696
2982,1168,731,437,115,143,200,169,235,306,14,3447,1182
2983,2038,1341,697,96,146,358,320,394,724,45,5730,2083
2984,1618,992,626,63,89,248,249,382,587,17,4508,1635
2985,1183,657,526,20,46,190,201,274,452,0,3349,1183
2986,1657,1197,460,95,133,269,296,329,535,0,4906,1657
2987,2540,2118,422,106,181,459,324,587,883,0,4612,2540
2988,1566,1258,308,19,81,237,235,424,570,17,3703,1583
2989,9093,7312,1781,397,817,1135,1143,1957,3644,52,21911,9145
2990,1037,674,363,16,67,169,162,255,368,0,2773,1037
2991,1917,1229,688,34,112,307,304,442,718,17,5136,1934
2992,461,378,83,14,34,70,69,97,177,6,1036,467
2993,2324,1644,680,99,198,438,302,477,810,0,5474,2324
2994,1505,1292,213,42,89,266,192,324,592,8,4105,1513
2995,4374,2685,1689,139,333,715,669,934,1584,11,12352,4385
2996,1496,1100,396,86,168,253,205,304,480,0,3625,1496
2997,1003,731,272,33,68,173,128,245,356,42,2930,1045
2998,941,584,357,13,42,162,172,194,358,17,2864,958
2999,1585,919,666,252,446,164,198,194,331,0,4950,1585
3000,485,317,168,17,39,79,78,112,160,0,1394,485
3001,971,635,336,35,77,159,156,224,320,3,2870,974
3002,393,257,136,14,31,64,63,91,130,0,960,393
3003,678,462,216,46,95,106,98,135,198,0,1933,678
3004,654,428,226,24,52,107,105,151,215,0,2047,654
3005,0,0,0,0,0,0,0,0,0,0,0,0
3006,16308,10576,5732,1189,1949,2288,2536,2988,5358,0,53710,16308
3007,529,346,183,19,42,87,85,122,174,0,1441,529
3008,655,446,209,44,92,103,95,130,191,0,2152,655
3009,772,526,246,52,108,121,112,153,226,0,2584,772
3010,454,297,157,16,36,74,73,105,150,0,1441,454
3011,444,302,142,30,62,69,64,88,131,0,1316,444
3012,272,185,87,34,46,40,40,44,68,11,792,283
3013,33,22,11,4,6,5,5,5,8,0,68,33
3014,510,346,164,64,86,74,74,83,129,0,1288,510
3015,861,527,334,52,61,161,138,168,281,11,2449,872
3016,505,293,212,80,142,52,63,62,106,0,1427,505
3017,907,616,291,114,153,132,132,147,229,0,1931,907
3018,449,258,191,12,25,86,83,93,150,14,1507,463
3019,178,130,48,6,12,31,23,43,63,0,464,178
3020,392,240,152,24,28,73,63,76,128,3,1003,395
3021,835,650,185,245,231,74,89,71,125,69,2146,904
3022,644,466,178,52,72,122,110,117,171,48,1619,692
3023,222,160,62,18,25,42,38,40,59,23,589,245
3024,330,257,73,97,91,29,35,28,50,3,774,333
3025,527,302,225,15,30,101,98,109,174,17,1764,544
3026,413,253,160,25,29,77,66,81,135,0,1149,413
3027,1503,1127,376,25,68,225,243,356,586,9,4474,1512
3028,1431,1073,358,24,65,215,231,339,557,0,3978,1431
3029,2842,1534,1308,66,167,430,437,683,1059,0,8379,2842
3030,736,397,339,17,43,111,113,177,275,8,2143,744
3031,200,164,36,6,15,30,30,42,77,20,561,220
3032,276,226,50,8,20,42,41,58,107,0,683,276
3033,959,787,172,29,71,145,143,203,368,14,2228,973
3034,429,310,119,48,82,65,59,77,98,0,940,429
3035,302,218,84,34,58,46,41,54,69,0,520,302
3036,259,187,72,29,50,39,35,46,60,0,620,259
3037,763,551,212,85,146,115,104,136,177,0,1201,763
3038,651,543,108,27,46,118,83,150,227,0,1862,651
3039,708,590,118,30,50,128,90,164,246,0,1728,708
3040,490,409,81,20,35,89,63,113,170,0,1023,490
3041,17,12,5,1,1,3,2,4,6,0,56,17
3042,0,0,0,0,0,0,0,0,0,0,0,0
3043,0,0,0,0,0,0,0,0,0,0,0,0
3044,0,0,0,0,0,0,0,0,0,0,0,0
3045,5,4,1,0,0,1,1,1,2,0,14,5
3046,1124,763,361,141,190,164,164,182,283,17,3217,1141
3047,292,205,87,10,20,43,46,54,119,0,777,292
3048,3395,2536,859,155,274,516,426,748,1276,72,8024,3467
3049,2299,1456,843,57,178,367,294,493,910,39,5854,2338
3050,1568,1224,344,35,88,281,198,363,603,116,3239,1684
3051,2685,2051,634,281,377,416,308,475,828,9,6815,2694
3052,2456,1790,666,85,176,400,321,538,936,39,5074,2495
3053,1164,886,278,17,60,201,163,245,478,4,2468,1168
3054,2306,1876,430,70,142,362,303,478,951,91,4483,2397
3055,39,39,0,7,7,5,4,7,9,128,36,167
3056,1742,1082,660,50,117,219,228,382,746,96,5370,1838
3057,3013,2318,695,218,335,514,410,636,900,0,8305,3013
3058,337,243,94,16,27,54,44,73,123,0,767,337
3059,1175,824,351,84,130,165,149,225,422,0,3065,1175
3060,798,505,293,24,62,123,115,190,284,2,1845,800
3061,500,400,100,23,37,74,64,109,193,12,1138,512
3062,662,529,133,31,49,97,84,145,256,0,1422,662
3063,576,458,118,89,103,79,64,89,152,0,1305,576
3064,336,267,69,52,60,46,37,52,89,281,574,617
3065,448,323,125,21,36,72,59,97,163,0,892,448
3066,484,349,135,22,38,77,64,105,178,32,953,516
3067,1058,787,271,55,82,159,132,220,410,23,2442,1081
3068,764,559,205,89,124,104,84,113,250,13,1679,777
3069,882,701,181,136,157,121,98,136,234,251,1313,1133
3070,433,305,128,15,29,64,69,80,176,0,1258,433
3071,903,635,268,31,61,133,144,166,368,0,2192,903
3072,971,722,249,50,76,146,121,202,376,0,2612,971
3073,369,270,99,43,60,50,41,55,120,0,633,369
3074,854,599,255,61,95,120,109,164,305,0,2115,854
3075,1455,1020,435,104,161,204,185,279,522,84,3346,1539
3076,581,465,116,27,43,86,74,127,224,0,1234,581
3077,436,324,112,22,34,66,54,91,169,0,1024,436
3078,407,303,104,21,32,61,51,85,157,154,821,561
3079,411,306,105,21,32,62,51,85,160,0,1073,411
3080,516,321,195,15,35,65,67,113,221,0,1683,516
3081,640,398,242,18,43,81,84,140,274,0,2081,640
3082,553,425,128,40,61,94,75,117,166,11,1809,564
3083,1008,775,233,73,112,172,137,213,301,0,2886,1008
3084,1180,1056,124,42,85,166,162,274,451,150,1757,1330
3085,2705,2141,564,146,244,463,355,564,933,241,5301,2946
3086,862,653,209,24,52,151,128,217,290,25,1641,887
3087,2092,1674,418,115,211,378,335,428,625,51,4133,2143
3088,1936,1657,279,62,130,296,244,467,737,28,4031,1964
3089,2676,2178,498,38,138,434,343,612,1111,87,5500,2763
3090,982,801,181,23,61,178,149,230,341,37,2122,1019
3091,1874,1664,210,34,95,331,302,400,712,2455,4235,4329
3092,706,592,114,17,33,124,104,180,248,156,1290,862
3093,5,3,2,0,0,1,1,1,2,0,12,5
3094,483,300,183,14,32,61,63,106,207,0,1974,483
3095,1,1,0,0,0,0,0,0,1,0,2,1
3096,1,1,0,0,0,0,0,0,1,0,2,1
3097,0,0,0,0,0,0,0,0,0,0,0,0
3098,0,0,0,0,0,0,0,0,0,0,0,0
3099,1,1,0,0,0,0,0,0,1,0,5,1
3100,0,0,0,0,0,0,0,0,0,0,0,0
3101,297,242,55,4,15,48,38,68,124,37,701,334
3102,308,251,57,4,16,50,39,70,129,0,756,308
3103,187,152,35,3,10,30,24,43,77,19,393,206
3104,1114,926,188,23,85,225,137,246,398,5,2093,1119
3105,2256,2122,134,48,141,414,314,511,828,25,3401,2281
3106,2243,1631,612,56,142,373,368,433,871,57,4644,2300
3107,2201,1810,391,46,116,395,401,459,784,150,3686,2351
3108,3501,2484,1017,125,269,554,449,711,1393,0,7300,3501
3109,1502,1108,394,67,103,233,192,317,590,0,3113,1502
3110,3052,2314,738,179,229,453,460,530,1201,73,5971,3125
3111,6373,4529,1844,598,1020,885,765,1036,2069,84,13394,6457
3112,455,323,132,43,63,69,57,75,148,0,1008,455
3113,1530,1228,302,136,195,259,198,251,491,5,2865,1535
3114,544,379,165,62,93,88,68,79,154,12,1081,556
3115,1553,1254,299,122,169,261,220,270,511,0,2630,1553
3116,989,862,127,63,88,130,140,197,371,4645,2571,5634
3117,978,698,280,64,99,182,116,169,348,0,2227,978
3118,5722,4732,990,1209,2206,484,382,494,947,561,10341,6283
3119,1664,1296,368,77,129,279,206,333,640,0,3398,1664
3120,762,645,117,32,63,120,128,129,290,0,1612,762
3121,494,394,100,17,34,89,55,92,207,2,733,496
3122,1064,850,214,36,74,193,119,198,444,0,1904,1064
3123,1886,1483,403,166,206,221,199,329,765,20,3667,1906
3124,1766,1321,445,33,106,327,237,349,714,831,3843,2597
3125,2742,2202,540,244,349,464,355,449,881,149,5202,2891
3126,2902,2295,607,604,613,443,365,328,549,0,5628,2902
3127,490,353,137,18,34,78,61,104,195,0,1052,490
3128,9538,8016,1522,416,623,1108,941,1791,4659,24,17553,9562
3129,3387,2435,952,144,263,599,446,677,1258,0,6748,3387
3130,4022,3522,500,150,313,680,541,831,1507,0,6808,4022
3131,2638,2331,307,85,210,483,365,526,969,53,4028,2691
3132,3405,2279,1126,201,349,545,552,632,1126,30,7439,3435
3133,1637,1192,445,61,122,217,271,318,648,22,4084,1659
3134,1387,1125,262,41,61,213,155,362,555,123,2747,1510
3135,3975,3878,97,73,285,725,622,894,1376,0,5166,3975
3136,2110,1708,402,83,151,384,272,452,768,24,3806,2134
3137,5217,4297,920,158,329,978,621,1199,1932,70,9484,5287
3138,1366,1073,293,38,61,283,176,309,499,13,2560,1379
3139,3302,2620,682,55,192,591,465,781,1218,72,6722,3374
3140,916,731,185,81,103,165,124,152,291,16,2143,932
3141,1377,1069,308,182,351,197,99,208,340,0,2691,1377
3142,1374,1132,242,241,287,215,171,178,282,435,2407,1809
3143,1651,1316,335,179,230,296,221,289,436,96,2760,1747
3144,1695,1177,518,82,126,344,214,367,562,32,3341,1727
3145,1973,1328,645,59,138,375,272,452,677,66,4239,2039
3146,1274,997,277,250,372,178,149,148,177,32,2803,1306
3147,1327,772,555,189,249,206,202,179,302,40,3618,1367
3148,512,318,194,66,80,80,70,86,130,13,1525,525
3149,1507,865,642,144,164,262,233,255,449,53,3626,1560
3150,596,342,254,57,65,103,92,101,178,21,1422,617
3151,2625,2094,531,85,238,471,337,571,923,0,4742,2625
3152,3443,2549,894,74,217,706,463,807,1176,32,7430,3475
3153,2197,1600,597,54,133,381,279,529,821,19,4815,2216
3154,2183,1695,488,473,585,326,265,239,295,17,5256,2200
3155,984,694,290,93,113,180,131,172,295,29,2218,1013
3156,2364,1737,627,59,119,413,345,577,851,45,5434,2409
3157,2459,1911,548,159,190,446,295,481,888,40,5322,2499
3158,1205,557,648,63,82,235,160,251,414,289,3526,1494
3159,2314,1378,936,234,251,428,357,394,650,82,5489,2396
3160,748,510,238,31,48,135,107,151,276,69,1812,817
3161,1781,1481,300,68,130,279,279,356,669,40,3185,1821
3162,1712,1344,368,117,179,297,205,353,561,13,3230,1725
3163,1800,1419,381,45,114,304,248,416,673,24,3419,1824
3164,1591,1268,323,35,103,312,228,374,539,0,3056,1591
3165,2240,1774,466,62,139,409,299,551,780,194,4246,2434
3166,2699,1637,1062,230,342,531,404,456,736,57,6637,2756
3167,4499,3154,1345,400,504,857,620,853,1265,62,9935,4561
3168,2862,2328,534,158,226,536,316,612,1014,32,5187,2894
3169,2632,2186,446,118,188,501,342,575,908,141,4758,2773
3170,1368,1059,309,22,50,256,170,346,524,45,2641,1413
3171,1270,1116,154,325,360,168,134,122,161,565,1856,1835
3172,805,700,105,132,191,132,93,99,158,92,1449,897
3173,2846,2337,509,162,236,562,320,605,961,117,5068,2963
3174,1777,1597,180,190,256,342,240,283,466,0,2723,1777
3175,1689,1486,203,65,115,330,180,379,620,138,3040,1827
3176,2410,2119,291,89,198,445,380,494,804,84,3626,2494
3177,2239,1857,382,75,157,446,341,479,741,1603,3746,3842
3178,1617,1307,310,48,112,321,232,386,518,57,2862,1674
3179,859,618,241,103,151,130,109,135,231,19,1881,878
3180,1503,1176,327,43,106,306,203,344,501,0,2916,1503
3181,1242,1021,221,25,86,220,150,301,460,141,2432,1383
3182,1501,1160,341,31,108,279,217,354,512,173,3204,1674
3183,5735,4336,1399,309,568,1028,838,1150,1842,78,11983,5813
3184,3711,3281,430,105,331,755,500,717,1303,199,5893,3910
3185,2299,1966,333,57,175,450,371,503,743,0,3621,2299
3186,2053,1689,364,53,145,404,297,486,668,6,3560,2059
3187,317,190,127,14,32,58,50,61,102,67,744,384
3188,810,553,257,19,54,135,104,184,314,33,1789,843
3189,2151,1759,392,124,254,372,298,483,620,278,3654,2429
3190,1864,1176,688,193,224,250,319,308,570,2,3783,1866
3191,222,168,54,5,15,40,30,49,83,0,366,222
3192,79,61,18,10,20,11,6,12,20,32,167,111
3193,1163,838,325,44,80,184,145,247,463,0,2491,1163
3194,270,221,49,16,32,47,37,61,77,0,507,270
3195,712,426,286,31,71,131,112,136,231,0,1933,712
3196,348,208,140,15,35,64,55,67,112,8,1007,356
3197,1146,782,364,26,76,191,147,260,446,0,2492,1146
3198,1115,802,313,134,196,168,141,176,300,0,2734,1115
3199,2049,1226,823,89,206,377,324,392,661,8,5471,2057
3200,1154,830,324,138,202,174,146,182,312,0,1754,1154
3201,324,233,91,39,57,49,41,51,87,6,807,330
3202,631,454,177,76,111,95,80,100,169,0,1559,631
3203,195,140,55,23,34,29,25,31,53,6,392,201
3204,323,220,103,7,21,54,41,73,127,0,722,323
3205,486,332,154,11,32,81,62,110,190,0,875,486
3206,291,199,92,7,19,48,37,66,114,0,617,291
3207,361,246,115,8,24,60,46,82,141,0,819,361
3208,353,267,86,8,24,64,48,77,132,50,775,403
3209,719,545,174,15,49,131,98,158,268,0,1464,719
3210,717,543,174,15,49,131,98,157,267,0,1356,717
3211,172,133,39,23,44,25,12,26,42,5,376,177
3212,374,290,84,50,95,53,27,56,93,13,777,387
3213,517,401,116,69,132,74,37,78,127,13,980,530
3214,528,413,115,103,154,74,62,61,74,181,1231,709
3215,975,763,212,191,285,136,114,113,136,0,1469,975
3216,3026,2350,676,655,810,451,368,332,410,0,5077,3026
3217,574,446,128,124,154,86,70,63,77,0,1303,574
3218,487,303,184,63,76,76,66,82,124,64,1318,551
3219,374,232,142,48,58,58,51,63,96,3,915,377
3220,304,189,115,39,47,47,41,51,79,0,737,304
3221,693,431,262,89,108,108,94,116,178,501,1452,1194
3222,566,498,68,145,160,75,60,54,72,35,733,601
3223,421,297,124,40,48,77,56,74,126,11,1038,432
3224,775,546,229,74,89,142,103,135,232,16,1844,791
3225,405,352,53,67,96,67,47,50,78,11,687,416
3226,448,257,191,43,49,78,69,76,133,35,1034,483
3227,292,168,124,28,32,51,45,49,87,106,750,398
3228,634,442,192,72,109,103,80,92,178,0,1429,634
3229,433,312,121,16,30,69,54,92,172,0,899,433
3230,539,470,69,35,48,71,76,107,202,0,1140,539
3231,471,410,61,30,42,62,67,94,176,0,966,471
3232,256,223,33,16,23,34,36,51,96,10,514,266
3233,117,83,34,11,16,18,15,19,38,0,212,117
3234,606,431,175,57,84,92,76,100,197,17,1040,623
3235,428,304,124,41,59,65,53,71,139,0,865,428
3236,692,492,200,66,96,105,86,114,225,0,1176,692
3237,350,250,100,23,36,65,41,60,125,0,904,350
3238,483,344,139,31,49,90,57,83,173,0,968,483
3239,784,559,225,51,80,146,93,135,279,0,1584,784
3240,976,758,218,112,158,161,123,131,291,16,1903,992
3241,513,398,115,59,83,85,64,69,153,0,1173,513
3242,617,479,138,71,100,102,77,83,184,2,1059,619
3243,377,312,65,80,145,32,25,33,62,0,822,377
3244,364,301,63,77,140,31,24,31,61,2,556,366
3245,306,244,62,10,21,55,34,57,129,0,523,306
3246,453,383,70,19,38,71,76,77,172,0,849,453
3247,397,336,61,17,33,62,67,67,151,0,724,397
3248,354,300,54,15,29,56,60,60,134,0,699,354
3249,405,315,90,19,32,68,50,81,155,5,719,410
3250,423,295,128,48,73,69,53,62,118,335,999,758
3251,2898,1976,922,118,187,522,415,585,1071,435,7911,3333
3252,143,98,45,3,9,24,18,32,57,0,239,143
3253,963,876,87,63,86,206,105,173,330,215,1897,1178
3254,3110,2377,733,353,569,436,250,415,1087,132,8338,3242
3255,2891,2382,509,410,463,403,295,371,949,329,6586,3220
3256,685,596,89,27,39,109,62,141,307,6,1576,691
3257,774,582,192,68,118,107,78,108,295,0,1806,774
3258,2920,2237,683,148,329,444,300,546,1153,52,7477,2972
3259,3088,2465,623,209,299,500,297,576,1207,57,7583,3145
3260,2186,1657,529,117,183,330,207,413,936,24,5395,2210
3261,1559,1327,232,97,118,241,141,277,685,13,3188,1572
3262,1583,1295,288,364,618,172,89,112,228,0,4069,1583
3263,991,804,187,25,46,136,110,221,453,0,2322,991
3264,459,354,105,46,91,62,36,72,152,0,1166,459
3265,2440,1960,480,147,254,400,232,379,1028,109,6464,2549
3266,1075,946,129,114,116,152,79,169,445,23,1633,1098
3267,1821,1503,318,58,97,292,170,317,887,132,4298,1953
3268,2779,2413,366,189,288,393,213,447,1249,73,6351,2852
3269,684,623,61,87,88,77,46,92,294,37,1559,721
3270,1382,1129,253,107,159,229,156,216,515,11,2903,1393
3271,2816,2167,649,131,173,314,339,585,1274,122,6675,2938
3272,167,146,21,2,6,39,11,35,74,0,431,167
3273,806,696,110,49,76,169,99,146,267,9,1488,815
3274,1507,1245,262,107,145,284,147,238,586,34,3209,1541
3275,1631,1291,340,96,150,252,190,303,640,32,3504,1663
3276,2336,1942,394,92,164,362,244,412,1062,11,4978,2347
3277,1084,859,225,77,109,148,125,178,447,0,2559,1084
3278,2320,1935,385,280,321,247,211,316,945,53,4635,2373
3279,820,572,248,13,24,63,127,176,417,99,2114,919
3280,2218,1917,301,188,255,295,238,351,891,0,5031,2218
3281,547,472,75,40,50,69,47,96,245,435,1080,982
3282,2153,1813,340,75,140,270,233,419,1016,0,4548,2153
3283,2019,1742,277,326,330,223,174,240,726,107,4060,2126
3284,879,742,137,105,102,94,90,123,365,12,2124,891
3285,3169,1747,1422,477,708,319,346,398,921,50,12249,3219
3286,2054,1860,194,231,296,236,165,286,840,54,3971,2108
3287,2143,1788,355,182,238,231,180,327,985,0,4825,2143
3288,2172,1856,316,244,267,233,205,307,916,316,4261,2488
3289,1065,761,304,252,365,82,68,68,230,0,2523,1065
3290,251,241,10,13,21,38,25,37,117,122,473,373
3291,2124,1689,435,124,145,205,182,369,1099,14,5216,2138
3292,2514,2170,344,131,182,281,235,450,1235,18,5124,2532
3293,922,722,200,103,101,86,91,144,397,0,1633,922
3294,989,879,110,96,141,113,107,132,400,0,2086,989
3295,2233,1784,449,163,195,245,207,381,1042,0,5216,2233
3296,0,0,0,0,0,0,0,0,0,0,0,0
3297,2635,2315,320,287,326,267,297,411,1047,7,5720,2642
3298,2410,1936,474,108,118,277,261,399,1247,0,5977,2410
3299,2023,1752,271,276,259,258,186,281,763,0,4176,2023
3300,2068,1731,337,116,166,281,233,334,938,9,4133,2077
3301,2826,2290,536,123,166,328,265,476,1468,25,6179,2851
3302,1870,1520,350,94,139,241,182,329,885,0,4455,1870
3303,4364,4177,187,484,614,608,422,598,1638,21,7156,4385
3304,244,183,61,21,37,34,24,34,94,0,499,244
3305,81,62,19,9,15,11,7,11,28,0,255,81
3306,520,397,123,59,95,73,42,69,182,0,1129,520
3307,852,651,201,97,156,120,69,114,296,13,2236,865
3308,686,528,158,68,136,92,54,107,229,2,1848,688
3309,1276,1044,232,293,498,139,71,90,185,84,2514,1360
3310,853,726,127,53,65,132,77,151,375,0,2076,853
3311,1149,1011,138,122,124,163,85,181,474,0,2122,1149
3312,529,482,47,67,68,60,36,71,227,0,1213,529
3313,800,728,72,102,103,91,54,107,343,48,1426,848
3314,1073,977,96,137,138,121,72,144,461,9,2097,1082
3315,191,174,17,24,25,22,13,26,81,0,487,191
3316,146,133,13,19,19,17,10,20,61,36,305,182
3317,357,295,62,11,19,57,33,62,175,15,832,372
3318,659,570,89,56,76,88,71,104,264,0,1479,659
3319,709,613,96,60,81,94,76,112,286,35,1419,744
3320,1775,1531,244,129,162,223,152,312,797,676,3751,2451
3321,290,160,130,44,65,29,32,36,84,15,1162,305
3322,603,509,94,72,70,65,61,84,251,1,1639,604
3323,647,586,61,73,93,74,52,90,265,0,1683,647
3324,440,398,42,50,63,51,35,61,180,0,783,440
3325,177,153,24,9,13,20,17,32,86,0,358,177
3326,267,231,36,14,19,30,25,48,131,0,648,267
3327,83,69,14,7,9,9,7,13,38,0,156,83
3328,1544,1210,334,173,169,144,152,241,665,0,3881,1544
3329,78,61,17,9,9,7,8,12,33,0,164,78
3330,532,459,73,86,87,59,46,63,191,153,813,685
3331,324,280,44,52,53,36,28,39,116,4,490,328
3332,524,443,81,63,61,56,53,73,218,0,1148,524
