TAZ,HHLESSGQ,HHCHILDNO,HHCHILDYES,HHINC1,HHINC2,HHINC3,HHINC4,HHINC5,HHINC6,HHGQYES,HHGQNO,HHBASE
1,703,684,19,205,146,48,45,81,178,4,961,707
2,984,446,538,552,386,19,19,5,3,31,2773,1015
3,3220,3035,185,1222,724,224,191,223,636,19,5984,3239
4,2922,2758,164,697,391,285,262,294,993,0,5652,2922
5,4134,4061,73,1009,567,341,351,366,1500,6,6597,4140
6,1473,1430,43,372,220,152,146,138,445,19,2973,1492
7,554,505,49,210,104,51,50,38,101,0,1234,554
8,824,810,14,209,114,76,81,80,264,0,1290,824
9,8845,6943,1902,510,243,359,669,1474,5590,930,27368,9775
10,4619,4545,74,685,253,387,238,571,2485,156,9454,4775
11,892,813,79,339,167,82,81,62,161,0,1742,892
12,652,642,10,215,121,76,71,58,111,0,923,652
13,699,688,11,230,130,81,76,62,120,0,1089,699
14,1168,1143,25,527,182,160,71,78,150,325,1487,1493
15,575,563,12,259,90,79,35,39,73,0,998,575
16,1414,1383,31,637,221,194,86,95,181,267,1853,1681
17,1602,1567,35,722,250,219,98,108,205,0,1898,1602
18,1223,1183,40,701,203,105,32,59,123,306,1583,1529
19,1274,1232,42,730,212,110,34,62,126,175,1784,1449
20,1364,1337,27,672,269,95,59,72,197,98,2096,1462
21,2164,2127,37,510,298,150,118,213,875,147,3500,2311
22,1566,1539,27,369,215,109,86,154,633,42,2279,1608
23,5833,5739,94,864,320,488,300,721,3140,94,8879,5927
24,935,921,14,308,174,109,102,83,159,320,1330,1255
25,1504,1481,23,495,279,175,164,134,257,0,2140,1504
26,1834,1771,63,736,326,288,120,148,216,66,2933,1900
27,1149,1110,39,461,205,180,75,92,136,0,1804,1149
28,1825,1762,63,732,325,287,119,147,215,571,2751,2396
29,1466,1425,41,650,261,217,85,107,146,14,2312,1480
30,1953,1899,54,866,348,289,114,143,193,120,3251,2073
31,703,683,20,312,125,104,41,51,70,505,924,1208
32,741,719,22,187,110,77,74,69,224,0,1226,741
33,1328,1289,39,335,198,137,132,124,402,0,2014,1328
34,2241,2225,16,773,478,111,102,153,624,11,4208,2252
35,867,777,90,261,153,93,101,73,186,0,1615,867
36,1008,903,105,303,178,108,118,85,216,3,1890,1011
37,1091,978,113,328,192,116,127,92,236,0,1666,1091
38,591,539,52,224,111,54,54,41,107,0,1427,591
39,1064,970,94,404,199,98,97,74,192,0,2076,1064
40,2816,2737,79,1249,502,417,164,206,278,172,3930,2988
41,1426,1386,40,632,254,211,83,104,142,42,1952,1468
42,2250,2177,73,1289,374,194,60,109,224,2089,3691,4339
43,1455,1408,47,833,242,125,39,70,146,116,1821,1571
44,1187,1076,111,338,206,135,128,99,281,0,2077,1187
45,932,845,87,265,162,106,100,78,221,0,1701,932
46,895,811,84,255,156,102,96,75,211,0,1566,895
47,1312,1290,22,333,182,121,129,128,419,0,2160,1312
48,1371,1348,23,348,190,127,135,133,438,0,1991,1371
49,722,660,62,188,120,68,73,69,204,0,1164,722
50,1319,1206,113,343,220,124,133,126,373,3,2593,1322
51,1415,1293,122,368,236,133,142,135,401,11,2525,1426
52,1539,1515,24,504,301,142,149,131,312,19,2368,1558
53,1754,1727,27,575,343,162,170,150,354,0,2526,1754
54,968,953,15,317,189,89,94,83,196,3,1238,971
55,1019,990,29,326,187,101,104,96,205,0,1477,1019
56,452,439,13,144,83,45,46,42,92,3,779,455
57,843,819,24,269,155,83,86,79,171,0,1465,843
58,797,721,76,313,159,67,67,60,131,0,1720,797
59,1072,969,103,422,215,90,90,81,174,2,1549,1074
60,2181,2135,46,586,301,129,123,227,815,30,3153,2211
61,1059,1037,22,399,209,132,83,79,157,331,1592,1390
62,712,690,22,231,41,57,19,70,294,30,1128,742
63,546,534,12,179,39,43,22,52,211,13,742,559
64,1021,918,103,319,205,100,85,101,211,17,2028,1038
65,901,886,15,435,109,89,31,71,166,455,1128,1356
66,1753,1725,28,846,212,174,60,137,324,0,2564,1753
67,3218,3166,52,1554,388,320,110,252,594,69,4956,3287
68,2288,2264,24,683,562,212,179,203,449,73,3995,2361
69,2501,2458,43,589,344,174,137,246,1011,235,3989,2736
70,1804,1768,36,663,294,259,114,159,315,48,2462,1852
71,1664,1630,34,612,271,239,105,147,290,58,2502,1722
72,1839,1801,38,693,364,229,144,137,272,489,2671,2328
73,1747,1719,28,626,240,119,112,115,535,3,2633,1750
74,1258,1129,129,425,256,117,99,106,255,13,2683,1271
75,720,646,74,243,146,67,57,60,147,0,1431,720
76,3450,3384,66,1577,575,459,196,224,419,105,3761,3555
77,1829,1794,35,836,305,243,104,119,222,45,4977,1874
78,2158,2115,43,1063,426,150,93,114,312,75,3463,2233
79,2557,2506,51,1260,504,178,110,135,370,9,2688,2566
80,3328,3261,67,350,263,238,233,391,1853,20,5224,3348
81,511,501,10,120,148,49,40,42,112,338,791,849
82,353,348,5,92,46,34,28,42,111,16,446,369
83,545,523,22,178,61,35,15,44,212,11,867,556
84,531,528,3,127,70,42,37,49,206,11,1133,542
85,438,426,12,150,53,61,22,30,122,63,694,501
86,282,276,6,113,38,23,10,23,75,22,457,304
87,121,120,1,28,12,10,7,13,51,2,196,123
88,2039,2017,22,609,501,189,160,181,399,342,4010,2381
89,679,665,14,71,54,49,48,80,377,339,1042,1018
90,849,832,17,199,246,82,67,70,185,33,1430,882
91,970,950,20,227,281,94,76,80,212,20,1855,990
92,2403,2330,73,461,283,269,248,282,860,18,3736,2421
93,5027,4943,84,1026,691,458,423,529,1900,99,7924,5126
94,3666,3584,82,722,465,386,362,490,1241,31,5599,3697
95,3017,2924,93,666,369,338,293,315,1036,4,5484,3021
96,842,823,19,205,103,82,74,87,291,0,1519,842
97,2954,2561,393,467,462,284,291,364,1086,115,6773,3069
98,2143,1837,306,357,333,200,188,237,828,22,5015,2165
99,2067,1772,295,286,314,216,206,240,805,0,4612,2067
100,68,61,7,7,11,7,7,11,25,0,106,68
101,303,244,59,26,31,30,32,42,142,0,748,303
102,1022,877,145,170,151,97,90,101,413,0,1971,1022
103,1252,1086,166,210,176,103,104,127,532,0,2752,1252
104,551,478,73,93,78,45,46,56,233,0,1183,551
105,576,500,76,97,81,47,48,59,244,4,1269,580
106,798,693,105,134,112,66,66,81,339,0,1578,798
107,895,772,123,148,120,83,79,97,368,0,1856,895
108,923,796,127,153,123,86,81,100,380,31,1964,954
109,809,697,112,134,108,75,71,87,334,18,1800,827
110,1064,917,147,176,142,99,94,115,438,0,2239,1064
111,1125,966,159,190,177,102,110,121,425,20,2132,1145
112,1176,1010,166,198,185,106,115,127,445,38,2252,1214
113,1067,916,151,180,168,96,105,115,403,0,2023,1067
114,236,190,46,20,24,23,25,32,112,0,591,236
115,486,392,94,42,50,48,51,67,228,0,1112,486
116,948,816,132,161,157,78,81,104,367,0,2188,948
117,998,859,139,170,165,82,85,109,387,9,2191,1007
118,1453,1250,203,247,240,119,124,159,564,9,3008,1462
119,716,608,108,113,107,67,68,75,286,2,1511,718
120,1094,929,165,173,163,102,104,115,437,0,2268,1094
121,576,489,87,91,86,54,55,60,230,0,1211,576
122,600,509,91,95,89,56,57,63,240,0,1433,600
123,949,806,143,150,141,88,90,100,380,7,1857,956
124,999,854,145,146,158,91,87,116,401,4,2110,1003
125,763,653,110,112,121,69,67,89,305,7,1839,770
126,669,572,97,98,106,61,58,78,268,2,1535,671
127,837,716,121,122,133,76,73,97,336,0,1748,837
128,708,603,105,117,96,79,70,80,266,0,1662,708
129,1030,884,146,171,152,98,90,102,417,7,2047,1037
130,749,643,106,125,110,71,66,74,303,0,1571,749
131,874,745,129,145,118,97,86,99,329,4,1937,878
132,547,474,73,86,86,53,54,67,201,11,1526,558
133,1076,1028,48,323,286,99,77,85,206,49,1800,1125
134,851,623,228,53,42,116,97,163,380,7,2386,858
135,677,647,30,203,180,62,48,53,131,7,1088,684
136,1411,1348,63,424,374,130,101,111,271,15,2081,1426
137,614,523,91,102,83,68,61,70,230,0,1571,614
138,1274,1252,22,322,198,118,123,138,375,135,1904,1409
139,1744,1714,30,440,271,162,169,189,513,2,2544,1746
140,1082,1063,19,273,168,100,105,117,319,68,1640,1150
141,858,843,15,217,134,80,83,93,251,0,1375,858
142,230,202,28,55,42,20,18,21,74,0,477,230
143,1147,1005,142,275,207,101,90,107,367,0,2338,1147
144,854,748,106,205,154,75,67,80,273,163,1898,1017
145,958,840,118,230,173,84,75,89,307,71,1827,1029
146,1146,1004,142,275,207,101,90,107,366,68,2087,1214
147,987,909,78,219,195,97,77,96,303,75,2026,1062
148,730,672,58,162,144,72,57,71,224,0,1374,730
149,1108,1021,87,245,219,109,86,108,341,0,1582,1108
150,1771,1631,140,392,350,174,137,173,545,42,2468,1813
151,707,651,56,157,140,70,55,69,216,155,1329,862
152,797,734,63,177,158,79,62,78,243,97,1168,894
153,738,663,75,106,111,78,67,85,291,0,1392,738
154,651,585,66,94,98,69,59,75,256,152,1283,803
155,932,837,95,134,140,98,84,107,369,4,1710,936
156,450,404,46,65,68,47,41,52,177,0,931,450
157,1131,1016,115,163,170,119,102,130,447,31,2230,1162
158,719,702,17,175,88,70,64,74,248,0,1249,719
159,760,742,18,185,93,74,67,78,263,0,1299,760
160,1094,1069,25,266,134,107,97,112,378,0,1710,1094
161,704,601,103,91,73,76,76,85,303,0,1414,704
162,720,667,53,109,60,79,91,93,288,49,1444,769
163,368,341,27,56,30,41,47,48,146,4,667,372
164,1487,1377,110,225,123,164,189,193,593,0,2023,1487
165,340,290,50,44,35,37,37,41,146,0,822,340
166,580,495,85,75,60,63,63,70,249,353,913,933
167,288,246,42,37,30,31,31,35,124,0,713,288
168,567,484,83,73,59,61,61,69,244,0,1070,567
169,831,771,60,140,89,105,104,109,284,0,1574,831
170,837,777,60,141,90,106,105,109,286,0,1453,837
171,507,471,36,86,54,64,64,66,173,0,875,507
172,839,821,18,176,80,95,90,117,281,57,1253,896
173,1070,1047,23,225,101,121,114,150,359,0,1507,1070
174,1567,1566,1,398,271,144,118,159,477,183,2130,1750
175,695,694,1,177,120,64,52,70,212,15,934,710
176,562,543,19,177,128,48,48,39,122,0,1019,562
177,960,928,32,303,219,82,82,67,207,0,1693,960
178,1356,1310,46,428,309,115,116,95,293,0,1918,1356
179,801,749,52,118,108,81,69,96,329,0,1537,801
180,636,594,42,93,86,64,55,76,262,46,1211,682
181,784,704,80,159,123,63,60,80,299,0,1390,784
182,1172,1052,120,238,184,94,90,120,446,0,2141,1172
183,565,507,58,115,89,45,43,58,215,0,1026,565
184,1617,1451,166,328,253,130,124,165,617,0,2591,1617
185,1083,972,111,220,170,87,83,111,412,2,2113,1085
186,546,534,12,152,101,35,42,51,165,9,1128,555
187,1598,1562,36,445,296,103,122,150,482,183,2089,1781
188,1106,1081,25,308,205,72,84,104,333,0,1420,1106
189,588,536,52,96,88,56,58,58,232,2,1193,590
190,462,421,41,76,69,44,46,46,181,18,904,480
191,794,723,71,130,119,76,78,78,313,0,1590,794
192,641,615,26,93,94,49,52,66,287,3975,1251,4616
193,822,788,34,120,120,62,67,85,368,4,1805,826
194,1435,1376,59,209,210,109,116,149,642,26,2981,1461
195,1065,1021,44,155,156,81,86,110,477,13,2016,1078
196,1241,1115,126,412,314,89,77,105,244,11,2270,1252
197,1406,1263,143,467,356,101,87,120,275,0,2694,1406
198,2295,2249,46,743,585,205,196,162,404,24,3274,2319
199,867,767,100,425,312,21,20,23,66,0,1754,867
200,1157,1023,134,568,417,28,27,31,86,0,1887,1157
201,621,549,72,305,224,15,15,16,46,20,1468,641
202,459,406,53,225,165,11,11,12,35,0,947,459
203,501,448,53,106,113,46,42,41,153,0,943,501
204,754,674,80,159,170,69,63,62,231,20,1487,774
205,1539,1375,164,325,346,140,129,126,473,132,3153,1671
206,1095,1043,52,175,206,114,116,110,374,13,2035,1108
207,1620,1544,76,258,305,168,172,162,555,40,2839,1660
208,667,619,48,126,121,72,63,71,214,44,1297,711
209,750,696,54,142,137,81,71,79,240,77,1574,827
210,673,625,48,127,122,72,64,71,217,31,1420,704
211,852,791,61,161,155,92,81,90,273,210,1905,1062
212,855,799,56,153,206,84,76,92,244,13,1722,868
213,570,532,38,102,137,56,51,61,163,79,1312,649
214,701,655,46,125,169,69,62,75,201,13,1528,714
215,1031,963,68,184,249,101,92,111,294,29,1939,1060
216,816,754,62,102,135,79,65,96,339,29,1527,845
217,1126,1040,86,140,186,109,90,133,468,0,2199,1126
218,1203,1039,164,178,172,126,128,137,462,7,2298,1210
219,1255,1084,171,185,180,131,133,143,483,0,2439,1255
220,665,574,91,98,95,69,71,76,256,4,1315,669
221,618,534,84,91,89,65,66,70,237,2,1291,620
222,705,609,96,104,101,74,75,80,271,2,1475,707
223,815,699,116,136,127,76,71,90,315,9,1820,824
224,1059,908,151,176,165,99,93,117,409,0,2429,1059
225,753,646,107,125,117,70,66,83,292,95,1656,848
226,619,572,47,77,102,60,49,73,258,104,1076,723
227,429,396,33,53,71,42,34,51,178,2,906,431
228,1283,1226,57,235,234,127,99,131,457,0,2333,1283
229,785,750,35,143,143,78,61,80,280,0,1441,785
230,2179,2093,86,267,304,246,170,255,937,0,3318,2179
231,562,540,22,69,78,63,44,66,242,0,973,562
232,860,826,34,106,120,97,67,101,369,0,1537,860
233,0,0,0,0,0,0,0,0,0,124,0,124
234,75,55,20,5,4,10,9,14,33,9,211,84
235,610,548,62,88,92,64,55,70,241,0,1166,610
236,0,0,0,0,0,0,0,0,0,0,0,0
237,47,47,0,9,7,2,8,4,17,115,62,162
238,721,691,30,105,105,55,58,75,323,104,1397,825
239,1294,1238,56,158,177,170,144,180,465,0,2255,1294
240,1506,1344,162,157,192,173,147,201,636,9,2998,1515
241,635,575,60,87,61,81,63,90,253,0,1141,635
242,752,563,189,77,66,103,73,117,316,104,2232,856
243,1914,1828,86,308,271,210,142,217,766,173,3749,2087
244,1250,1092,158,113,109,160,126,173,569,0,2526,1250
245,1151,825,326,119,129,153,113,168,469,50,3560,1201
246,1378,1259,119,105,123,159,127,200,664,0,3293,1378
247,4186,1955,2231,576,356,417,280,537,2020,0,14062,4186
248,889,799,90,185,165,76,55,84,324,9,1472,898
249,1684,1405,279,378,260,156,121,169,600,90,2470,1774
250,1892,1700,192,394,352,161,117,179,689,64,3578,1956
251,2180,2067,113,310,398,189,125,249,909,33,3596,2213
252,631,598,33,90,115,55,36,72,263,7,1201,638
253,1287,1220,67,183,235,111,74,147,537,43,2276,1330
254,504,479,25,85,68,57,48,64,182,0,923,504
255,518,492,26,87,70,58,49,65,189,9,867,527
256,1096,1041,55,184,147,124,104,138,399,5,1722,1101
257,1054,1002,52,177,142,119,100,133,383,0,1871,1054
258,795,729,66,110,147,77,55,88,318,5,1446,800
259,1567,1436,131,216,290,151,107,173,630,62,2792,1629
260,2231,2045,186,308,413,215,153,246,896,24,4130,2255
261,1735,1498,237,499,137,131,138,184,646,204,3545,1939
262,1221,1054,167,351,96,92,97,130,455,64,2271,1285
263,1035,894,141,297,82,78,83,110,385,0,2161,1035
264,951,821,130,273,75,72,76,101,354,2,2252,953
265,810,746,64,253,74,47,65,76,295,0,1906,810
266,757,697,60,236,69,44,60,71,277,2,1924,759
267,1202,1107,95,375,110,69,96,113,439,2,2521,1204
268,1526,1406,120,477,139,88,122,144,556,128,3836,1654
269,683,606,77,101,80,67,51,91,293,277,1494,960
270,1139,1090,49,172,192,98,108,130,439,0,2532,1139
271,595,518,77,175,1,22,98,69,230,36,1839,631
272,497,324,173,61,55,84,47,59,191,14,1872,511
273,580,337,243,119,91,85,46,61,178,128,1963,708
274,633,287,346,355,248,13,12,3,2,0,1618,633
275,1067,946,121,157,125,105,79,142,459,59,1984,1126
276,737,654,83,109,86,73,55,98,316,0,1562,737
277,791,701,90,117,92,78,59,105,340,12,1699,803
278,432,386,46,54,71,53,42,53,159,0,940,432
279,553,494,59,69,91,67,53,68,205,0,1169,553
280,717,640,77,89,118,87,69,89,265,0,1542,717
281,598,534,64,74,98,73,58,74,221,2,1101,600
282,524,464,60,74,80,62,51,67,190,5,1052,529
283,811,718,93,115,124,96,79,104,293,0,1657,811
284,661,586,75,94,101,78,64,85,239,0,1445,661
285,650,572,78,91,108,91,61,71,228,0,1273,650
286,452,398,54,63,75,63,43,50,158,0,845,452
287,516,454,62,72,86,72,49,57,180,0,959,516
288,553,486,67,78,92,77,52,61,193,0,1058,553
289,585,515,70,82,97,82,55,64,205,95,1117,680
290,854,774,80,117,82,109,85,121,340,0,1749,854
291,674,611,63,92,65,86,67,96,268,0,1247,674
292,812,777,35,122,137,70,77,92,314,0,1577,812
293,446,427,19,67,75,38,42,51,173,0,1078,446
294,636,600,36,92,67,76,66,83,252,0,1296,636
295,442,417,25,64,47,53,46,57,175,0,959,442
296,567,396,171,62,58,81,62,75,229,81,2018,648
297,659,462,197,74,93,96,69,76,251,9,2285,668
298,206,120,86,54,27,32,14,26,53,251,544,457
299,12458,6925,5533,5220,4034,805,995,445,959,0,30549,12458
300,722,681,41,104,76,86,75,94,287,52,1395,774
301,634,598,36,92,67,75,66,82,252,0,1258,634
302,2203,2094,109,279,134,149,154,277,1210,2,5229,2205
303,1365,1298,67,173,83,92,96,172,749,7,2262,1372
304,2105,1656,449,533,199,152,159,225,837,47,4937,2152
305,1179,928,251,299,111,85,89,126,469,33,3093,1212
306,876,839,37,147,64,83,65,115,402,2,1906,878
307,1485,1168,317,376,140,107,112,159,591,19,3951,1504
308,981,749,232,264,94,65,88,98,372,28,3001,1009
309,1222,1065,157,359,2,45,202,142,472,12,3003,1234
310,550,479,71,162,1,20,91,64,212,0,1612,550
311,698,533,165,188,67,46,63,70,264,36,2343,734
312,263,230,33,59,40,27,24,24,89,14,557,277
313,866,662,204,233,83,57,78,87,328,0,3083,866
314,495,345,150,74,69,67,45,63,177,104,1407,599
315,450,314,136,67,63,61,41,57,161,36,1308,486
316,517,337,180,64,58,87,49,61,198,47,1950,564
317,464,328,136,98,76,64,37,54,135,17,1194,481
318,369,240,129,45,41,62,35,44,142,0,1320,369
319,355,279,76,32,43,40,33,51,156,0,935,355
320,395,310,85,27,50,61,32,65,160,7,1111,402
321,328,257,71,22,42,51,27,54,132,0,924,328
322,535,294,241,108,83,73,43,64,164,38,1741,573
323,789,433,356,159,122,108,64,95,241,21,2677,810
324,550,456,94,53,73,66,57,75,226,85,1524,635
325,508,421,87,49,67,61,53,70,208,31,1302,539
326,592,353,239,58,109,56,52,71,246,0,1746,592
327,1226,636,590,309,264,93,58,117,385,0,4555,1226
328,643,334,309,162,139,49,31,61,201,0,2342,643
329,347,291,56,38,51,50,31,47,130,33,949,380
330,644,539,105,70,95,93,57,87,242,52,1708,696
331,426,357,69,46,63,62,38,57,160,45,1062,471
332,622,515,107,60,83,75,65,85,254,246,1719,868
333,703,553,150,64,86,79,65,100,309,7,1952,710
334,617,486,131,56,75,70,57,88,271,0,1680,617
335,772,627,145,83,113,89,72,104,311,0,1836,772
336,813,660,153,87,119,93,76,110,328,0,2016,813
337,673,546,127,72,98,77,63,91,272,0,1849,673
338,518,421,97,56,76,60,49,70,207,5,1397,523
339,285,231,54,31,42,33,27,39,113,0,807,285
340,539,358,181,48,67,71,62,71,220,31,1818,570
341,277,184,93,25,34,36,32,37,113,0,917,277
342,432,287,145,38,54,57,50,57,176,31,1446,463
343,418,278,140,37,52,55,48,55,171,19,1402,437
344,455,303,152,40,57,60,52,60,186,85,1624,540
345,696,577,119,68,92,84,72,95,285,52,1588,748
346,1104,920,184,123,215,123,101,140,402,31,2640,1135
347,545,454,91,60,106,61,50,69,199,24,1230,569
348,425,354,71,47,83,48,39,54,154,12,1160,437
349,409,341,68,45,80,46,37,52,149,66,924,475
350,383,300,83,26,48,59,31,63,156,7,1009,390
351,746,561,185,76,103,114,61,104,288,0,2409,746
352,961,721,240,175,349,96,72,62,207,7,2699,968
353,836,629,207,85,116,127,68,116,324,31,2882,867
354,469,352,117,85,170,47,35,30,102,0,1429,469
355,608,486,122,45,54,88,72,78,271,47,1814,655
356,524,385,139,54,83,55,57,70,205,38,1574,562
357,420,308,112,43,67,44,45,56,165,0,1323,420
358,487,357,130,50,77,51,53,65,191,0,1627,487
359,586,430,156,60,93,61,63,79,230,0,1759,586
360,407,299,108,42,65,42,44,55,159,71,1362,478
361,364,267,97,38,58,38,39,49,142,9,1171,373
362,492,355,137,46,44,68,48,67,219,9,1654,501
363,475,343,132,45,42,66,47,64,211,0,1580,475
364,352,254,98,33,31,49,35,48,156,5,1064,357
365,348,251,97,33,31,48,34,47,155,0,1075,348
366,278,200,78,41,29,35,23,32,118,43,746,321
367,413,298,115,60,42,53,33,48,177,0,1134,413
368,553,414,139,57,48,76,54,86,232,12,1730,565
369,172,129,43,18,15,24,17,27,71,0,526,172
370,778,513,265,89,95,110,64,107,313,0,2834,778
371,804,561,243,97,109,101,81,100,316,0,2832,804
372,836,575,261,85,106,106,111,109,319,0,2921,836
373,541,356,185,62,66,76,44,75,218,7,1989,548
374,384,307,77,28,34,55,46,49,172,0,1220,384
375,1886,1422,464,325,511,124,134,199,593,9,6596,1895
376,358,270,88,62,97,24,25,38,112,0,1121,358
377,669,504,165,115,181,44,48,70,211,0,2380,669
378,415,313,102,72,113,27,30,44,129,0,1364,415
379,527,363,164,52,73,60,58,73,211,19,1874,546
380,419,288,131,41,58,48,46,58,168,14,1536,433
381,353,243,110,35,49,40,39,49,141,0,1349,353
382,352,242,110,35,48,40,39,48,142,26,1327,378
383,355,244,111,35,49,40,39,49,143,57,1341,412
384,297,206,91,29,24,45,32,39,128,0,1114,297
385,393,274,119,47,53,49,40,49,155,14,1314,407
386,383,266,117,37,31,58,41,51,165,0,1572,383
387,363,260,103,38,41,48,36,53,147,0,1208,363
388,297,207,90,36,40,37,30,37,117,2,1021,299
389,464,322,142,45,37,70,50,62,200,0,1804,464
390,743,515,228,80,68,101,67,92,335,0,2245,743
391,513,342,171,66,86,82,45,56,178,33,1632,546
392,559,372,187,71,93,89,49,60,197,0,1850,559
393,537,490,47,73,99,55,47,57,206,57,1217,594
394,790,721,69,108,146,81,69,84,302,161,1660,951
395,572,522,50,78,106,59,50,61,218,2,1287,574
396,982,896,86,134,181,101,86,105,375,24,1803,1006
397,1148,1094,54,176,136,137,112,143,444,713,2077,1861
398,957,912,45,147,113,115,93,119,370,0,1930,957
399,1688,1637,51,222,95,129,89,210,943,38,2517,1726
400,1494,1464,30,295,59,125,60,223,732,0,2686,1494
401,760,732,28,177,68,58,47,81,329,0,1476,760
402,424,404,20,65,50,51,41,53,164,0,845,424
403,3045,2202,843,277,492,268,197,406,1405,0,7179,3045
404,564,408,156,51,91,50,36,75,261,0,1780,564
405,230,202,28,51,31,31,28,19,70,0,493,230
406,1522,1456,66,186,208,200,169,212,547,0,2630,1522
407,538,474,64,118,73,72,65,46,164,24,1379,562
408,968,927,41,162,71,91,72,128,444,0,1994,968
409,12,10,2,3,2,1,1,1,4,173,23,185
410,510,361,149,107,84,71,40,60,148,2,1554,512
411,316,223,93,66,52,44,25,37,92,69,842,385
412,934,618,316,117,100,131,82,116,388,0,2878,934
413,530,350,180,66,57,74,47,66,220,0,1610,530
414,434,326,108,79,157,43,33,28,94,26,1218,460
415,611,420,191,58,50,91,65,86,261,0,2235,611
416,754,519,235,72,62,112,81,107,320,0,2539,754
417,920,632,288,93,117,116,123,119,352,9,3127,929
418,880,617,263,99,124,128,92,101,336,24,3208,904
419,631,438,193,68,58,86,57,78,284,21,2117,652
420,402,219,183,48,53,63,30,47,161,12,1648,414
421,296,162,134,36,39,47,22,35,117,0,1143,296
422,909,499,410,183,140,124,73,109,280,163,3296,1072
423,650,622,28,79,89,85,72,90,235,0,1207,650
424,492,471,21,60,67,65,55,68,177,0,855,492
425,798,763,35,98,109,105,89,111,286,2,1597,800
426,1491,1427,64,300,125,147,118,199,602,7,2844,1498
427,968,927,41,195,81,95,77,129,391,0,1971,968
428,541,377,164,59,56,78,59,72,217,33,1810,574
429,377,263,114,41,39,54,41,50,152,2,1271,379
430,377,263,114,41,39,54,41,50,152,17,1351,394
431,416,290,126,46,43,60,45,55,167,14,1374,430
432,973,693,280,106,132,108,90,120,417,33,3503,1006
433,872,621,251,95,118,97,80,107,375,47,2946,919
434,380,271,109,41,52,42,35,47,163,17,1250,397
435,398,284,114,43,54,44,37,49,171,0,1353,398
436,471,336,135,51,64,52,43,58,203,0,1677,471
437,551,393,158,60,75,61,51,68,236,0,2038,551
438,1155,679,476,208,174,147,77,128,421,208,3851,1363
439,1675,1557,118,429,236,163,153,162,532,19,3445,1694
440,4031,3363,668,904,623,374,290,404,1436,268,5260,4299
441,1457,1215,242,327,225,135,105,146,519,185,3220,1642
442,123,114,9,32,17,12,11,12,39,329,235,452
443,1595,1331,264,358,246,148,115,160,568,31,3303,1626
444,2393,2151,242,499,445,203,148,227,871,111,4015,2504
445,2392,2125,267,652,66,224,161,292,997,9,5803,2401
446,2425,2155,270,661,67,227,163,296,1011,17,5177,2442
447,740,657,83,202,20,69,50,90,309,0,1629,740
448,13,12,1,2,2,2,1,2,4,33,18,46
449,577,403,174,63,59,83,63,77,232,2,1977,579
450,0,0,0,0,0,0,0,0,0,0,0,0
451,148,136,12,20,17,23,10,23,55,26,307,174
452,3233,3114,119,755,288,246,199,344,1401,137,6326,3370
453,1262,1173,89,323,178,123,115,122,401,147,3315,1409
454,854,794,60,219,120,83,78,82,272,12,1810,866
455,0,0,0,0,0,0,0,0,0,5,0,5
456,190,177,13,49,27,19,17,18,60,36,486,226
457,1264,1238,26,249,50,106,51,188,620,213,2264,1477
458,2615,2519,96,611,233,199,161,278,1133,36,4671,2651
459,523,507,16,69,29,40,28,65,292,422,703,945
460,328,287,41,73,50,34,30,30,111,0,810,328
461,336,294,42,75,51,35,30,30,115,0,876,336
462,47,45,2,6,3,3,3,6,26,0,177,47
463,4580,4354,226,579,279,310,321,576,2515,66,11769,4646
464,994,945,49,126,61,67,70,125,545,5,2554,999
465,427,406,21,54,26,29,30,54,234,0,592,427
466,0,0,0,0,0,0,0,0,0,0,0,0
467,368,338,30,50,43,57,25,57,136,0,437,368
468,0,0,0,0,0,0,0,0,0,47,0,47
469,1,1,0,0,0,0,0,0,1,5,3,6
470,70,64,6,10,8,11,5,11,25,5,136,75
471,8,7,1,1,1,1,1,1,3,12,13,20
472,0,0,0,0,0,0,0,0,0,0,0,0
473,220,202,18,30,25,34,15,34,82,0,565,220
474,562,334,228,194,139,84,44,36,65,0,1652,562
475,970,576,394,336,240,145,76,61,112,12,2579,982
476,3088,1399,1689,1732,1210,61,59,16,10,5,10464,3093
477,648,386,262,63,119,62,57,78,269,0,2158,648
478,1547,922,625,151,284,147,135,186,644,0,5115,1547
479,1095,568,527,276,236,83,52,104,344,0,3225,1095
480,1020,529,491,257,220,77,49,97,320,0,3549,1020
481,667,366,301,134,103,91,54,80,205,2,2136,669
482,63,44,19,6,5,10,7,8,27,0,248,63
483,5210,3767,1443,474,841,458,337,694,2406,0,11668,5210
484,2445,1768,677,222,395,215,158,326,1129,14,7894,2459
485,340,256,84,59,92,22,24,36,107,14,1199,354
486,558,421,137,96,151,37,40,59,175,0,1735,558
487,285,209,76,29,45,30,31,38,112,0,913,285
488,723,660,63,55,65,84,67,105,347,0,1731,723
489,696,636,60,53,62,80,64,101,336,0,1683,696
490,481,463,18,112,43,37,30,51,208,1324,943,1805
491,612,494,118,43,50,64,73,69,313,0,1470,612
492,1432,1263,169,119,90,102,124,209,788,0,3337,1432
493,1033,831,202,115,162,105,96,109,446,59,2433,1092
494,252,203,49,28,40,26,23,27,108,7,659,259
495,308,248,60,34,48,31,29,32,134,0,880,308
496,379,305,74,42,59,39,35,40,164,13,1002,392
497,457,352,105,44,58,53,47,56,199,2,1318,459
498,335,258,77,32,42,39,34,41,147,0,823,335
499,376,290,86,36,48,43,38,46,165,0,969,376
500,359,277,82,34,45,41,37,44,158,0,935,359
501,594,458,136,57,75,68,60,73,261,13,1522,607
502,419,323,96,40,53,48,43,52,183,0,1100,419
503,347,267,80,33,44,40,35,43,152,9,923,356
504,414,341,73,41,72,48,39,48,166,4,1078,418
505,695,573,122,68,121,81,66,81,278,0,1583,695
506,370,305,65,36,64,43,35,43,149,9,993,379
507,556,458,98,55,96,65,53,65,222,0,1465,556
508,341,281,60,33,59,40,32,40,137,0,897,341
509,330,272,58,32,57,39,31,38,133,0,884,330
510,292,241,51,29,51,34,28,34,116,0,773,292
511,485,381,104,43,65,58,41,59,219,0,1290,485
512,543,426,117,48,73,65,46,67,244,0,1479,543
513,666,523,143,59,89,80,56,82,300,17,1686,683
514,429,337,92,38,57,51,36,53,194,0,1148,429
515,593,465,128,52,79,71,50,73,268,37,1566,630
516,459,360,99,40,61,55,39,56,208,6,1238,465
517,575,490,85,41,65,69,47,80,273,6,1458,581
518,318,271,47,22,36,38,26,44,152,0,730,318
519,405,345,60,29,46,48,33,57,192,0,1006,405
520,247,210,37,17,28,30,20,35,117,0,622,247
521,876,737,139,122,144,97,81,104,328,0,1995,876
522,694,584,110,97,114,77,64,83,259,50,1581,744
523,651,527,124,68,85,66,68,83,281,0,1651,651
524,606,490,116,64,79,62,64,77,260,6,1623,612
525,473,383,90,50,62,48,50,60,203,0,1266,473
526,378,306,72,40,49,38,40,48,163,6,1145,384
527,366,296,70,38,48,37,38,46,159,0,1049,366
528,347,281,66,36,45,35,36,44,151,0,981,347
529,490,396,94,51,64,50,51,62,212,0,1507,490
530,693,583,110,97,114,77,64,82,259,0,1594,693
531,399,320,79,36,42,49,43,56,173,0,1139,399
532,345,276,69,31,36,42,37,48,151,0,1027,345
533,391,313,78,36,41,48,42,55,169,0,1099,391
534,342,274,68,31,36,42,37,48,148,0,1007,342
535,538,432,106,54,73,61,53,74,223,0,1417,538
536,365,293,72,36,50,42,36,50,151,24,911,389
537,636,511,125,63,87,72,63,88,263,0,1585,636
538,391,314,77,39,53,44,38,54,163,6,1005,397
539,529,425,104,53,72,60,52,73,219,0,1285,529
540,335,269,66,33,46,38,33,46,139,0,838,335
541,560,450,110,60,78,60,62,69,231,0,1279,560
542,480,385,95,52,67,52,53,59,197,0,1185,480
543,510,410,100,55,71,55,56,62,211,0,1360,510
544,509,409,100,55,71,55,56,62,210,7,1235,516
545,1187,1050,137,169,228,120,97,136,437,0,2290,1187
546,674,596,78,96,130,68,55,77,248,6,1405,680
547,919,791,128,98,116,113,96,122,374,0,1998,919
548,782,691,91,112,150,79,64,90,287,0,1768,782
549,938,835,103,136,191,121,76,108,306,0,1720,938
550,1010,899,111,146,206,130,82,116,330,28,1762,1038
551,582,501,81,62,73,71,61,77,238,0,1361,582
552,3630,3519,111,372,421,259,238,605,1735,2,8627,3632
553,748,644,104,79,94,92,78,99,306,20,1584,768
554,502,412,90,45,56,60,55,64,222,0,1261,502
555,512,441,71,54,65,63,53,68,209,0,1110,512
556,508,417,91,46,56,61,56,64,225,0,1290,508
557,300,242,58,29,40,37,29,37,128,0,792,300
558,556,448,108,54,75,68,54,68,237,0,1378,556
559,494,398,96,48,66,60,48,61,211,0,1203,494
560,431,347,84,42,58,53,42,53,183,0,1037,431
561,315,254,61,22,25,33,37,36,162,11,780,326
562,835,672,163,93,131,85,77,88,361,7,2262,842
563,764,680,84,110,156,99,62,88,249,19,1414,783
564,485,398,87,44,54,58,53,61,215,0,1097,485
565,446,334,112,37,46,49,48,68,198,17,1258,463
566,695,520,175,58,72,76,75,106,308,11,1892,706
567,520,389,131,43,54,57,56,79,231,0,1446,520
568,631,472,159,52,65,69,68,96,281,0,1849,631
569,612,458,154,51,63,67,66,93,272,0,1827,612
570,611,457,154,51,63,66,65,93,273,0,1758,611
571,1070,897,173,138,175,125,86,123,423,7,2539,1077
572,976,818,158,126,159,114,79,113,385,0,2435,976
573,782,656,126,101,128,91,63,90,309,7,1978,789
574,934,783,151,121,152,109,75,108,369,24,2392,958
575,701,588,113,91,114,82,57,81,276,0,1732,701
576,528,443,85,68,86,61,43,61,209,9,1392,537
577,628,517,111,68,81,72,59,80,268,0,1647,628
578,771,634,137,84,100,89,73,98,327,2,1887,773
579,469,386,83,51,61,54,44,60,199,0,1178,469
580,561,462,99,61,73,65,53,71,238,0,1312,561
581,648,533,115,70,84,75,61,82,276,0,1657,648
582,490,403,87,53,64,56,46,62,209,0,1343,490
583,421,337,84,39,55,48,41,56,182,0,1248,421
584,455,365,90,42,59,52,44,61,197,0,1281,455
585,518,415,103,48,67,59,51,69,224,0,1514,518
586,670,537,133,62,87,76,65,90,290,13,1849,683
587,418,335,83,39,54,48,41,56,180,0,1210,418
588,453,363,90,42,59,52,44,61,195,13,1339,466
589,476,382,94,44,62,54,46,64,206,0,1313,476
590,2057,1814,243,170,130,147,179,300,1131,0,4788,2057
591,455,401,54,38,29,32,39,66,251,0,1088,455
592,2037,1796,241,169,129,145,177,297,1120,0,4872,2037
593,1190,1049,141,99,75,85,103,173,655,0,2792,1190
594,594,476,118,54,63,73,64,83,257,0,1476,594
595,702,564,138,76,98,76,78,86,288,0,1751,702
596,318,309,9,93,66,22,21,36,80,4,462,322
597,0,0,0,0,0,0,0,0,0,0,0,0
598,379,284,95,31,39,41,41,58,169,0,1183,379
599,1558,1374,184,129,98,111,135,227,858,0,3412,1558
600,76,74,2,8,9,5,5,13,36,3404,190,3480
601,203,163,40,23,32,21,19,21,87,0,481,203
602,674,543,131,65,90,82,66,83,288,0,1702,674
603,469,455,14,62,26,36,25,58,262,0,556,469
604,53,51,2,7,3,4,3,7,29,0,191,53
605,3360,3259,101,442,189,256,177,419,1877,0,6897,3360
606,22,21,1,3,1,2,1,3,12,0,81,22
607,1117,1093,24,449,152,91,41,89,295,66,1475,1183
608,363,355,8,146,50,30,13,29,95,23,639,386
609,325,318,7,131,44,27,12,26,85,13,314,338
610,788,784,4,188,104,62,54,73,307,55,565,843
611,0,0,0,0,0,0,0,0,0,17,0,17
612,348,346,2,83,46,27,24,32,136,0,243,348
613,367,364,3,43,19,28,20,41,216,0,594,367
614,655,650,5,76,35,51,35,74,384,2,781,657
615,598,594,4,136,61,48,37,62,254,17,755,615
616,1040,768,272,103,146,134,123,170,364,0,2435,1040
617,623,511,112,85,70,76,67,96,229,0,1402,623
618,1596,1154,442,172,178,229,204,255,558,263,4438,1859
619,1553,1104,449,105,169,216,183,275,605,0,3885,1553
620,2566,1792,774,61,107,410,322,471,1195,16,5799,2582
621,7,4,3,1,1,1,1,0,3,0,18,7
622,3126,2587,539,73,147,452,438,581,1435,18,5975,3144
623,1377,1007,370,111,144,172,168,232,550,0,3381,1377
624,1264,850,414,108,125,166,151,210,504,41,3435,1305
625,2247,1750,497,266,292,317,250,346,776,20,6188,2267
626,1400,979,421,77,81,190,167,274,611,34,4647,1434
627,435,323,112,48,67,67,52,70,131,0,1168,435
628,1939,1333,606,191,327,256,252,295,618,7,5510,1946
629,660,433,227,91,106,92,80,88,203,36,1783,696
630,4895,3281,1614,589,700,672,621,832,1481,11,12104,4906
631,1778,1196,582,113,178,243,181,327,736,52,4436,1830
632,1591,1238,353,19,52,251,191,310,768,14,2925,1605
633,1915,1611,304,179,202,289,226,318,701,82,3507,1997
634,1222,905,317,19,37,158,143,253,612,0,2705,1222
635,1455,1023,432,17,49,211,195,293,690,0,3056,1455
636,1892,1388,504,67,116,314,268,345,782,0,4156,1892
637,3354,2298,1056,96,147,339,395,696,1681,59,8558,3413
638,1695,1198,497,31,66,209,170,314,905,499,4161,2194
639,329,274,55,11,16,39,47,67,149,0,757,329
640,930,762,168,8,16,82,150,250,424,0,2265,930
641,629,501,128,6,10,64,83,163,303,36,1327,665
642,529,455,74,15,21,64,80,111,238,5,1032,534
643,316,253,63,29,33,36,37,53,128,16,755,332
644,2079,1394,685,201,346,296,252,289,695,54,5693,2133
645,3065,2046,1019,446,645,339,338,394,903,2,7434,3067
646,1718,1169,549,238,313,223,182,212,550,168,4336,1886
647,868,502,366,128,208,100,100,93,239,0,2666,868
648,1452,1131,321,83,102,175,154,260,678,0,3211,1452
649,428,318,110,22,34,58,42,74,198,0,959,428
650,387,288,99,20,31,53,38,67,178,2,876,389
651,422,314,108,22,33,57,42,73,195,0,1009,422
652,4118,3724,394,729,789,284,253,482,1581,0,4763,4118
653,597,415,182,45,54,68,73,98,259,184,1501,781
654,694,402,292,102,166,80,80,75,191,0,1959,694
655,948,645,303,131,173,123,101,117,303,18,2473,966
656,4449,3458,991,609,1269,258,350,514,1449,2,10235,4451
657,802,546,256,111,146,104,85,99,257,18,2100,820
658,1024,820,204,93,108,115,120,171,417,127,2466,1151
659,339,236,103,26,31,38,41,56,147,88,877,427
660,459,319,140,35,42,52,56,76,198,0,1184,459
661,1648,1203,445,75,107,175,168,299,824,50,4127,1698
662,497,268,229,51,63,69,56,76,182,0,1196,497
663,347,187,160,35,44,48,39,53,128,0,998,347
664,2168,1755,413,131,158,188,208,344,1139,43,4397,2211
665,362,300,62,48,130,37,49,33,65,0,892,362
666,818,558,260,78,113,131,87,117,292,75,2039,893
667,739,636,103,22,29,89,112,156,331,61,1667,800
668,315,252,63,29,33,35,37,53,128,0,727,315
669,434,234,200,44,55,60,49,66,160,66,1316,500
670,3816,2504,1312,527,613,533,461,511,1171,197,10662,4013
671,948,777,171,129,107,116,102,146,348,45,1985,993
672,1440,1153,287,131,152,162,168,240,587,20,2763,1460
673,469,375,94,43,50,53,55,78,190,0,1079,469
674,3304,2741,563,440,1190,336,443,306,589,0,5636,3304
675,223,167,56,16,42,18,37,33,77,0,535,223
676,424,317,107,31,80,35,71,63,144,0,973,424
677,383,286,97,28,72,31,64,57,131,32,879,415
678,610,450,160,60,85,79,72,100,214,0,1438,610
679,639,430,209,55,63,84,76,106,255,0,1973,639
680,738,558,180,164,230,52,56,70,166,14,1726,752
681,611,462,149,136,191,43,46,58,137,0,1523,611
682,342,256,86,25,64,28,57,51,117,0,819,342
683,633,393,240,77,71,78,70,97,240,0,1776,633
684,1086,674,412,131,122,135,120,166,412,0,3242,1086
685,366,246,120,31,36,48,44,61,146,0,1128,366
686,951,606,345,138,244,120,100,112,237,0,2790,951
687,1054,672,382,153,271,132,110,125,263,0,3133,1054
688,884,564,320,94,341,91,81,88,189,23,2557,907
689,750,479,271,80,290,77,68,74,161,5,2090,755
690,1644,1049,595,176,635,169,150,163,351,238,4583,1882
691,782,499,283,84,302,80,71,77,168,16,2264,798
692,2456,1861,595,316,313,330,265,366,866,11,5221,2467
693,1000,795,205,145,198,151,73,128,305,0,2237,1000
694,4020,2692,1328,734,1314,320,291,363,998,20,10932,4040
695,918,684,234,87,135,131,100,138,327,0,2262,918
696,356,265,91,34,52,51,39,53,127,9,861,365
697,12940,9792,3148,2883,4037,912,981,1225,2902,0,23982,12940
698,1666,1242,424,158,244,237,182,250,595,20,3957,1686
699,805,660,145,110,90,99,86,124,296,20,1779,825
700,854,582,272,81,118,136,91,122,306,0,1927,854
701,775,528,247,73,107,124,83,111,277,43,1924,818
702,491,363,128,33,45,67,54,82,210,0,1280,491
703,863,638,225,59,79,117,96,144,368,14,2251,877
704,756,559,197,51,69,103,84,126,323,50,2130,806
705,1073,988,85,155,111,154,109,190,354,0,2062,1073
706,1575,1171,404,173,241,242,187,255,477,23,3694,1598
707,860,670,190,49,60,104,91,154,402,11,1887,871
708,2489,1934,555,340,710,145,196,288,810,0,5003,2489
709,675,525,150,92,193,39,53,78,220,0,1284,675
710,758,632,126,25,37,90,108,154,344,16,1608,774
711,232,193,39,8,11,28,33,47,105,25,543,257
712,342,272,70,3,6,35,45,89,164,0,770,342
713,539,369,170,48,78,72,65,84,192,32,1657,571
714,431,295,136,38,62,57,52,67,155,11,1376,442
715,830,568,262,74,120,111,100,129,296,0,2517,830
716,707,562,145,103,140,107,51,90,216,0,1578,707
717,446,350,96,43,60,39,72,72,160,0,955,446
718,1089,855,234,105,146,94,175,177,392,0,2266,1089
719,561,440,121,54,75,48,90,91,203,11,1151,572
720,87,70,17,10,12,10,7,12,36,0,200,87
721,424,289,135,40,59,68,45,61,151,166,1050,590
722,755,506,249,138,247,60,55,68,187,32,1944,787
723,628,421,207,115,205,50,45,57,156,0,1698,628
724,0,0,0,0,0,0,0,0,0,0,0,0
725,0,0,0,0,0,0,0,0,0,184,0,184
726,452,309,143,40,65,60,54,70,163,0,1197,452
727,761,616,145,85,103,85,57,108,323,0,2219,761
728,1212,898,314,115,131,159,139,203,465,109,3351,1321
729,1128,836,292,107,122,148,129,189,433,79,3054,1207
730,2791,2037,754,127,182,296,284,506,1396,0,8128,2791
731,452,371,81,62,51,55,48,70,166,45,1061,497
732,351,273,78,20,25,42,37,63,164,25,752,376
733,603,469,134,34,42,73,64,108,282,23,1305,626
734,15223,12323,2900,918,1107,1321,1460,2414,8003,0,72365,15223
735,7725,6986,739,1368,1479,532,474,904,2968,0,18736,7725
736,161,146,15,29,31,11,10,19,61,0,544,161
737,2787,1860,927,405,587,308,307,359,821,23,7657,2810
738,352,294,58,5,10,40,48,57,192,0,832,352
739,1286,1040,246,19,18,169,156,221,703,14,3057,1300
740,1626,1398,228,31,48,192,218,308,829,0,3602,1626
741,265,218,47,7,10,28,32,48,140,0,690,265
742,1071,704,367,21,31,119,120,203,577,175,3228,1246
743,379,277,102,4,16,36,36,69,218,49,1095,428
744,2060,1885,175,97,107,241,226,347,1042,0,3321,2060
745,1434,1167,267,123,184,182,188,233,524,0,3037,1434
746,1479,1152,327,20,44,190,219,276,730,0,3479,1479
747,4057,3398,659,233,263,524,499,739,1799,0,9027,4057
748,531,378,153,4,12,66,75,100,274,4,1415,535
749,1343,1035,308,68,78,172,202,239,584,70,3410,1413
750,2639,2115,524,69,274,268,207,474,1347,0,6929,2639
751,3317,2878,439,174,312,431,301,581,1518,0,6862,3317
752,419,327,92,8,12,43,57,87,212,0,1185,419
753,1398,1053,345,13,27,133,174,306,745,0,3897,1398
754,670,520,150,33,40,50,88,117,342,5,1707,675
755,4670,3471,1199,234,202,345,421,818,2650,20,11240,4690
756,375,237,138,5,17,27,32,85,209,76,1130,451
757,1531,1092,439,59,77,212,185,278,720,11,3513,1542
758,1670,1292,378,54,71,192,203,357,793,0,4023,1670
759,1402,1117,285,29,59,188,185,299,642,23,3458,1425
760,2393,1728,665,21,72,358,308,528,1106,29,6301,2422
761,1651,1167,484,46,81,195,168,343,818,47,4503,1698
762,3421,2393,1028,84,171,398,352,746,1670,25,8973,3446
763,5915,4472,1443,425,477,662,596,1042,2713,140,13405,6055
764,2762,2106,656,283,484,276,255,391,1073,20,6387,2782
765,425,333,92,28,50,57,57,73,160,0,983,425
766,341,267,74,23,40,45,46,59,128,0,874,341
767,278,218,60,18,32,37,37,48,106,0,733,278
768,1758,1537,221,287,384,169,187,189,542,288,3205,2046
769,1015,887,128,166,222,98,108,109,312,29,2189,1044
770,485,396,89,68,127,56,56,58,120,70,1189,555
771,1952,1651,301,149,359,175,149,303,817,14,3832,1966
772,899,760,139,69,165,80,69,140,376,43,2243,942
773,892,754,138,68,164,80,68,138,374,0,2182,892
774,796,696,100,130,174,76,85,86,245,9,1426,805
775,812,680,132,43,52,96,125,168,328,0,2157,812
776,637,421,216,11,23,88,69,130,316,16,1966,653
777,450,298,152,8,16,62,49,92,223,0,1383,450
778,313,207,106,5,11,43,34,64,156,11,1103,324
779,419,239,180,24,36,54,52,76,177,0,1050,419
780,640,366,274,37,55,83,80,116,269,202,2137,842
781,632,361,271,37,54,82,79,115,265,54,2061,686
782,529,447,82,40,97,47,40,82,223,707,1335,1236
783,403,230,173,23,34,52,50,73,171,0,1181,403
784,1205,1042,163,163,174,111,104,181,472,146,1883,1351
785,1057,914,143,143,153,97,91,159,414,13,1960,1070
786,530,425,105,62,70,40,44,73,241,0,1147,530
787,1130,977,153,153,163,104,97,170,443,0,2815,1130
788,418,344,74,11,16,44,51,75,221,0,1041,418
789,463,381,82,12,17,49,57,83,245,0,1232,463
790,634,524,110,75,106,67,62,79,245,0,1474,634
791,953,788,165,112,159,101,93,118,370,0,2087,953
792,330,257,73,6,9,34,45,69,167,0,913,330
793,1321,1106,215,69,84,156,203,273,536,20,2530,1341
794,2911,2277,634,147,179,283,270,449,1583,79,7411,2990
795,1899,1571,328,316,389,125,149,224,696,99,4214,1998
796,2632,2178,454,438,540,174,206,311,963,0,5457,2632
797,748,588,160,31,39,69,104,126,379,29,1820,777
798,787,643,144,111,206,90,92,94,194,56,1665,843
799,905,740,165,128,237,104,105,108,223,2,1856,907
800,386,315,71,54,101,44,45,46,96,13,987,399
801,1068,835,233,139,267,105,115,125,317,0,2167,1068
802,521,407,114,68,130,51,56,61,155,9,1153,530
803,1360,1063,297,177,340,133,147,160,403,0,3087,1360
804,2350,1837,513,306,588,231,254,276,695,0,5423,2350
805,576,450,126,75,144,57,62,68,170,0,1330,576
806,626,492,134,26,33,58,87,106,316,63,1531,689
807,700,590,110,96,85,72,67,98,282,56,1673,756
808,1539,1297,242,211,186,159,147,215,621,92,3127,1631
809,391,330,61,54,47,40,37,55,158,36,952,427
810,5992,4872,1120,677,633,408,522,849,2903,20,14032,6012
811,2584,2369,215,497,911,170,170,241,595,2,4098,2586
812,1702,1560,142,327,600,112,112,159,392,18,3346,1720
813,1174,1076,98,226,414,77,77,109,271,0,3012,1174
814,642,470,172,6,26,60,62,116,372,112,1914,754
815,427,280,147,8,12,47,48,81,231,27,1299,454
816,357,226,131,4,16,26,30,81,200,99,1125,456
817,1506,1184,322,47,92,146,151,281,789,0,4029,1506
818,2831,2225,606,89,173,275,284,528,1482,0,6532,2831
819,839,638,201,81,110,86,91,135,336,31,2014,870
820,746,568,178,72,98,76,81,120,299,38,2043,784
821,410,312,98,40,54,42,44,66,164,52,1072,462
822,413,314,99,40,54,42,45,67,165,0,1143,413
823,1099,923,176,160,204,138,88,166,343,0,2305,1099
824,351,274,77,7,10,36,47,73,178,0,1003,351
825,455,343,112,4,9,43,57,100,242,0,1212,455
826,1144,1081,63,184,247,97,110,136,370,0,1707,1144
827,930,725,205,18,26,95,126,193,472,0,2589,930
828,711,595,116,10,20,81,96,116,388,0,1569,711
829,754,713,41,121,162,64,73,89,245,0,1243,754
830,644,609,35,103,139,54,62,76,210,7,1560,651
831,866,818,48,139,187,73,83,103,281,79,1664,945
832,268,208,60,13,16,20,35,47,137,0,702,268
833,500,388,112,25,30,37,66,88,254,0,1194,500
834,524,420,104,62,69,40,44,72,237,27,1254,551
835,3047,2441,606,358,402,230,253,420,1384,0,7266,3047
836,214,184,30,27,52,20,13,26,76,0,564,214
837,2086,1709,377,35,135,210,203,401,1102,194,4716,2280
838,1664,1262,402,15,50,204,187,358,850,46,4274,1710
839,689,575,114,70,107,60,62,97,293,0,1599,689
840,1680,948,732,19,87,179,182,383,830,28,5176,1708
841,1449,764,685,150,287,190,134,208,480,158,4917,1607
842,1477,1135,342,106,140,181,182,208,660,0,3994,1477
843,672,565,107,27,79,73,60,131,302,0,1643,672
844,1993,1621,372,96,179,261,278,324,855,40,4953,2033
845,3053,2307,746,110,419,340,333,568,1283,0,7016,3053
846,426,193,233,26,58,68,44,76,154,0,1520,426
847,1855,1237,618,93,189,261,260,342,710,0,4891,1855
848,1079,848,231,64,113,137,149,139,477,48,2627,1127
849,860,611,249,43,67,111,90,160,389,115,2220,975
850,2502,929,1573,236,362,275,158,410,1061,135,10943,2637
851,1652,611,1041,92,115,267,183,359,636,28,6879,1680
852,1862,1426,436,33,59,281,275,430,784,237,4361,2099
853,712,563,149,74,85,112,78,105,258,0,1928,712
854,1208,908,300,14,47,173,117,261,596,12,3589,1220
855,1917,1569,348,22,83,253,205,408,946,9,4498,1926
856,1757,1584,173,27,83,228,196,358,865,11,4161,1768
857,2744,2203,541,40,103,341,297,611,1352,28,6543,2772
858,1255,980,275,42,43,163,123,274,610,0,3386,1255
859,1345,1060,285,14,40,169,136,317,669,0,3349,1345
860,2390,1912,478,211,293,379,275,336,896,63,5611,2453
861,2248,1740,508,45,127,307,257,449,1063,43,5576,2291
862,2553,2093,460,146,288,291,253,454,1121,73,6307,2626
863,1993,1578,415,25,86,284,217,410,971,20,4844,2013
864,800,631,169,31,58,93,95,164,359,0,2104,800
865,2384,1036,1348,233,388,353,258,445,707,2,8378,2386
866,3532,1650,1882,176,301,574,343,668,1470,98,12172,3630
867,2742,1549,1193,80,200,471,362,621,1008,45,7781,2787
868,1370,1245,125,310,317,165,112,145,321,73,2626,1443
869,226,178,48,9,16,26,27,46,102,697,579,923
870,502,396,106,19,36,58,59,103,227,0,1218,502
871,1935,1306,629,184,336,167,143,273,832,0,5139,1935
872,409,324,85,8,21,46,61,62,211,0,1093,409
873,357,270,87,47,42,40,36,63,129,0,967,357
874,382,288,94,50,45,43,39,68,137,0,1026,382
875,657,496,161,86,77,73,66,117,238,0,1687,657
876,837,630,207,32,62,103,112,122,406,46,2183,883
877,1111,843,268,22,113,114,103,211,548,0,2850,1111
878,848,644,204,17,86,87,78,161,419,3,2188,851
879,354,271,83,12,17,44,36,73,172,0,829,354
880,683,588,95,87,167,63,43,84,239,0,1743,683
881,1883,1622,261,239,460,173,119,233,659,17,4132,1900
882,1427,1229,198,181,348,131,90,176,501,15,3210,1442
883,439,347,92,46,53,69,48,65,158,0,1219,439
884,327,208,119,31,33,28,33,68,134,255,765,582
885,710,452,258,67,71,61,72,147,292,0,1675,710
886,2068,1725,343,210,321,179,187,292,879,0,3655,2068
887,727,606,121,74,113,63,66,103,308,29,1718,756
888,2051,1864,187,464,474,247,168,217,481,2,4554,2053
889,470,360,110,17,23,58,48,96,228,3,1212,473
890,1055,977,78,226,234,112,95,102,286,0,2572,1055
891,1057,978,79,227,234,112,96,102,286,0,1849,1057
892,1274,1179,95,273,282,135,115,123,346,2,2407,1276
893,1916,1147,769,151,306,203,196,248,812,26,6268,1942
894,700,419,281,55,112,74,72,91,296,0,2292,700
895,5251,4630,621,878,1036,302,358,547,2130,12,10438,5263
896,1231,899,332,139,185,178,135,185,409,0,3716,1231
897,470,213,257,28,65,75,49,84,169,0,1869,470
898,1471,1267,204,186,359,135,93,182,516,33,2367,1504
899,1592,953,639,126,254,168,163,206,675,0,4719,1592
900,1449,1258,191,167,250,200,168,199,465,144,3736,1593
901,991,861,130,114,171,137,115,136,318,0,2054,991
902,917,619,298,87,159,79,68,129,395,14,2214,931
903,2004,1635,369,63,187,177,196,372,1009,0,4842,2004
904,613,485,128,12,32,68,92,93,316,14,1593,627
905,431,366,65,60,91,44,34,54,148,36,1064,467
906,1136,966,170,158,239,115,89,142,393,12,2200,1148
907,522,444,78,73,110,53,41,65,180,9,1145,531
908,834,584,250,85,197,94,88,102,268,0,2014,834
909,617,280,337,37,85,99,64,110,222,418,1677,1035
910,777,433,344,63,152,80,97,108,277,8,2359,785
911,813,586,227,73,151,100,84,101,304,0,1826,813
912,584,531,53,132,135,70,48,62,137,0,1385,584
913,693,642,51,149,154,73,63,67,187,0,1344,693
914,644,359,285,52,126,67,81,89,229,195,2344,839
915,711,513,198,64,132,87,74,89,265,0,1548,711
916,1040,750,290,93,194,128,108,129,388,45,2640,1085
917,916,661,255,82,170,112,95,114,343,46,2373,962
918,1167,934,233,93,169,134,123,209,439,0,2966,1167
919,365,292,73,29,53,42,38,65,138,0,783,365
920,749,642,107,6,25,131,73,179,335,0,1859,749
921,3375,2766,609,366,479,460,356,623,1091,27,8035,3402
922,2191,1682,509,33,83,318,251,489,1017,12,6454,2203
923,1672,1288,384,13,73,286,150,396,754,2,4912,1674
924,1914,1655,259,16,115,323,210,413,837,0,4611,1914
925,650,523,127,28,63,86,52,126,295,0,1800,650
926,2079,1646,433,169,284,299,251,332,744,0,5503,2079
927,470,376,94,42,62,61,55,80,170,0,1103,470
928,1064,835,229,6,43,170,93,231,521,0,3024,1064
929,0,0,0,0,0,0,0,0,0,3542,0,3542
930,1498,1197,301,4,59,244,121,357,713,13,4022,1511
931,592,541,51,65,70,73,76,95,213,24,1201,616
932,591,486,105,41,58,84,80,114,214,23,1552,614
933,1481,1138,343,9,63,228,141,332,708,13,4003,1494
934,1122,894,228,5,38,180,88,264,547,0,2967,1122
935,1010,861,149,24,72,166,98,205,445,0,2542,1010
936,1495,1172,323,18,88,247,147,319,676,10,3871,1505
937,1196,888,308,33,63,153,145,250,552,0,3061,1196
938,913,719,194,2,37,153,75,218,428,0,2493,913
939,0,0,0,0,0,0,0,0,0,0,0,0
940,950,910,40,7,52,190,97,207,397,419,2535,1369
941,3025,2528,497,23,117,458,311,739,1377,148,7145,3173
942,1606,1310,296,239,341,165,141,223,497,12,4120,1618
943,1055,870,185,53,85,138,136,225,418,0,2314,1055
944,1008,795,213,131,165,120,115,158,319,0,2041,1008
945,4162,3647,515,1024,1636,249,300,303,650,27,8719,4189
946,778,667,111,74,89,89,122,133,271,0,1510,778
947,781,683,98,110,123,76,107,119,246,0,1472,781
948,2610,2172,438,417,401,312,233,373,874,20,5602,2630
949,862,754,108,122,136,84,118,131,271,0,2015,862
950,1036,862,174,166,159,124,93,148,346,0,3276,1036
951,1287,1125,162,182,203,125,176,196,405,0,2322,1287
952,3146,2974,172,609,646,307,393,406,785,81,5429,3227
953,0,0,0,0,0,0,0,0,0,0,0,0
954,0,0,0,0,0,0,0,0,0,0,0,0
955,6487,6451,36,1311,659,584,465,813,2655,24,8474,6511
956,1576,1224,352,19,64,257,149,339,748,7,4225,1583
957,1357,1283,74,263,279,133,169,175,338,7,2454,1364
958,338,268,70,28,46,49,41,54,120,0,717,338
959,1069,897,172,148,205,113,105,164,334,0,2149,1069
960,1002,880,122,84,99,169,134,208,308,2258,2097,3260
961,608,502,106,31,49,79,78,129,242,0,1590,608
962,643,492,151,35,52,86,59,137,274,0,1556,643
963,712,597,115,23,80,143,61,126,279,1,1888,713
964,832,683,149,86,134,97,99,145,271,0,1851,832
965,984,808,176,102,159,115,117,171,320,0,2442,984
966,589,483,106,61,95,69,70,103,191,13,1490,602
967,692,542,150,8,41,114,68,148,313,0,1538,692
968,808,651,157,111,119,77,78,142,281,0,2005,808
969,1103,918,185,176,170,132,99,158,368,0,2216,1103
970,550,453,97,38,54,78,74,106,200,0,1275,550
971,1314,1052,262,105,190,150,138,235,496,7,2527,1321
972,115,99,16,11,13,13,18,20,40,1,240,116
973,544,466,78,51,62,62,85,93,191,0,1166,544
974,985,777,208,128,161,117,112,154,313,0,2332,985
975,333,292,41,82,131,20,24,24,52,0,698,333
976,1065,886,179,170,164,127,95,152,357,0,2611,1065
977,3128,2468,660,406,510,373,357,490,992,37,7191,3165
978,181,165,16,20,22,22,23,29,65,0,279,181
979,554,472,82,13,40,91,54,113,243,8,1353,562
980,777,710,67,86,92,96,100,124,279,0,1504,777
981,618,564,54,68,74,76,80,99,221,0,1150,618
982,533,435,98,26,61,66,62,108,210,0,1034,533
983,354,289,65,18,41,44,41,72,138,0,900,354
984,1683,1484,199,276,328,163,182,226,508,0,3081,1683
985,927,757,170,46,106,115,107,188,365,0,1971,927
986,1812,1598,214,297,353,175,196,243,548,0,2410,1812
987,1768,1425,343,244,259,168,171,311,615,0,3783,1768
988,1302,1148,154,214,254,126,141,174,393,0,2777,1302
989,866,764,102,142,169,84,94,116,261,2,1899,868
990,370,302,68,18,42,46,43,75,146,21,1080,391
991,0,0,0,0,0,0,0,0,0,0,0,0
992,810,601,209,22,43,103,98,170,374,6,1867,816
993,505,424,81,70,97,53,50,77,158,0,1240,505
994,417,325,92,23,38,55,43,79,179,0,1018,417
995,485,378,107,26,45,64,50,92,208,0,1242,485
996,252,196,56,14,23,33,26,48,108,0,612,252
997,241,188,53,13,22,32,25,46,103,0,596,241
998,696,658,38,135,143,68,87,90,173,26,1869,722
999,488,416,72,11,35,80,48,99,215,0,1236,488
1000,0,0,0,0,0,0,0,0,0,0,0,0
1001,1125,944,181,155,215,119,111,172,353,0,1915,1125
1002,388,301,87,5,16,63,37,83,184,0,1124,388
1003,458,359,99,3,19,73,40,100,223,0,1322,458
1004,429,337,92,2,17,68,38,93,211,17,1277,446
1005,1408,1132,276,61,135,185,113,272,642,0,3486,1408
1006,563,431,132,31,45,75,52,120,240,0,1479,563
1007,710,543,167,39,57,95,65,151,303,97,1750,807
1008,527,421,106,47,70,68,61,90,191,0,1177,527
1009,453,336,117,13,24,58,55,95,208,0,1182,453
1010,2729,2290,439,456,1113,189,85,223,663,5,6740,2734
1011,1502,1494,8,304,153,135,108,188,614,0,3360,1502
1012,0,0,0,0,0,0,0,0,0,0,0,0
1013,3422,2630,792,174,214,431,444,671,1488,31,9245,3453
1014,1440,1070,370,24,66,163,232,290,665,0,3777,1440
1015,2033,1509,524,115,136,221,343,343,875,4,5404,2037
1016,1303,961,342,101,62,170,224,228,518,0,3400,1303
1017,949,735,214,29,55,136,183,135,411,11,2351,960
1018,171,134,37,17,17,22,25,25,65,0,488,171
1019,1357,1065,292,133,138,177,196,196,517,0,3525,1357
1020,3240,2632,608,605,531,486,352,471,795,22,7749,3262
1021,4248,3735,513,428,641,485,485,715,1494,9,8595,4257
1022,8542,6254,2288,888,1196,1169,1042,1396,2851,0,19174,8542
1023,5827,5048,779,941,966,950,862,781,1327,0,12620,5827
1024,885,546,339,41,91,133,110,170,340,58,3177,943
1025,1816,1292,524,133,238,248,239,307,651,13,4712,1829
1026,881,621,260,48,107,129,128,157,312,2,2507,883
1027,2572,1967,605,185,387,394,310,466,830,0,5970,2572
1028,3683,2674,1009,259,446,506,457,693,1322,13,9103,3696
1029,1384,892,492,82,109,267,160,249,517,0,3759,1384
1030,1345,1073,272,100,111,215,172,242,505,44,3033,1389
1031,1830,1358,472,178,249,282,199,364,558,0,4371,1830
1032,3386,2401,985,533,465,528,420,466,974,75,8493,3461
1033,2667,2100,567,122,159,345,428,507,1106,29,6879,2696
1034,1094,912,182,32,59,148,172,204,479,27,2840,1121
1035,4495,3821,674,1268,1071,443,395,448,870,11,11699,4506
1036,973,803,170,99,111,140,135,158,330,0,1855,973
1037,607,470,137,35,44,87,83,106,252,0,1232,607
1038,1665,1086,579,91,124,271,221,334,624,0,4716,1665
1039,1852,1586,266,1014,678,64,11,21,64,0,10958,1852
1040,1633,1144,489,111,202,249,171,295,605,0,3455,1633
1041,29599,23804,5795,3860,3158,2815,2066,4538,13162,20,53948,29619
1042,512,425,87,40,33,65,55,100,219,0,1109,512
1043,5980,4111,1869,2464,1744,579,198,347,648,0,14616,5980
1044,2086,1452,634,719,338,205,154,297,373,0,4083,2086
1045,3874,2245,1629,1182,1252,137,449,292,562,0,9469,3874
1046,45177,40858,4319,5277,7490,4405,4012,7255,16738,49,86694,45226
1047,10203,6813,3390,1460,1993,1024,962,1389,3375,0,34110,10203
1048,456,330,126,99,187,27,31,40,72,7,1263,463
1049,888,651,237,76,104,119,127,174,288,20,3099,908
1050,0,0,0,0,0,0,0,0,0,0,0,0
1051,9209,7997,1212,1074,1506,608,829,1399,3793,0,20070,9209
1052,6623,3787,2836,2125,2444,1017,431,500,106,0,12320,6623
1053,4,4,0,0,0,1,1,0,2,0,8,4
1054,9972,5929,4043,2051,2664,495,595,1181,2986,0,24373,9972
1055,2520,1998,522,432,508,369,341,397,473,0,5633,2520
1056,2120,1278,842,124,215,183,271,446,881,0,7465,2120
1057,2529,2233,296,411,573,303,291,317,634,0,6009,2529
1058,988,626,362,55,133,149,122,206,323,631,3545,1619
1059,240,149,91,28,53,32,26,37,64,0,747,240
1060,2101,1441,660,136,246,309,321,416,673,0,5472,2101
1061,1434,1043,391,66,118,191,165,278,616,0,3344,1434
1062,1945,1430,515,149,263,276,234,329,694,31,4922,1976
1063,1878,1470,408,108,193,273,243,343,718,51,4718,1929
1064,1626,1253,373,165,174,204,214,285,584,0,3194,1626
1065,1239,955,284,126,133,156,163,217,444,0,3402,1239
1066,3335,2042,1293,372,627,218,207,479,1432,0,4107,3335
1067,38,25,13,5,7,4,4,5,13,0,80,38
1068,9305,6213,3092,1332,1817,934,877,1266,3079,0,16041,9305
1069,2914,2348,566,329,428,442,343,449,923,0,6317,2914
1070,8440,5635,2805,1208,1648,847,796,1149,2792,0,31451,8440
1071,1246,904,342,99,172,163,113,208,491,0,3696,1246
1072,1133,822,311,90,156,148,103,189,447,0,2281,1133
1073,2231,1843,388,321,176,291,281,309,853,0,3047,2231
1074,511,372,139,24,42,68,59,99,219,9,1233,520
1075,741,539,202,34,61,99,85,144,318,18,1960,759
1076,345,251,94,16,28,46,40,67,148,0,945,345
1077,2395,2027,368,904,1273,34,17,34,133,0,5535,2395
1078,237,197,40,21,21,30,33,44,88,0,412,237
1079,312,220,92,17,38,46,45,56,110,0,948,312
1080,600,479,121,44,49,96,77,108,226,4,1575,604
1081,1596,1380,216,218,296,134,143,240,565,0,3647,1596
1082,419,260,159,49,92,57,45,65,111,0,1261,419
1083,229,142,87,27,50,31,25,35,61,0,625,229
1084,731,621,110,206,174,72,64,73,142,0,1613,731
1085,530,342,188,31,42,102,61,95,199,80,1574,610
1086,561,362,199,33,44,108,65,101,210,0,1726,561
1087,871,631,240,97,118,146,93,144,273,0,1840,871
1088,1106,856,250,64,80,159,151,193,459,0,2621,1106
1089,522,404,118,30,38,75,71,91,217,0,1186,522
1090,688,499,189,77,93,115,74,114,215,27,1843,715
1091,608,471,137,35,44,87,83,106,253,0,1457,608
1092,361,316,45,92,82,32,31,35,89,0,847,361
1093,5469,3601,1868,1684,2853,347,153,256,176,0,22595,5469
1094,1086,788,298,86,150,142,98,181,429,0,2685,1086
1095,4476,3573,903,606,474,682,709,778,1227,27,10450,4503
1096,1279,990,289,74,92,184,174,223,532,0,2461,1279
1097,823,721,102,211,188,73,70,79,202,9,2065,832
1098,3324,2910,414,852,758,297,283,321,813,0,6154,3324
1099,634,505,129,98,142,80,57,72,185,237,1775,871
1100,560,446,114,86,126,70,50,64,164,0,1454,560
1101,1136,904,232,175,255,143,102,129,332,0,2619,1136
1102,505,417,88,52,57,73,70,82,171,0,1202,505
1103,306,236,70,31,33,38,40,54,110,0,817,306
1104,569,470,99,58,65,82,79,92,193,0,1569,569
1105,991,694,297,67,123,151,104,179,367,20,2359,1011
1106,554,460,94,43,36,71,60,108,236,0,1283,554
1107,276,229,47,21,18,35,30,54,118,0,483,276
1108,121,98,23,23,20,18,13,18,29,0,259,121
1109,1101,864,237,108,112,143,159,159,420,15,2739,1116
1110,1843,809,1034,48,111,315,204,405,760,18,5915,1861
1111,596,473,123,75,67,86,76,97,195,193,1154,789
1112,5,5,0,1,0,1,0,1,2,0,10,5
1113,23037,16688,6349,5006,9468,1343,1571,2011,3638,0,73823,23037
1114,1656,1027,629,194,363,224,180,256,439,13,4876,1669
1115,440,339,101,45,47,55,58,77,158,0,1098,440
1116,0,0,0,0,0,0,0,0,0,0,0,0
1117,895,739,156,129,71,117,113,124,341,15,1385,910
1118,1574,1300,274,226,124,206,198,218,602,0,4047,1574
1119,2232,1681,551,88,138,267,327,478,934,45,5523,2277
1120,2480,1613,867,150,335,252,374,484,885,0,6970,2480
1121,1119,739,380,17,50,141,201,232,478,0,2961,1119
1122,1441,947,494,21,59,190,207,284,680,27,4123,1468
1123,5038,3667,1371,717,680,448,539,859,1795,36,13673,5074
1124,1209,988,221,136,162,161,142,170,438,0,2319,1209
1125,3083,2273,810,206,316,415,417,546,1183,0,7955,3083
1126,2449,1603,846,337,333,368,323,405,683,49,6063,2498
1127,2216,1701,515,296,368,329,312,351,560,209,5172,2425
1128,4592,3818,774,781,854,564,500,639,1254,18,9280,4610
1129,2472,1939,533,388,512,386,305,315,566,0,5452,2472
1130,1404,980,424,76,140,220,202,237,529,0,3747,1404
1131,7624,5267,2357,1058,1931,933,1118,832,1752,62,19929,7686
1132,1593,1048,545,106,141,209,231,326,580,0,4345,1593
1133,2256,1508,748,123,202,331,295,451,854,62,6582,2318
1134,3072,2318,754,102,166,403,432,639,1330,36,7596,3108
1135,1945,1474,471,42,100,300,249,473,781,76,5129,2021
1136,1406,1087,319,8,72,226,198,334,568,0,3570,1406
1137,2782,2135,647,45,161,389,406,616,1165,0,7526,2782
1138,3246,2843,403,85,131,453,457,748,1372,379,6745,3625
1139,1164,896,268,21,60,142,161,322,458,392,3008,1556
1140,1285,1017,268,55,89,182,188,307,464,0,3011,1285
1141,989,741,248,17,47,114,144,232,435,0,2439,989
1142,2762,2206,556,158,282,390,407,508,1017,45,6718,2807
1143,1167,909,258,23,69,146,186,251,492,0,3117,1167
1144,1506,1177,329,95,137,179,249,312,534,107,3806,1613
1145,1989,1508,481,22,107,234,299,490,837,0,5171,1989
1146,1156,825,331,38,79,139,157,252,491,0,2866,1156
1147,2060,1402,658,20,91,238,302,484,925,0,5551,2060
1148,3240,2453,787,120,187,425,463,680,1365,71,8631,3311
1149,2998,1950,1048,294,218,309,393,548,1236,0,8545,2998
1150,1779,1158,621,28,69,171,281,399,831,0,4837,1779
1151,1616,1094,522,21,76,233,254,294,738,0,4548,1616
1152,2556,1742,814,125,210,342,401,402,1076,0,6955,2556
1153,4233,3208,1025,378,378,460,534,778,1705,62,10126,4295
1154,2844,1925,919,151,271,341,387,607,1087,156,8134,3000
1155,4335,3407,928,830,695,288,320,576,1626,9,10429,4344
1156,3560,2902,658,356,509,506,441,578,1170,36,7246,3596
1157,1858,1450,408,80,219,271,250,394,644,98,4367,1956
1158,2863,2290,573,267,465,375,365,501,890,0,6585,2863
1159,2580,1942,638,205,265,377,330,505,898,18,6542,2598
1160,8685,6421,2264,1235,1561,954,1120,1058,2757,0,22189,8685
1161,2707,1988,719,216,287,405,350,446,1003,0,6006,2707
1162,1101,840,261,127,142,141,109,186,396,103,2056,1204
1163,2382,1553,829,344,351,359,334,375,619,0,6607,2382
1164,10885,7788,3097,1454,1794,872,1040,1488,4237,0,27297,10885
1165,1560,1068,492,53,96,240,236,322,613,49,3774,1609
1166,1630,1175,455,139,186,257,248,303,497,0,4168,1630
1167,1539,1181,358,127,171,228,211,283,519,58,4025,1597
1168,2361,1673,688,50,104,376,327,574,930,143,6561,2504
1169,1213,1016,197,36,54,173,176,268,506,4,2440,1217
1170,1967,1663,304,87,120,278,268,472,742,0,4476,1967
1171,1949,1458,491,19,91,236,279,479,845,27,5291,1976
1172,2050,1492,558,27,92,243,306,500,882,4,5279,2054
1173,1667,1272,395,22,78,199,241,436,691,89,4237,1756
1174,2378,1884,494,312,437,353,290,363,623,76,5403,2454
1175,3525,2710,815,108,228,533,434,819,1403,138,7797,3663
1176,7715,6180,1535,690,929,675,791,1113,3517,45,18429,7760
1177,1757,1274,483,85,152,272,237,324,687,138,4085,1895
1178,1699,1160,539,93,208,259,257,302,580,183,4622,1882
1179,2120,1484,636,151,199,335,318,352,765,49,5381,2169
1180,1777,1207,570,33,87,262,248,411,736,0,4969,1777
1181,173,155,18,21,44,29,21,24,34,0,457,173
1182,868,512,356,47,70,113,154,187,297,45,3173,913
1183,848,313,535,56,74,133,134,158,293,12,4116,860
1184,1094,580,514,86,126,148,185,181,368,60,3932,1154
1185,520,249,271,32,66,84,79,95,164,50,2178,570
1186,913,558,355,171,282,153,106,82,119,118,2562,1031
1187,2338,1605,733,313,448,392,334,375,476,90,6662,2428
1188,247,229,18,30,39,50,38,30,60,94,686,341
1189,767,558,209,145,143,140,107,108,124,28,2189,795
1190,3831,2776,1055,453,544,537,402,686,1209,104,9686,3935
1191,1529,1312,217,154,146,256,190,268,515,0,2938,1529
1192,1193,1064,129,44,69,199,134,265,482,9,2529,1202
1193,2232,1736,496,134,251,364,286,421,776,41,5424,2273
1194,643,368,275,121,115,120,85,73,129,55,1871,698
1195,4093,2564,1529,713,1120,558,368,485,849,37,9989,4130
1196,585,260,325,48,46,73,114,100,204,23,2301,608
1197,3059,1713,1346,427,723,510,370,385,644,143,9983,3202
1198,1017,824,193,219,281,122,110,119,166,4,1597,1021
1199,2358,1904,454,368,478,331,208,351,622,60,5491,2418
1200,3681,3035,646,533,675,551,449,511,962,0,7670,3681
1201,2574,2167,407,212,346,363,329,464,860,15,5603,2589
1202,617,506,111,32,60,99,84,113,229,3,1435,620
1203,2065,1696,369,112,186,329,254,428,756,24,5056,2089
1204,5906,5119,787,855,1049,645,587,904,1866,31,11414,5937
1205,1095,903,192,115,180,186,106,189,319,0,2594,1095
1206,566,270,296,81,84,103,92,81,125,8,2115,574
1207,2076,1599,477,264,312,346,262,355,537,12,5008,2088
1208,3975,3043,932,241,363,549,477,795,1550,49,9906,4024
1209,1941,1589,352,105,166,354,231,399,686,13,4795,1954
1210,1615,1350,265,84,162,324,210,275,560,31,3592,1646
1211,2542,1302,1240,296,379,432,323,400,712,0,8189,2542
1212,1050,369,681,178,281,159,115,113,204,0,4342,1050
1213,1068,446,622,105,132,152,180,175,324,89,4746,1157
1214,1019,890,129,138,220,131,124,169,237,198,2468,1217
1215,565,463,102,29,55,91,77,104,209,15,1319,580
1216,984,732,252,240,287,102,88,88,179,82,1643,1066
1217,2649,1970,679,645,774,274,236,237,483,597,7937,3246
1218,1632,841,791,307,445,267,217,191,205,0,4366,1632
1219,773,649,124,99,133,109,92,119,221,0,1949,773
1220,3069,2577,492,391,529,433,365,472,879,0,5893,3069
1221,256,202,54,59,41,47,30,42,37,4595,715,4851
1222,1858,1685,173,646,791,163,100,81,77,81,3357,1939
1223,2850,2548,302,338,729,473,342,389,579,0,5898,2850
1224,2127,1860,267,574,407,295,242,241,368,24,7707,2151
1225,474,328,146,49,63,83,50,82,147,0,1545,474
1226,468,324,144,49,62,82,50,81,144,108,1477,576
1227,2577,2254,323,696,493,358,294,291,445,4,3907,2581
1228,871,685,186,130,150,153,121,129,188,24,1952,895
1229,2115,1573,542,515,618,219,188,189,386,1,5070,2116
1230,1319,652,667,265,416,186,118,127,207,0,4310,1319
1231,2212,1408,804,351,430,349,295,302,485,37,6601,2249
1232,500,343,157,67,96,84,71,80,102,0,1629,500
1233,893,737,156,94,147,152,86,154,260,0,1982,893
1234,1232,651,581,221,248,187,205,153,218,0,4201,1232
1235,492,253,239,93,134,81,65,58,61,327,1726,819
1236,4909,4351,558,1239,1261,695,623,524,567,69,10465,4978
1237,344,271,73,80,56,63,41,56,48,0,855,344
1238,393,286,107,74,73,72,55,55,64,33,859,426
1239,1165,916,249,174,201,204,162,173,251,1,3335,1166
1240,3352,2049,1303,819,1219,386,338,250,340,60,10729,3412
1241,795,591,204,194,232,82,71,71,145,428,2010,1223
1242,417,342,75,23,38,66,51,86,153,0,1016,417
1243,1980,1598,382,301,431,229,251,275,493,2081,4714,4061
1244,532,436,96,27,52,85,72,98,198,0,1194,532
1245,429,352,77,22,42,69,58,79,159,0,1022,429
1246,458,376,82,23,45,73,62,84,171,0,996,458
1247,513,414,99,78,112,59,65,71,128,3,1124,516
1248,304,249,55,16,30,49,41,56,112,0,724,304
1249,497,221,276,41,39,62,97,85,173,10,2053,507
1250,1040,843,197,224,288,125,112,121,170,0,2685,1040
1251,425,294,131,44,56,75,45,73,132,0,1024,425
1252,261,242,19,32,42,53,41,32,61,614,707,875
1253,425,294,131,44,56,75,45,73,132,0,1053,425
1254,498,257,241,94,136,82,66,58,62,32,1872,530
1255,302,151,151,60,87,28,44,26,57,0,1405,302
1256,1995,1219,776,373,616,335,232,180,259,55,7092,2050
1257,241,80,161,38,58,25,26,32,62,9,946,250
1258,401,134,267,63,96,42,43,53,104,0,1513,401
1259,1812,1542,270,280,346,290,182,264,450,69,3116,1881
1260,283,146,137,53,77,46,38,33,36,0,1091,283
1261,824,599,225,156,154,150,115,116,133,162,2216,986
1262,571,415,156,108,107,104,80,80,92,134,1612,705
1263,1264,920,344,240,236,231,177,178,202,0,4150,1264
1264,539,257,282,77,80,98,88,77,119,58,1897,597
1265,724,443,281,177,263,83,73,54,74,0,2274,724
1266,1213,742,471,296,441,140,122,91,123,0,3854,1213
1267,763,403,360,128,151,128,95,105,156,21,3285,784
1268,1047,349,698,164,250,109,112,138,274,0,4333,1047
1269,1210,639,571,203,240,203,150,166,248,0,3724,1210
1270,461,380,81,48,76,78,45,80,134,0,1146,461
1271,629,535,94,97,120,101,63,92,156,14,1323,643
1272,747,618,129,88,79,116,100,120,244,67,1562,814
1273,512,475,37,63,82,104,80,62,121,427,1480,939
1274,539,362,177,103,109,81,69,67,110,0,1659,539
1275,288,267,21,36,46,58,45,35,68,33,781,321
1276,437,293,144,84,88,66,56,54,89,0,1124,437
1277,193,130,63,37,39,29,25,24,39,12,624,205
1278,1224,962,262,182,211,215,170,182,264,377,2557,1601
1279,592,397,195,114,119,89,75,73,122,5,1870,597
1280,467,285,182,114,170,54,47,35,47,0,1249,467
1281,607,420,187,110,161,100,59,69,108,0,1714,607
1282,546,270,276,110,172,77,49,53,85,138,2066,684
1283,991,686,305,179,262,163,96,112,179,0,2103,991
1284,632,560,72,159,162,89,80,67,75,0,1565,632
1285,0,0,0,0,0,0,0,0,0,0,0,0
1286,1803,1598,205,455,463,255,229,193,208,203,4180,2006
1287,498,408,90,124,119,85,58,55,57,37,1017,535
1288,588,462,126,88,101,103,82,87,127,9,1632,597
1289,2244,1837,407,560,536,383,262,247,256,72,4479,2316
1290,1058,866,192,264,253,180,123,116,122,1,1637,1059
1291,432,354,78,108,103,74,50,48,49,0,751,432
1292,558,457,101,139,133,95,65,61,65,13,1297,571
1293,2576,2356,220,624,738,355,286,302,271,27,4195,2603
1294,1277,1168,109,309,366,176,142,150,134,123,2445,1400
1295,555,472,83,86,106,89,56,81,137,0,1153,555
1296,572,440,132,152,266,34,35,34,51,130,1188,702
1297,428,354,74,51,45,66,57,69,140,62,1017,490
1298,192,101,91,32,38,32,24,26,40,0,738,192
1299,604,489,115,50,83,98,81,104,188,0,1483,604
1300,785,635,150,65,107,128,105,135,245,72,2447,857
1301,498,403,95,41,68,81,67,86,155,0,1201,498
1302,271,143,128,45,54,46,34,37,55,3,908,274
1303,805,403,402,159,233,75,118,71,149,17,2867,822
1304,427,345,82,35,58,69,57,74,134,0,1173,427
1305,419,366,53,57,91,54,51,70,96,1419,848,1838
1306,147,131,16,17,38,24,18,20,30,0,388,147
1307,1286,1150,136,153,329,214,154,175,261,0,2873,1286
1308,4234,3703,531,1143,810,588,483,479,731,0,4206,4234
1309,11125,6145,4980,1899,1648,2029,1728,1652,2169,75,43290,11200
1310,15984,7855,8129,2281,2741,1867,1819,2204,5072,37,69361,16021
1311,1042,726,316,15,24,145,189,231,438,9,3567,1051
1312,5543,2949,2594,288,486,701,868,1207,1993,54,22787,5597
1313,1774,849,925,45,72,251,299,428,679,253,6738,2027
1314,3438,1759,1679,56,132,493,561,864,1332,97,12860,3535
1315,1091,601,490,33,75,173,170,226,414,58,4663,1149
1316,1008,592,416,12,33,153,156,221,433,101,3969,1109
1317,896,526,370,13,31,135,151,213,353,30,3398,926
1318,1062,491,571,19,45,145,159,280,414,58,4025,1120
1319,1917,1196,721,264,266,234,227,326,600,19,6233,1936
1320,1509,892,617,28,56,217,167,371,670,45,5174,1554
1321,701,554,147,66,79,100,68,127,261,0,1729,701
1322,3304,2125,1179,244,205,392,276,633,1554,13,11192,3317
1323,489,300,189,9,16,77,53,108,226,0,1532,489
1324,751,415,336,10,38,93,95,189,326,0,2636,751
1325,1260,618,642,43,59,193,148,290,527,24,4677,1284
1326,1398,847,551,43,54,188,160,324,629,15,4328,1413
1327,1221,726,495,157,123,183,134,191,433,24,4379,1245
1328,1680,1058,622,155,144,249,186,314,632,19,5693,1699
1329,296,219,77,65,110,16,19,23,63,0,769,296
1330,3943,3096,847,694,1036,191,336,438,1248,0,11034,3943
1331,1997,1124,873,300,227,365,276,272,557,43,7177,2040
1332,1264,789,475,23,34,202,215,288,502,0,4243,1264
1333,3877,3507,370,78,217,686,573,898,1425,13,8430,3890
1334,1179,679,500,13,30,186,173,271,506,90,4559,1269
1335,919,316,603,92,87,153,136,160,291,9,4360,928
1336,1139,510,629,286,271,155,130,94,203,15,5425,1154
1337,1169,399,770,103,115,178,209,204,360,11,5937,1180
1338,417,122,295,46,22,77,57,62,153,21,2715,438
1339,876,407,469,15,29,165,99,213,355,0,3883,876
1340,874,438,436,49,83,148,109,174,311,0,3726,874
1341,1635,815,820,307,318,301,211,173,325,21,7160,1656
1342,426,220,206,52,81,89,55,63,86,0,1761,426
1343,1863,1333,530,127,154,292,257,318,715,56,6008,1919
1344,1459,726,733,256,199,256,182,195,371,0,6612,1459
1345,1955,1406,549,94,170,303,325,346,717,45,5779,2000
1346,579,401,178,50,68,80,61,114,206,0,1705,579
1347,1263,735,528,25,65,192,154,287,540,58,4590,1321
1348,846,534,312,56,59,139,104,176,312,64,2802,910
1349,1798,874,924,22,46,250,274,498,708,0,7054,1798
1350,1412,858,554,26,48,203,192,358,585,39,4703,1451
1351,4082,2291,1791,68,162,578,662,1023,1589,52,13531,4134
1352,1207,439,768,196,154,230,166,172,289,21,5789,1228
1353,1253,509,744,47,78,257,139,282,450,13,6215,1266
1354,1258,577,681,105,151,230,139,224,409,43,5421,1301
1355,209,123,86,35,29,44,25,24,52,4,849,213
1356,858,309,549,123,119,152,122,131,211,0,3719,858
1357,2401,1710,691,585,351,453,265,269,478,0,6438,2401
1358,198,118,80,35,26,41,28,23,45,0,716,198
1359,2229,1499,730,84,142,392,387,422,802,133,7888,2362
1360,1390,902,488,80,105,179,261,267,498,30,4541,1420
1361,2369,1449,920,159,225,412,318,451,804,97,8523,2466
1362,1562,835,727,139,231,278,202,254,458,0,6244,1562
1363,1014,573,441,64,61,174,125,208,382,732,3961,1746
1364,1314,683,631,54,97,225,195,255,488,13,5789,1327
1365,1673,1353,320,33,50,228,290,352,720,43,4886,1716
1366,1518,1153,365,21,49,235,272,311,630,41,4698,1559
1367,1485,1140,345,58,85,232,250,281,579,4,4087,1489
1368,1000,708,292,140,244,114,104,131,267,0,2367,1000
1369,1973,1166,807,37,88,314,253,480,801,41,6216,2014
1370,715,446,269,49,44,101,93,137,291,28,2409,743
1371,1248,635,613,30,38,200,146,281,553,0,4608,1248
1372,1511,914,597,33,62,206,154,360,696,4,5155,1515
1373,1372,832,540,133,105,203,162,251,518,11,5007,1383
1374,2348,1747,601,230,200,327,229,443,919,0,7222,2348
1375,2265,1604,661,318,552,259,236,296,604,0,6590,2265
1376,315,217,98,44,60,30,36,57,88,0,1082,315
1377,263,165,98,32,26,27,22,42,114,17,847,280
1378,601,299,302,113,117,110,78,64,119,157,2163,758
1379,102,56,46,26,36,14,8,9,9,2,301,104
1380,98,54,44,25,35,13,7,9,9,0,269,98
1381,2387,1690,697,335,582,273,249,312,636,0,7242,2387
1382,685,423,262,59,54,102,82,145,243,32,2678,717
1383,4114,2914,1200,577,1003,470,429,538,1097,0,9778,4114
1384,506,308,198,51,41,71,66,102,175,0,1693,506
1385,5702,4478,1224,1004,1498,276,485,634,1805,41,13632,5743
1386,570,334,236,97,80,120,69,64,140,0,1958,570
1387,1877,1027,850,485,661,249,143,167,172,0,6411,1877
1388,514,305,209,90,69,105,73,58,119,15,1758,529
1389,1361,703,658,165,259,286,176,202,273,176,5571,1537
1390,447,262,185,76,63,94,54,50,110,0,1705,447
1391,437,226,211,53,83,92,57,65,87,0,1579,437
1392,802,551,251,194,258,96,73,70,111,56,2615,858
1393,723,497,226,175,233,86,65,64,100,197,2226,920
1394,587,360,227,10,19,92,63,130,273,24,1948,611
1395,705,430,275,70,57,100,91,143,244,19,2521,724
1396,598,413,185,98,131,102,69,92,106,56,2000,654
1397,6390,4408,1982,1052,1401,1087,742,982,1126,0,20322,6390
1398,635,446,189,69,119,69,129,119,130,36,2039,671
1399,553,341,212,48,43,82,67,117,196,28,2009,581
1400,240,150,90,17,15,34,31,46,97,0,786,240
1401,4909,3089,1820,591,492,500,407,781,2138,0,14218,4909
1402,434,271,163,30,27,61,56,83,177,19,1612,453
1403,799,566,233,112,195,91,83,104,214,97,2571,896
1404,2330,1614,716,199,273,320,247,458,833,2,6950,2332
1405,801,504,297,96,80,82,66,127,350,13,2422,814
1406,1058,730,328,174,232,180,123,163,186,11,3618,1069
1407,296,203,93,42,57,29,33,53,82,0,855,296
1408,1108,767,341,95,130,152,117,218,396,0,2582,1108
1409,197,146,51,43,73,11,13,15,42,0,691,197
1410,4156,3264,892,732,1092,201,354,462,1315,0,10361,4156
1411,2681,1749,932,178,239,474,350,555,885,45,6952,2726
1412,1213,863,350,18,37,173,155,324,506,0,3312,1213
1413,2862,1912,950,22,91,454,507,635,1153,0,7684,2862
1414,1961,1423,538,123,142,334,249,414,699,10,4662,1971
1415,1756,1125,631,16,54,257,292,427,710,3,4919,1759
1416,2098,1540,558,30,85,289,280,533,881,37,5731,2135
1417,1094,618,476,44,59,156,162,273,400,0,2785,1094
1418,1082,812,270,16,35,171,141,290,429,0,2942,1082
1419,926,707,219,11,29,153,125,227,381,0,2584,926
1420,1441,1028,413,12,48,211,228,323,619,17,3988,1458
1421,3362,2222,1140,426,1032,357,266,486,795,42,9514,3404
1422,1858,1211,647,124,179,275,223,394,663,52,5746,1910
1423,755,366,389,102,141,106,125,113,168,1,2667,756
1424,1993,1296,697,136,232,326,257,425,617,42,5619,2035
1425,1828,1114,714,133,263,306,233,321,572,16,4798,1844
1426,1474,1014,460,82,144,248,177,309,514,0,4153,1474
1427,402,267,135,25,35,70,52,86,134,26,1159,428
1428,1057,698,359,63,85,184,151,192,382,0,2829,1057
1429,704,412,292,68,111,107,87,136,195,10,2295,714
1430,1144,779,365,193,371,117,94,135,234,33,2856,1177
1431,1401,912,489,147,139,216,189,266,444,0,4154,1401
1432,1952,1289,663,135,177,299,250,382,709,45,5670,1997
1433,5496,4097,1399,887,1275,727,751,646,1210,108,14043,5604
1434,1568,872,696,136,182,206,272,292,480,27,5949,1595
1435,755,525,230,76,151,106,80,148,194,0,2209,755
1436,2276,1593,683,256,546,346,277,338,513,42,6075,2318
1437,934,636,298,36,88,153,105,216,336,26,2636,960
1438,9784,7224,2560,1510,1753,1472,910,1445,2694,0,26210,9784
1439,2521,1635,886,251,449,379,263,469,710,27,7639,2548
1440,952,588,364,56,70,152,115,202,357,0,2754,952
1441,1379,846,533,62,107,204,198,324,484,14,4058,1393
1442,1742,1204,538,60,133,270,252,385,642,32,4585,1774
1443,2214,1681,533,97,143,394,282,476,822,10,5236,2224
1444,1300,972,328,25,59,219,204,281,512,95,3455,1395
1445,1335,981,354,24,44,210,148,348,561,131,3454,1466
1446,2307,1658,649,49,117,344,317,574,906,49,6361,2356
1447,1557,1190,367,85,134,285,198,311,544,14,3478,1571
1448,1798,1263,535,27,90,264,236,439,742,0,4863,1798
1449,556,314,242,22,30,79,82,138,205,19,1963,575
1450,265,150,115,11,14,38,39,66,97,1,824,266
1451,437,247,190,17,23,62,65,109,161,0,1527,437
1452,340,237,103,34,68,48,36,67,87,14,1040,354
1453,1552,751,801,209,289,219,258,233,344,16,5784,1568
1454,4205,2864,1341,711,1365,428,346,497,858,0,13656,4205
1455,304,225,79,32,51,49,34,59,79,19,1162,323
1456,1362,1008,354,142,227,221,154,265,353,0,3391,1362
1457,1800,1038,762,18,62,216,277,470,757,35,5525,1835
1458,823,482,341,80,129,125,101,159,229,10,2450,833
1459,362,241,121,23,31,63,47,78,120,0,590,362
1460,454,302,152,29,39,79,59,97,151,39,1353,493
1461,1694,1099,595,168,302,255,177,315,477,30,4264,1724
1462,474,315,159,30,41,82,61,102,158,10,1322,484
1463,708,524,184,74,118,115,80,137,184,75,1961,783
1464,572,318,254,50,66,75,99,106,176,14,2155,586
1465,678,472,206,68,136,95,72,133,174,0,1540,678
1466,603,390,213,37,55,102,89,134,186,26,2021,629
1467,1026,664,362,62,93,174,152,228,317,29,2804,1055
1468,308,199,109,19,28,52,46,69,94,35,891,343
1469,1412,1009,403,78,114,231,209,312,468,3,3867,1415
1470,2052,1117,935,141,197,371,359,416,568,192,7037,2244
1471,545,324,221,46,30,111,54,133,171,69,1652,614
1472,1431,946,485,80,116,238,221,325,451,3,4130,1434
1473,1430,1091,339,21,86,233,205,326,559,0,3544,1430
1474,2896,1910,986,75,197,430,480,653,1061,99,8986,2995
1475,324,216,108,52,51,40,40,63,78,15,1014,339
1476,2622,1539,1083,35,156,402,472,634,923,0,8077,2622
1477,1346,741,605,209,265,225,173,215,259,620,4800,1966
1478,3678,2307,1371,207,280,635,547,811,1198,49,10122,3727
1479,545,322,223,17,34,98,71,130,195,0,1634,545
1480,1828,1237,591,57,93,306,267,454,651,0,5198,1828
1481,799,549,250,67,59,131,126,167,249,27,2670,826
1482,546,370,176,51,51,87,84,108,165,10,1518,556
1483,423,327,96,18,18,73,53,93,168,20,932,443
1484,1141,729,412,180,260,134,147,159,261,0,3086,1141
1485,649,414,235,104,120,101,88,95,141,0,1870,649
1486,948,605,343,150,216,112,122,132,216,62,2778,1010
1487,286,183,103,45,65,34,37,40,65,15,994,301
1488,242,154,88,39,45,38,33,35,52,10,735,252
1489,911,581,330,145,169,141,124,133,199,0,2826,911
1490,788,503,285,126,146,122,107,115,172,29,2032,817
1491,682,469,213,58,51,112,107,142,212,230,2273,912
1492,2612,1668,944,412,596,307,336,363,598,0,6982,2612
1493,196,89,107,49,60,24,24,21,18,84,575,280
1494,627,393,234,35,48,108,93,138,205,8,2021,635
1495,464,211,253,115,142,57,58,50,42,18,1907,482
1496,191,87,104,47,58,23,24,20,19,0,556,191
1497,684,310,374,170,209,83,85,73,64,17,2825,701
1498,350,207,143,11,22,63,46,84,124,3,1165,353
1499,1792,1193,599,285,282,219,222,348,436,12,6215,1804
1500,1316,941,375,72,107,215,194,291,437,0,3370,1316
1501,326,208,118,52,60,51,44,48,71,29,1100,355
1502,3259,1479,1780,809,995,398,406,348,303,32,12856,3291
1503,527,357,170,49,50,84,81,105,158,18,1778,545
1504,809,516,293,129,150,126,110,118,176,113,2164,922
1505,613,338,275,95,121,103,79,98,117,198,2093,811
1506,776,525,251,72,73,124,119,154,234,39,2396,815
1507,305,138,167,76,93,37,38,33,28,10,1121,315
1508,568,384,184,53,54,91,87,113,170,0,1474,568
1509,1007,823,184,113,135,134,118,142,365,53,2463,1060
1510,1375,1124,251,154,185,183,162,194,497,0,2541,1375
1511,666,544,122,75,90,89,78,94,240,0,1520,666
1512,3399,2592,807,392,438,435,338,575,1221,0,7875,3399
1513,440,352,88,39,53,39,45,63,201,0,1057,440
1514,350,280,70,31,42,31,36,51,159,0,886,350
1515,417,334,83,37,50,36,43,60,191,0,900,417
1516,1479,1017,462,609,431,143,49,86,161,0,3615,1479
1517,10312,6885,3427,1476,2014,1035,972,1403,3412,0,15584,10312
1518,61,31,30,11,17,10,8,7,8,1,113,62
1519,3005,2628,377,811,575,417,343,340,519,1,6120,3006
1520,92,83,9,32,39,8,5,4,4,3,227,95
1521,3193,2454,739,848,1485,192,196,193,279,172,7075,3365
1522,3589,3254,335,1248,1527,314,192,157,151,5,12969,3594
1523,3699,2997,702,797,1023,445,400,432,602,3,6604,3702
1524,958,776,182,206,265,115,104,112,156,0,3462,958
1525,0,0,0,0,0,0,0,0,0,0,0,0
1526,1060,859,201,228,293,128,115,124,172,0,1741,1060
1527,1892,1402,490,417,702,104,124,149,396,0,6339,1892
1528,1759,1303,456,388,653,97,115,138,368,0,2957,1759
1529,2513,1581,932,303,252,256,209,400,1093,0,10923,2513
1530,2675,2118,557,951,624,427,304,185,184,2,3316,2677
1531,1914,1537,377,341,557,183,208,218,407,0,4384,1914
1532,652,436,216,55,94,76,90,117,220,18,1654,670
1533,310,198,112,47,99,27,48,40,49,0,870,310
1534,840,536,304,127,268,73,129,107,136,37,2443,877
1535,1684,1176,508,100,157,176,248,354,649,184,4580,1868
1536,1119,688,431,54,81,114,159,230,481,40,3350,1159
1537,5,3,2,0,0,1,1,1,2,0,11,5
1538,306,185,121,12,19,37,45,68,125,0,809,306
1539,931,562,369,37,59,112,138,207,378,0,2862,931
1540,1977,1322,655,112,160,236,275,390,804,0,5466,1977
1541,8717,6491,2226,868,1409,934,1305,1532,2669,0,25066,8717
1542,3059,2086,973,550,930,235,384,355,605,34,8472,3093
1543,2698,2039,659,237,335,343,408,506,869,0,6806,2698
1544,1325,904,421,14,40,154,203,343,571,37,3666,1362
1545,1059,673,386,163,271,97,137,151,240,43,2887,1102
1546,1192,777,415,86,146,162,174,221,403,74,3220,1266
1547,1104,867,237,122,167,149,156,179,331,0,3179,1104
1548,385,271,114,32,48,50,54,67,134,21,967,406
1549,1523,1225,298,188,209,179,197,256,494,25,3635,1548
1550,2918,2035,883,109,108,338,465,651,1247,0,8021,2918
1551,0,0,0,0,0,0,0,0,0,0,0,0
1552,331,218,113,32,51,40,52,61,95,9,989,340
1553,1177,849,328,22,48,142,158,291,516,0,3305,1177
1554,407,309,98,13,15,47,53,87,192,0,895,407
1555,1774,1256,518,262,389,150,203,272,498,18,5446,1792
1556,614,459,155,25,45,84,82,126,252,12,1383,626
1557,335,215,120,22,39,39,53,71,111,0,977,335
1558,855,550,305,56,99,101,137,180,282,0,2542,855
1559,2779,1884,895,211,277,350,378,601,962,43,7067,2822
1560,1193,747,446,133,175,131,155,202,397,25,3177,1218
1561,1080,724,356,49,75,141,150,243,422,432,2855,1512
1562,1364,889,475,98,168,186,199,252,461,15,3752,1379
1563,382,239,143,43,56,42,50,65,126,0,1130,382
1564,1231,936,295,38,46,144,161,262,580,0,3361,1231
1565,1220,885,335,85,142,160,170,235,428,37,3211,1257
1566,10999,7786,3213,1627,2410,927,1257,1687,3091,0,23062,10999
1567,633,470,163,77,126,80,78,94,178,0,1525,633
1568,319,239,80,13,23,44,42,65,132,37,887,356
1569,970,705,265,77,109,107,134,188,355,89,2112,1059
1570,516,345,171,44,75,60,71,93,173,43,1413,559
1571,609,408,201,68,107,85,108,98,143,0,1709,609
1572,793,576,217,56,92,104,110,153,278,34,1706,827
1573,1771,1425,346,218,243,208,229,297,576,0,3090,1771
1574,6948,6198,750,1233,1826,385,460,788,2256,0,18054,6948
1575,664,493,171,81,132,83,82,99,187,31,1782,695
1576,4229,2686,1543,651,1082,388,548,603,957,0,9612,4229
1577,25,16,9,2,3,3,4,5,8,0,53,25
1578,1193,767,426,78,138,141,191,252,393,0,3463,1193
1579,839,516,323,41,60,86,119,172,361,0,2132,839
1580,571,459,112,70,78,67,74,96,186,0,1142,571
1581,476,310,166,34,59,65,69,88,161,0,1577,476
1582,5927,3975,1952,660,1041,829,1054,955,1388,0,17193,5927
1583,1176,709,467,47,74,141,174,261,479,0,3303,1176
1584,1451,1186,265,213,249,178,173,220,418,0,2927,1451
1585,267,188,79,22,34,35,38,47,91,0,671,267
1586,10,9,1,2,3,1,1,1,2,0,26,10
1587,748,530,218,111,164,63,85,115,210,0,1966,748
1588,3097,2252,845,245,347,340,428,599,1138,0,8178,3097
1589,659,518,141,73,99,89,93,107,198,83,1367,742
1590,724,592,132,106,124,89,86,110,209,362,1829,1086
1591,1913,1707,206,340,503,106,127,217,620,0,5306,1913
1592,337,203,134,13,21,40,50,75,138,0,789,337
1593,1050,702,348,60,85,125,146,207,427,184,2296,1234
1594,333,223,110,19,27,40,46,66,135,0,858,333
1595,441,284,157,29,51,52,70,93,146,9,1150,450
1596,10379,6499,3880,1161,1518,1135,1345,1759,3461,0,27188,10379
1597,649,406,243,73,95,71,84,110,216,0,1780,649
1598,680,490,190,13,28,82,91,168,298,0,1620,680
1599,733,529,204,14,30,88,98,181,322,25,1849,758
1600,6876,4688,2188,1236,2090,529,863,798,1360,0,20552,6876
1601,0,0,0,0,0,0,0,0,0,0,0,0
1602,357,233,124,26,44,49,52,66,120,0,913,357
1603,250,176,74,21,31,33,35,44,86,12,695,262
1604,2534,1617,917,382,808,219,390,323,412,40,7496,2574
1605,456,341,115,18,33,62,61,93,189,0,1154,456
1606,1089,717,372,104,169,132,171,199,314,86,2812,1175
1607,1168,783,385,130,205,163,208,188,274,0,3273,1168
1608,749,556,193,92,149,94,92,112,210,0,1719,749
1609,794,577,217,63,89,87,110,153,292,202,1887,996
1610,3054,2041,1013,260,441,356,421,550,1026,74,8675,3128
1611,1331,937,394,110,167,173,188,232,461,31,3699,1362
1612,1849,1377,472,184,299,198,277,325,566,0,3528,1849
1613,24,21,3,4,6,1,2,3,8,0,104,24
1614,0,0,0,0,0,0,0,0,0,0,0,0
1615,498,328,170,48,77,61,78,91,143,25,1370,523
1616,248,179,69,5,10,30,33,61,109,0,681,248
1617,3366,2100,1266,72,185,421,433,743,1512,0,9888,3366
1618,741,442,299,10,30,104,91,147,359,94,2815,835
1619,552,401,151,13,29,81,64,123,242,0,1356,552
1620,1110,783,327,39,77,146,119,233,496,26,3218,1136
1621,877,471,406,6,31,125,118,172,425,53,2948,930
1622,529,313,216,15,24,60,79,108,243,19,1733,548
1623,2612,1930,682,262,277,404,335,501,833,0,7034,2612
1624,546,339,207,11,31,77,69,121,237,13,1650,559
1625,753,516,237,48,70,101,84,146,304,51,2110,804
1626,958,621,337,22,54,128,92,230,432,40,2874,998
1627,1360,840,520,27,85,194,146,322,586,23,4336,1383
1628,1281,751,530,37,71,152,176,299,546,0,3962,1281
1629,2187,1543,644,65,116,305,281,468,952,15,6483,2202
1630,1908,1074,834,35,88,193,243,357,992,28,5889,1936
1631,102,72,30,20,13,11,13,15,30,0,331,102
1632,1107,677,430,16,51,160,135,273,472,26,3222,1133
1633,727,467,260,17,43,101,79,181,306,0,2156,727
1634,704,476,228,137,235,62,44,74,152,0,2133,704
1635,2363,1451,912,71,175,324,272,520,1001,36,7416,2399
1636,1106,822,284,21,68,135,113,236,533,17,2967,1123
1637,1987,1299,688,30,109,294,248,429,877,30,6207,2017
1638,2368,1461,907,76,129,295,290,582,996,145,6809,2513
1639,1212,648,564,12,50,158,157,324,511,162,3562,1374
1640,1228,778,450,12,54,175,143,309,535,0,3712,1228
1641,581,407,174,27,36,68,70,101,279,0,1848,581
1642,3321,1790,1531,238,267,323,376,581,1536,68,10919,3389
1643,1677,913,764,31,55,199,241,350,801,98,5465,1775
1644,11900,8022,3878,923,956,1078,1299,2066,5578,26,35077,11926
1645,1908,1140,768,115,126,241,231,324,871,98,5976,2006
1646,1105,854,251,140,127,140,121,135,442,117,2890,1222
1647,1700,1232,468,31,126,269,198,383,693,4,4078,1704
1648,2352,1575,777,56,108,304,280,521,1083,49,7286,2401
1649,1795,1204,591,78,117,233,200,389,778,36,5395,1831
1650,2298,1360,938,74,97,291,282,476,1078,21,7415,2319
1651,1485,980,505,16,79,204,181,316,689,43,4754,1528
1652,352,167,185,17,16,42,46,70,161,0,1324,352
1653,281,168,113,4,11,39,34,56,137,32,1014,313
1654,1015,757,258,19,60,106,142,191,497,0,2240,1015
1655,1802,1406,396,324,36,216,144,396,686,0,3842,1802
1656,1257,971,286,156,160,146,141,226,428,0,2904,1257
1657,297,175,122,4,14,39,34,73,133,0,860,297
1658,350,246,104,67,46,39,45,53,100,0,882,350
1659,905,559,346,18,56,129,97,214,391,23,3090,928
1660,678,392,286,22,33,75,89,130,329,0,2371,678
1661,813,438,375,11,29,124,108,192,349,17,2543,830
1662,1016,797,219,98,109,133,127,201,348,4,2529,1020
1663,435,252,183,14,21,48,57,84,211,11,1540,446
1664,384,279,105,46,50,51,49,63,125,0,1169,384
1665,841,533,308,37,48,121,104,188,343,15,2245,856
1666,1215,853,362,249,217,138,151,153,307,43,3500,1258
1667,1485,1045,440,286,195,164,190,225,425,85,4304,1570
1668,2173,1530,643,419,285,240,277,329,623,211,4652,2384
1669,516,245,271,26,24,61,67,103,235,0,1879,516
1670,239,137,102,15,19,25,26,39,115,2,994,241
1671,635,364,271,39,50,66,69,103,308,62,2273,697
1672,697,400,297,43,55,73,76,113,337,70,2473,767
1673,3366,2197,1169,492,578,243,285,454,1314,0,12116,3366
1674,3833,2502,1331,560,658,277,324,517,1497,0,9913,3833
1675,348,205,143,4,16,46,40,86,156,0,1007,348
1676,449,285,164,20,26,64,56,101,182,17,1663,466
1677,868,502,366,28,43,95,113,167,422,28,2994,896
1678,975,707,268,23,52,144,113,218,425,72,3077,1047
1679,444,262,182,6,21,59,50,110,198,9,1304,453
1680,1385,971,414,64,87,162,168,241,663,23,4087,1408
1681,675,400,275,20,31,77,101,138,308,9,2287,684
1682,1142,829,313,138,149,152,145,187,371,47,3213,1189
1683,1177,676,501,72,93,123,128,191,570,0,4095,1177
1684,8,5,3,0,0,1,1,2,4,60,23,68
1685,845,578,267,54,79,113,94,164,341,0,2413,845
1686,328,238,90,40,43,44,42,54,105,0,1069,328
1687,3997,3148,849,758,995,442,368,472,962,0,10800,3997
1688,857,675,182,163,213,95,79,101,206,0,1982,857
1689,1299,1023,276,246,323,144,120,154,312,0,3398,1299
1690,690,544,146,131,172,76,63,82,166,0,1722,690
1691,475,333,142,97,85,54,59,60,120,26,1500,501
1692,383,199,184,38,45,49,46,58,147,0,1195,383
1693,366,204,162,36,33,48,50,54,145,0,1339,366
1694,428,302,126,15,30,56,46,90,191,28,1125,456
1695,2760,2174,586,524,687,305,254,326,664,0,7536,2760
1696,1372,1081,291,260,342,152,126,162,330,0,2702,1372
1697,509,332,177,74,87,37,43,69,199,0,1346,509
1698,484,316,168,71,83,35,41,65,189,55,1439,539
1699,355,132,223,14,25,46,48,64,158,34,1380,389
1700,843,623,220,85,89,130,108,162,269,4,1830,847
1701,952,611,341,23,57,133,103,236,400,0,2836,952
1702,553,384,169,85,76,71,65,84,172,208,1446,761
1703,1075,747,328,166,149,138,127,163,332,19,2644,1094
1704,606,421,185,93,84,78,71,92,188,0,1553,606
1705,602,465,137,75,77,70,67,108,205,0,1202,602
1706,619,419,200,121,206,55,39,65,133,0,1856,619
1707,3050,1881,1169,98,166,380,374,749,1283,0,8814,3050
1708,519,290,229,50,46,68,71,77,207,9,1864,528
1709,568,399,169,116,102,65,71,72,142,23,1481,591
1710,389,230,159,11,18,44,58,80,178,17,1253,406
1711,402,150,252,16,28,52,55,72,179,0,1469,402
1712,370,178,192,23,25,48,52,69,153,40,1348,410
1713,760,528,232,117,105,98,90,115,235,0,1962,760
1714,939,643,296,60,87,126,105,182,379,251,2690,1190
1715,665,462,203,102,92,86,78,101,206,13,1989,678
1716,1177,818,359,181,163,151,139,178,365,17,3493,1194
1717,523,358,165,33,49,70,58,102,211,0,1539,523
1718,962,593,369,31,52,120,118,236,405,0,2663,962
1719,822,576,246,38,52,96,100,143,393,11,1914,833
1720,581,313,268,42,47,57,66,102,267,0,1834,581
1721,734,396,338,53,59,71,83,128,340,17,2316,751
1722,404,251,153,8,23,57,51,90,175,0,1256,404
1723,651,503,148,82,75,82,71,80,261,6,1541,657
1724,205,123,82,12,14,26,25,35,93,23,603,228
1725,381,269,112,13,27,50,41,80,170,13,1233,394
1726,350,224,126,11,22,50,42,76,149,0,1215,350
1727,2313,1786,527,288,295,269,259,416,786,4,6567,2317
1728,1204,874,330,28,64,178,139,269,526,2,2665,1206
1729,619,322,297,62,73,80,74,95,235,0,2124,619
1730,389,274,115,75,51,43,50,59,111,0,1295,389
1731,111,69,42,2,6,14,14,25,50,0,357,111
1732,501,311,190,10,28,71,63,111,218,0,1469,501
1733,484,300,184,9,27,68,61,108,211,0,1550,484
1734,541,366,175,105,180,48,34,57,117,0,1591,541
1735,856,411,445,54,59,110,121,161,351,26,3224,882
1736,888,477,411,6,32,127,119,174,430,53,3085,941
1737,706,496,210,145,126,80,88,89,178,0,2057,706
1738,390,146,244,16,27,50,53,70,174,19,1433,409
1739,376,140,236,15,26,48,51,68,168,0,1387,376
1740,728,466,262,23,45,103,86,159,312,40,2202,768
1741,212,136,76,7,13,30,25,46,91,28,677,240
1742,987,632,355,31,61,140,117,215,423,0,3251,987
1743,461,257,204,45,41,60,63,69,183,30,1674,491
1744,441,260,181,5,21,58,50,109,198,11,1354,452
1745,1126,817,309,136,147,150,143,184,366,6,3442,1132
1746,2,2,0,0,0,0,0,0,2,0,6,2
1747,646,403,243,14,36,81,83,143,289,0,1839,646
1748,977,561,416,60,77,102,107,159,472,0,2898,977
1749,437,285,152,64,75,32,37,59,170,40,1289,477
1750,222,145,77,32,38,16,19,30,87,26,699,248
1751,82,65,17,16,20,9,8,10,19,9,243,91
1752,553,389,164,107,72,61,71,84,158,0,1381,553
1753,93,61,32,24,35,6,2,8,18,0,387,93
1754,4109,2711,1398,1061,1545,277,87,333,806,0,6329,4109
1755,905,597,308,234,340,61,19,73,178,0,2685,905
1756,1551,1023,528,400,583,105,33,126,304,11,3278,1562
1757,554,375,179,108,185,49,35,58,119,0,1643,554
1758,1047,875,172,83,86,176,114,156,432,8,2657,1055
1759,1049,838,211,22,46,147,124,219,491,0,3081,1049
1760,500,349,151,55,72,78,73,59,163,5,1606,505
1761,1417,995,422,25,54,196,192,295,655,158,3962,1575
1762,2866,2107,759,22,81,403,383,659,1318,49,7779,2915
1763,2502,1844,658,27,82,318,300,583,1192,88,6080,2590
1764,740,588,152,8,17,95,96,177,347,0,1997,740
1765,1061,673,388,58,61,165,132,178,467,0,2642,1061
1766,1504,1168,336,27,59,182,163,361,712,36,3865,1540
1767,1713,1309,404,21,71,237,215,355,814,5,4698,1718
1768,1672,1105,567,163,175,261,202,285,586,548,4863,2220
1769,1795,1213,582,142,202,273,240,277,661,47,5540,1842
1770,1427,1017,410,17,53,210,151,318,678,67,4083,1494
1771,1755,1267,488,215,261,259,216,247,557,10,5369,1765
1772,1163,908,255,118,162,174,147,190,372,70,2868,1233
1773,1018,851,167,31,50,134,124,231,448,36,2440,1054
1774,1792,1220,572,126,209,319,222,299,617,21,5033,1813
1775,1077,641,436,131,207,127,102,121,389,34,3431,1111
1776,806,560,246,59,95,110,92,121,329,13,2228,819
1777,948,598,350,16,27,154,96,164,491,16,3120,964
1778,306,137,169,18,27,46,40,57,118,0,1022,306
1779,1182,895,287,18,35,164,135,224,606,80,3784,1262
1780,1686,1024,662,34,84,185,193,294,896,26,6401,1712
1781,746,540,206,48,57,95,89,150,307,18,2347,764
1782,698,519,179,9,26,121,77,129,336,0,1921,698
1783,1488,1100,388,141,192,208,166,229,552,18,3426,1506
1784,1150,968,182,95,128,171,122,193,441,5,2808,1155
1785,1454,1225,229,32,85,232,175,287,643,26,3683,1480
1786,1131,911,220,198,229,168,124,136,276,0,2297,1131
1787,1311,974,337,24,65,176,144,269,633,13,4141,1324
1788,1361,1056,305,31,75,217,170,252,616,26,4004,1387
1789,1076,812,264,83,115,161,115,185,417,0,2798,1076
1790,833,576,257,153,179,129,100,92,180,21,2203,854
1791,2510,1780,730,289,454,196,194,339,1038,34,7481,2544
1792,1629,1517,112,71,114,217,213,280,734,2807,4350,4436
1793,452,327,125,35,40,74,53,80,170,0,1136,452
1794,1089,785,304,61,83,183,140,187,435,34,3331,1123
1795,1647,1251,396,29,53,258,150,368,789,16,5091,1663
1796,731,541,190,79,78,109,81,106,278,0,2107,731
1797,562,322,240,37,70,83,75,88,209,0,2038,562
1798,1356,1019,337,91,124,156,153,223,609,54,3587,1410
1799,1099,842,257,57,82,159,116,173,512,59,3547,1158
1800,1172,541,631,42,72,196,170,232,460,80,4120,1252
1801,1002,681,321,73,96,137,141,142,413,8,3600,1010
1802,1726,1087,639,35,64,214,198,341,874,72,5720,1798
1803,940,510,430,49,64,131,124,158,414,109,3823,1049
1804,406,314,92,27,38,69,61,60,151,0,1050,406
1805,679,415,264,110,131,100,93,76,169,26,1914,705
1806,391,319,72,59,58,57,44,52,121,18,1008,409
1807,510,398,112,103,135,69,46,52,105,0,1335,510
1808,445,378,67,128,157,42,30,32,56,0,1089,445
1809,329,257,72,66,87,44,30,34,68,0,692,329
1810,531,434,97,65,64,71,61,81,189,0,1460,531
1811,856,630,226,87,105,115,105,121,323,16,2314,872
1812,404,279,125,74,87,62,49,44,88,0,1239,404
1813,446,356,90,9,20,62,53,93,209,10,1136,456
1814,1148,976,172,330,406,109,77,82,144,10,2372,1158
1815,514,382,132,10,25,69,56,105,249,0,1614,514
1816,450,362,88,79,91,67,49,54,110,8,812,458
1817,424,366,58,48,68,66,49,63,130,0,966,424
1818,951,822,129,107,153,147,111,141,292,10,1909,961
1819,578,472,106,71,70,78,67,88,204,129,1774,707
1820,1691,1321,370,342,449,227,153,173,347,0,4547,1691
1821,666,520,146,68,93,100,84,109,212,23,1588,689
1822,750,581,169,42,87,128,98,135,260,96,1771,846
1823,1031,717,314,116,159,140,110,167,339,34,3150,1065
1824,484,390,94,85,98,72,53,58,118,0,1032,484
1825,349,281,68,61,71,52,38,42,85,0,684,349
1826,897,722,175,157,181,134,98,108,219,0,1819,897
1827,285,212,73,5,14,38,31,58,139,47,916,332
1828,6809,4828,1981,784,1232,532,526,919,2816,0,13262,6809
1829,269,210,59,27,38,40,34,44,86,10,760,279
1830,1510,1050,460,110,178,206,172,226,618,0,4606,1510
1831,479,333,146,35,56,65,55,72,196,0,1639,479
1832,841,644,197,44,63,122,88,133,391,78,2394,919
1833,210,146,64,24,32,29,22,34,69,0,593,210
1834,514,358,156,58,79,70,55,83,169,0,1690,514
1835,854,594,260,96,132,116,91,138,281,0,2553,854
1836,545,379,166,61,84,74,58,88,180,0,1517,545
1837,1157,946,211,141,140,156,133,176,411,41,2558,1198
1838,336,260,76,19,39,57,44,60,117,13,793,349
1839,533,393,140,54,65,71,65,76,202,16,1687,549
1840,720,567,153,15,37,116,80,151,321,44,1548,764
1841,500,362,138,39,45,82,58,88,188,49,1282,549
1842,768,604,164,16,39,124,86,161,342,13,1750,781
1843,1180,958,222,276,379,128,99,124,174,0,2739,1180
1844,648,481,167,9,25,112,71,119,312,93,1693,741
1845,172,77,95,10,15,26,22,32,67,83,613,255
1846,619,277,342,37,54,93,81,115,239,0,2413,619
1847,732,569,163,31,40,91,86,126,358,134,2202,866
1848,698,543,155,30,38,86,82,120,342,57,2004,755
1849,673,550,123,82,82,90,78,103,238,0,1241,673
1850,3407,2416,991,392,616,266,263,460,1410,0,8862,3407
1851,282,200,82,32,51,22,22,38,117,13,736,295
1852,1003,663,340,98,105,157,121,171,351,132,3182,1135
1853,378,263,115,28,44,51,43,57,155,44,1374,422
1854,369,225,144,60,71,54,51,41,92,0,1097,369
1855,717,438,279,116,139,105,98,80,179,18,2119,735
1856,457,365,92,10,20,64,54,95,214,0,1108,457
1857,1098,949,149,123,177,170,128,163,337,21,2180,1119
1858,192,134,58,14,23,26,22,29,78,0,722,192
1859,304,211,93,22,36,41,35,46,124,13,1042,317
1860,626,281,345,37,54,94,82,117,242,0,2095,626
1861,582,385,197,57,61,91,70,99,204,0,1608,582
1862,791,469,322,190,117,99,87,87,211,16,2465,807
1863,1296,1008,288,55,71,161,152,223,634,18,3853,1314
1864,374,210,164,37,64,58,40,55,120,0,1211,374
1865,672,378,294,66,115,103,72,98,218,10,2155,682
1866,403,181,222,24,35,61,53,75,155,0,1492,403
1867,423,251,172,102,62,53,46,47,113,21,1074,444
1868,631,416,215,50,88,85,66,93,249,0,1712,631
1869,1159,970,189,225,272,166,116,129,251,26,2857,1185
1870,535,410,125,28,40,78,56,84,249,21,1658,556
1871,680,529,151,29,37,84,80,117,333,34,2090,714
1872,241,187,54,10,13,30,28,42,118,0,614,241
1873,409,313,96,21,31,59,43,65,190,0,1410,409
1874,619,408,211,49,86,83,65,92,244,62,1892,681
1875,1970,1675,295,566,697,187,132,141,247,0,4565,1970
1876,3552,3020,532,1020,1256,338,238,254,446,109,5960,3661
1877,977,831,146,280,345,93,66,70,123,152,1981,1129
1878,353,214,139,25,34,46,34,51,163,0,1342,353
1879,271,173,98,10,11,34,32,50,134,0,939,271
1880,746,451,295,52,73,97,71,108,345,0,2406,746
1881,1273,773,500,180,337,177,122,141,316,13,3087,1286
1882,746,453,293,105,197,103,72,82,187,103,2258,849
1883,952,578,374,134,252,132,91,105,238,152,3190,1104
1884,1134,723,411,42,46,143,133,211,559,101,3421,1235
1885,218,174,44,5,10,31,26,45,101,0,370,218
1886,267,186,81,29,38,42,39,32,87,194,867,461
1887,638,441,197,118,137,98,77,70,138,0,1584,638
1888,390,304,86,62,72,65,48,49,94,16,914,406
1889,405,309,96,5,17,56,51,84,192,0,1054,405
1890,1096,890,206,257,352,119,92,115,161,0,2548,1096
1891,632,356,276,62,108,97,68,92,205,0,2300,632
1892,368,265,103,21,28,62,47,63,147,0,1188,368
1893,963,552,411,63,121,143,128,152,356,28,3026,991
1894,239,167,72,26,34,37,35,28,79,3,756,242
1895,640,403,237,13,24,79,73,126,325,0,2285,640
1896,941,597,344,51,54,147,117,158,414,80,2320,1021
1897,932,721,211,61,87,159,141,139,345,199,2241,1131
1898,357,281,76,8,18,58,40,75,158,0,884,357
1899,325,256,69,7,17,52,36,68,145,0,762,325
1900,1265,888,377,287,545,104,93,82,154,0,4140,1265
1901,747,541,206,58,67,123,87,131,281,52,1790,799
1902,432,248,184,28,54,64,58,68,160,13,1544,445
1903,702,493,209,159,302,58,52,45,86,0,2038,702
1904,447,273,174,72,86,66,61,50,112,8,1114,455
1905,409,334,75,62,61,59,46,54,127,18,936,427
1906,296,180,116,42,78,41,28,33,74,0,824,296
1907,964,713,251,104,103,144,107,139,367,0,2273,964
1908,535,417,118,86,99,89,65,67,129,39,1338,574
1909,836,653,183,85,117,125,106,137,266,21,1613,857
1910,200,113,87,20,34,31,22,29,64,0,651,200
1911,526,395,131,35,48,60,60,86,237,36,1249,562
1912,567,392,175,12,31,81,60,120,263,0,1719,567
1913,761,526,235,17,41,108,81,161,353,13,2362,774
1914,471,325,146,10,25,67,50,99,220,0,1635,471
1915,774,589,185,158,231,100,72,91,122,28,2362,802
1916,1399,1065,334,286,418,180,130,165,220,0,3707,1399
1917,327,273,54,26,27,55,36,49,134,0,835,327
1918,945,714,231,72,101,141,101,163,367,0,2064,945
1919,991,810,181,150,148,144,112,131,306,21,2102,1012
1920,1323,1107,216,256,310,190,132,147,288,202,2707,1525
1921,2153,1802,351,417,505,309,216,239,467,57,5293,2210
1922,663,517,146,106,123,110,81,83,160,41,1656,704
1923,650,456,194,147,280,53,48,42,80,0,1741,650
1924,226,159,67,51,97,19,17,15,27,0,608,226
1925,369,257,112,42,57,50,39,60,121,0,1077,369
1926,89,68,21,18,27,11,8,10,15,0,284,89
1927,9848,7499,2349,2011,2944,1269,915,1158,1551,0,27333,9848
1928,134,97,37,7,10,22,17,23,55,0,543,134
1929,561,434,127,37,52,96,85,84,207,0,1345,561
1930,290,251,39,33,47,45,34,43,88,0,566,290
1931,79,61,18,4,9,13,10,14,29,0,197,79
1932,168,130,38,10,19,29,22,30,58,0,373,168
1933,219,152,67,16,26,30,25,33,89,0,798,219
1934,0,0,0,0,0,0,0,0,0,0,0,0
1935,980,579,401,252,371,88,83,78,108,72,3192,1052
1936,661,635,26,128,113,103,74,81,162,0,1164,661
1937,2394,2070,324,47,72,319,262,488,1206,0,5098,2394
1938,777,651,126,36,52,97,86,147,359,2,1833,779
1939,314,259,55,27,29,41,35,54,128,0,653,314
1940,1411,1195,216,23,29,179,163,334,683,31,3121,1442
1941,215,199,16,10,12,31,25,36,101,0,279,215
1942,972,900,72,44,52,141,115,162,458,15,2484,987
1943,699,611,88,38,38,114,66,131,312,0,1711,699
1944,2449,2141,308,82,96,333,272,535,1131,12,5121,2461
1945,1915,1637,278,33,47,267,187,441,940,0,4483,1915
1946,498,321,177,78,69,86,53,61,151,62,1482,560
1947,1068,1031,37,57,65,187,119,190,450,673,2266,1741
1948,1369,1168,201,45,61,199,161,290,613,0,3001,1369
1949,263,193,70,22,23,36,36,52,94,19,652,282
1950,1151,976,175,50,81,163,143,212,502,0,3109,1151
1951,45,28,17,4,5,8,5,7,16,0,133,45
1952,1572,1204,368,39,38,206,167,308,814,6,4091,1578
1953,374,312,62,44,54,60,42,54,120,0,953,374
1954,1660,1047,613,215,363,244,180,224,434,0,4609,1660
1955,800,687,113,57,86,130,115,125,287,0,1395,800
1956,1559,1338,221,112,167,254,223,244,559,17,3433,1576
1957,741,616,125,118,147,100,85,84,207,0,1742,741
1958,3275,2616,659,295,387,412,349,471,1361,0,8313,3275
1959,5712,4257,1455,820,995,614,525,857,1901,4,14862,5716
1960,67,46,21,1,2,8,7,13,36,0,142,67
1961,960,785,175,146,175,145,115,122,257,0,2083,960
1962,358,322,36,28,39,48,38,57,148,0,560,358
1963,241,191,50,22,27,36,29,36,91,0,611,241
1964,439,402,37,41,32,72,51,67,176,1321,1025,1760
1965,552,437,115,49,51,81,60,101,210,0,1245,552
1966,510,302,208,83,72,100,49,72,134,60,1552,570
1967,276,163,113,45,39,54,27,39,72,12,862,288
1968,432,316,116,28,23,66,53,77,185,0,1015,432
1969,603,493,110,92,110,91,72,77,161,0,1465,603
1970,678,507,171,155,118,124,89,69,123,0,1585,678
1971,267,147,120,39,42,49,29,37,71,0,882,267
1972,582,476,106,88,106,88,70,74,156,0,1404,582
1973,505,378,127,116,88,93,67,51,90,17,1093,522
1974,570,426,144,130,100,105,75,58,102,0,1174,570
1975,1855,1772,83,729,464,268,170,111,113,0,2752,1855
1976,469,313,156,217,127,51,39,18,17,0,1043,469
1977,256,166,90,89,56,52,28,13,18,8,548,264
1978,1992,1900,92,1044,382,281,140,71,74,0,2484,1992
1979,0,0,0,0,0,0,0,0,0,164,0,164
1980,2329,1560,769,470,597,473,341,218,230,29,4547,2358
1981,428,339,89,56,76,63,48,55,130,0,955,428
1982,2345,1857,488,834,547,375,267,162,160,0,5715,2345
1983,1740,1474,266,200,266,259,205,232,578,0,3902,1740
1984,559,443,116,73,100,82,63,72,169,0,1182,559
1985,706,375,331,210,162,108,71,68,87,89,1985,795
1986,526,450,76,88,106,77,65,63,127,0,1136,526
1987,580,482,98,92,115,78,67,66,162,0,1384,580
1988,437,321,116,62,50,73,50,70,132,0,1024,437
1989,528,262,266,92,92,90,44,68,142,0,1836,528
1990,476,281,195,77,67,94,46,67,125,64,1265,540
1991,1007,676,331,205,217,159,81,109,236,10,2887,1017
1992,315,156,159,55,55,54,27,41,83,0,1134,315
1993,637,397,240,60,65,120,69,96,227,19,1731,656
1994,1543,1483,60,299,263,239,173,189,380,8,2568,1551
1995,944,855,89,300,190,149,109,82,114,0,1759,944
1996,665,463,202,179,116,125,86,64,95,0,1753,665
1997,4206,2805,1401,1930,1646,198,286,87,59,8,8928,4214
1998,1315,1191,124,418,265,207,152,114,159,0,2130,1315
1999,1233,1117,116,391,248,194,143,107,150,0,1890,1233
2000,636,443,193,171,111,119,82,61,92,0,1337,636
2001,569,396,173,153,99,107,74,55,81,0,1304,569
2002,395,275,120,106,69,74,51,38,57,14,934,409
2003,276,211,65,7,7,36,29,54,143,0,717,276
2004,2959,2839,120,1138,756,421,309,188,147,27,5678,2986
2005,1512,1451,61,581,386,215,158,96,76,221,2799,1733
2006,528,359,169,157,95,110,62,39,65,795,1237,1323
2007,734,659,75,121,97,126,99,107,184,0,1562,734
2008,721,539,182,165,126,132,95,73,130,44,1539,765
2009,868,530,338,285,192,130,111,62,88,807,1869,1675
2010,1039,849,190,115,125,145,93,166,395,0,2431,1039
2011,423,330,93,56,58,62,49,54,144,0,991,423
2012,691,540,151,92,94,101,80,89,235,10,1670,701
2013,458,298,160,83,88,87,45,55,100,29,1168,487
2014,414,267,147,65,57,72,44,51,125,0,1158,414
2015,394,265,129,80,85,62,32,43,92,0,1152,394
2016,335,209,126,31,34,63,36,51,120,0,850,335
2017,449,258,191,101,75,80,64,47,82,15,1574,464
2018,602,345,257,135,100,107,85,63,112,10,2037,612
2019,400,205,195,84,106,74,47,35,54,25,1555,425
2020,376,299,77,127,77,77,47,16,32,15,813,391
2021,1217,815,402,246,312,247,178,114,120,0,2864,1217
2022,366,313,53,26,31,54,50,60,145,0,721,366
2023,705,633,72,55,78,94,75,113,290,8,1436,713
2024,442,308,134,119,77,83,57,43,63,0,911,442
2025,476,273,203,107,79,85,67,50,88,23,1708,499
2026,291,167,124,65,48,52,41,30,55,17,1013,308
2027,722,464,258,121,110,141,70,87,193,0,1973,722
2028,451,290,161,76,69,88,44,54,120,145,1281,596
2029,331,223,108,50,46,60,34,39,102,17,1063,348
2030,561,378,183,85,78,102,58,66,172,0,1579,561
2031,600,404,196,91,83,109,62,70,185,0,1516,600
2032,334,225,109,51,46,61,34,39,103,0,812,334
2033,481,324,157,73,67,87,49,56,149,64,1269,545
2034,453,305,148,69,63,82,47,53,139,0,1339,453
2035,392,321,71,20,23,52,40,76,181,0,1003,392
2036,1445,1306,139,372,361,221,131,156,204,72,2873,1517
2037,722,649,73,119,96,124,98,105,180,0,1311,722
2038,591,361,230,194,130,89,76,42,60,15,1316,606
2039,688,618,70,114,91,119,93,100,171,0,1147,688
2040,1298,1264,34,259,172,240,152,182,293,0,2197,1298
2041,1072,969,103,276,268,164,97,116,151,211,2085,1283
2042,2276,1336,940,873,776,257,177,110,83,0,7198,2276
2043,716,425,291,23,41,127,67,146,312,114,2351,830
2044,613,340,273,109,99,117,58,75,155,62,1945,675
2045,392,252,140,62,54,68,42,48,118,0,951,392
2046,394,256,138,71,76,74,39,47,87,0,1227,394
2047,380,297,83,51,52,56,44,49,128,0,892,380
2048,524,317,207,112,94,96,42,66,114,0,1436,524
2049,848,498,350,325,289,96,66,41,31,0,2397,848
2050,352,222,130,74,70,68,33,41,66,145,1258,497
2051,1203,711,492,309,455,108,102,96,133,29,3850,1232
2052,1040,635,405,253,249,155,111,107,165,393,2447,1433
2053,644,395,249,118,119,126,60,71,150,0,2094,644
2054,459,282,177,84,85,90,43,51,106,0,1205,459
2055,555,341,214,102,103,109,51,61,129,0,1541,555
2056,249,153,96,46,46,49,23,28,57,0,781,249
2057,272,167,105,50,50,53,25,30,64,0,902,272
2058,284,174,110,52,53,56,26,31,66,0,805,284
2059,297,152,145,63,79,55,35,26,39,8,1123,305
2060,150,95,55,19,33,22,16,20,40,0,422,150
2061,554,347,207,191,134,96,62,26,45,2,1349,556
2062,409,257,152,141,99,71,46,19,33,0,914,409
2063,703,430,273,231,155,105,90,50,72,7508,1731,8211
2064,335,185,150,50,52,61,36,47,89,0,1049,335
2065,1223,768,455,262,296,221,134,121,189,56,3744,1279
2066,517,325,192,111,125,93,57,51,80,6,1727,523
2067,1722,1703,19,989,385,173,85,53,37,540,2393,2262
2068,1539,1031,508,311,395,313,225,144,151,12,2833,1551
2069,697,512,185,98,80,116,80,111,212,0,1717,697
2070,342,222,120,62,66,65,34,41,74,0,1124,342
2071,460,272,188,75,65,91,45,65,119,0,1234,460
2072,406,243,163,60,57,95,40,53,101,4,1314,410
2073,487,299,188,97,67,92,49,63,119,0,1245,487
2074,348,213,135,70,48,66,35,45,84,0,991,348
2075,305,157,148,47,46,58,35,40,79,0,1204,305
2076,683,645,38,92,68,108,67,107,241,12,1034,695
2077,1109,925,184,130,160,177,125,161,356,54,2595,1163
2078,768,602,166,296,167,125,92,36,52,21,1858,789
2079,452,279,173,166,93,79,50,31,33,10,1023,462
2080,682,420,262,251,140,119,75,47,50,101,1587,783
2081,295,216,79,25,26,41,41,58,104,0,719,295
2082,460,237,223,70,70,88,53,60,119,2,1790,462
2083,746,385,361,114,113,143,86,98,192,10,2814,756
2084,1133,581,552,239,301,210,134,100,149,0,3798,1133
2085,315,174,141,47,49,57,34,44,84,0,987,315
2086,393,217,176,35,42,72,40,63,141,75,1305,468
2087,369,270,99,24,20,56,46,65,158,25,1104,394
2088,903,761,142,151,168,112,103,107,262,14,1894,917
2089,1577,1379,198,730,416,203,127,51,50,4,3084,1581
2090,533,509,24,210,133,77,49,32,32,27,774,560
2091,0,0,0,0,0,0,0,0,0,147,0,147
2092,621,342,279,56,67,114,63,99,222,0,2066,621
2093,246,232,14,33,25,39,24,39,86,0,582,246
2094,281,139,142,49,49,48,24,36,75,0,972,281
2095,441,304,137,7,15,52,49,83,235,0,1182,441
2096,318,190,128,47,45,74,32,42,78,0,1026,318
2097,334,245,89,22,18,51,41,59,143,0,879,334
2098,1338,882,456,553,478,79,106,54,68,60,4400,1398
2099,246,201,45,13,14,33,25,47,114,0,566,246
2100,940,850,90,242,235,144,85,101,133,0,1573,940
2101,649,587,62,167,162,99,59,70,92,0,1234,649
2102,2902,2768,134,1522,556,409,203,104,108,151,5055,3053
2103,787,766,21,119,71,139,100,131,227,10,1261,797
2104,382,269,113,51,54,60,38,54,125,0,939,382
2105,383,231,152,82,69,70,31,48,83,0,1194,383
2106,2115,2030,85,813,540,301,221,135,105,15,3404,2130
2107,517,430,87,82,102,70,59,58,146,0,1049,517
2108,808,684,124,93,123,120,95,108,269,0,1635,808
2109,815,677,138,129,161,110,94,92,229,0,1707,815
2110,418,260,158,39,42,79,45,63,150,0,1087,418
2111,502,312,190,168,152,79,51,27,25,0,1382,502
2112,522,324,198,175,159,82,53,29,24,21,1615,543
2113,383,342,41,45,42,61,40,54,141,0,808,383
2114,348,306,42,29,32,56,33,59,139,0,889,348
2115,1382,922,460,634,541,65,94,29,19,0,3252,1382
2116,2919,1491,1428,812,463,376,339,357,572,0,7038,2919
2117,666,527,139,87,119,98,75,85,202,0,1639,666
2118,543,443,100,60,66,76,48,86,207,0,1191,543
2119,1767,1540,227,644,606,221,153,75,68,2,4623,1769
2120,844,842,2,385,213,104,75,38,29,255,870,1099
2121,409,278,131,121,74,85,48,31,50,0,933,409
2122,456,310,146,135,82,95,54,34,56,0,1051,456
2123,398,350,48,33,37,64,38,67,159,0,952,398
2124,676,515,161,171,100,120,76,61,148,0,1185,676
2125,410,394,16,203,86,63,36,15,7,33,678,443
2126,553,545,8,222,142,86,52,31,20,74,661,627
2127,725,620,105,121,146,106,89,87,176,0,1648,725
2128,389,333,56,65,79,57,48,46,94,0,773,389
2129,1365,1130,235,243,365,160,145,146,306,0,2493,1365
2130,996,840,156,166,185,123,114,118,290,0,1967,996
2131,737,622,115,123,137,91,84,87,215,0,1543,737
2132,597,498,99,70,86,95,67,87,192,0,1525,597
2133,578,448,130,127,90,117,77,64,103,0,1125,578
2134,418,331,87,55,75,62,47,54,125,52,975,470
2135,1104,946,158,77,95,163,152,182,435,10,2137,1114
2136,344,281,63,52,63,52,41,44,92,0,882,344
2137,584,522,62,68,65,93,61,82,215,0,1292,584
2138,452,398,54,37,42,73,43,76,181,0,987,452
2139,437,288,149,181,156,26,35,18,21,0,887,437
2140,1111,1082,29,222,147,205,130,156,251,0,1778,1111
2141,861,838,23,130,78,152,109,143,249,23,1415,884
2142,392,370,22,53,39,62,38,62,138,19,589,411
2143,604,542,62,118,89,112,84,63,138,0,1145,604
2144,369,286,83,81,57,75,49,41,66,27,959,396
2145,339,263,76,75,53,69,45,38,59,0,838,339
2146,288,171,117,58,42,52,44,31,61,0,911,288
2147,400,327,73,20,24,53,41,77,185,0,1010,400
2148,298,227,71,46,35,46,47,35,89,0,787,298
2149,402,239,163,80,58,72,61,43,88,0,1273,402
2150,475,323,152,70,68,83,44,56,154,44,1167,519
2151,498,391,107,192,108,81,60,24,33,0,1005,498
2152,500,276,224,74,78,91,54,70,133,0,1612,500
2153,5405,5346,59,3103,1207,542,268,166,119,60,8450,5465
2154,4156,3949,207,1500,862,715,476,301,302,50,6203,4206
2155,656,560,96,99,75,86,78,89,229,4,1275,660
2156,563,464,99,48,52,74,63,98,228,19,1239,582
2157,351,289,62,30,32,46,39,61,143,0,731,351
2158,390,310,80,35,44,58,47,58,148,0,893,390
2159,276,228,48,23,25,36,31,48,113,0,563,276
2160,430,322,108,98,75,79,57,44,77,0,987,430
2161,472,353,119,108,82,87,62,48,85,0,1089,472
2162,1726,1640,86,623,358,297,198,125,125,35,2835,1761
2163,407,387,20,147,84,70,47,30,29,0,718,407
2164,475,451,24,171,98,82,54,34,36,0,694,475
2165,637,605,32,230,132,110,73,46,46,46,1029,683
2166,1887,1723,164,490,379,315,229,191,283,89,3259,1976
2167,619,604,15,194,124,106,72,51,72,35,943,654
2168,1038,1013,25,326,209,178,121,85,119,0,1537,1038
2169,653,637,16,205,131,112,76,53,76,0,1159,653
2170,921,899,22,289,185,158,107,75,107,0,1374,921
2171,1297,1246,51,252,221,201,146,159,318,0,1691,1297
2172,575,553,22,112,98,89,65,70,141,0,771,575
2173,932,593,339,226,259,134,133,88,92,4,2783,936
2174,424,267,157,89,84,82,39,49,81,0,1609,424
2175,287,210,77,19,16,44,35,51,122,12,798,299
2176,780,617,163,69,72,114,84,143,298,15,1853,795
2177,433,317,116,28,23,66,54,77,185,0,1084,433
2178,782,645,137,66,72,103,88,135,318,0,1639,782
2179,465,299,166,73,64,80,50,57,141,0,1052,465
2180,782,699,83,91,87,125,82,110,287,4,1626,786
2181,403,240,163,80,58,72,61,43,89,0,1151,403
2182,639,583,56,166,128,107,77,65,96,0,1203,639
2183,239,142,97,48,34,43,36,26,52,0,733,239
2184,755,684,71,240,152,119,87,65,92,2,1237,757
2185,459,263,196,103,76,82,65,48,85,0,1474,459
2186,696,370,326,207,160,106,70,67,86,0,2337,696
2187,270,165,105,61,39,48,35,31,56,17,962,287
2188,539,346,193,91,82,105,52,65,144,0,1570,539
2189,2939,1736,1203,756,1111,263,249,234,326,0,6917,2939
2190,381,211,170,14,28,70,33,75,161,8,1466,389
2191,268,213,55,24,30,40,32,40,102,0,642,268
2192,398,321,77,41,43,63,41,65,145,48,932,446
2193,428,340,88,39,48,64,51,64,162,0,1037,428
2194,311,246,65,28,29,45,34,57,118,0,758,311
2195,508,410,98,53,55,81,52,83,184,0,1187,508
2196,296,239,57,31,32,47,31,48,107,8,738,304
2197,608,503,105,108,162,71,65,65,137,0,1200,608
2198,325,298,27,30,23,54,38,50,130,0,723,325
2199,496,275,221,88,80,94,47,60,127,17,1769,513
2200,365,285,80,49,50,53,42,47,124,0,837,365
2201,3148,2002,1146,764,876,453,450,296,309,4,9186,3152
2202,607,381,226,130,147,110,67,60,93,27,2085,634
2203,314,174,140,56,51,60,30,38,79,17,1051,331
2204,505,328,177,91,98,95,50,60,111,0,1735,505
2205,1104,648,456,423,376,125,86,53,41,0,2464,1104
2206,708,428,280,151,127,130,57,89,154,0,2213,708
2207,645,473,172,91,74,107,74,103,196,0,1479,645
2208,1545,1318,227,51,68,224,182,327,693,0,3305,1545
2209,3144,1983,1161,660,625,606,292,362,599,0,9613,3144
2210,460,307,153,213,125,50,39,17,16,4,1098,464
2211,388,214,174,35,42,71,39,62,139,0,1073,388
2212,259,155,104,38,36,61,26,34,64,0,819,259
2213,369,348,21,49,37,58,36,58,131,0,557,369
2214,256,153,103,38,36,60,25,34,63,0,892,256
2215,380,209,171,34,41,70,39,61,135,0,1152,380
2216,6721,5859,862,2449,2305,841,583,286,257,89,11426,6810
2217,664,419,245,139,132,128,62,76,127,0,2042,664
2218,464,285,179,93,64,88,47,60,112,0,1319,464
2219,366,219,147,54,51,86,36,48,91,0,1162,366
2220,453,304,149,92,97,72,37,49,106,0,1151,453
2221,689,422,267,223,198,92,63,47,66,224,2066,913
2222,394,256,138,71,76,74,39,47,87,0,1206,394
2223,475,309,166,86,92,90,47,57,103,0,1335,475
2224,420,377,43,82,62,78,59,44,95,23,862,443
2225,480,431,49,94,71,89,67,50,109,0,1013,480
2226,3135,3060,75,1501,704,430,264,152,84,0,8265,3135
2227,547,386,161,73,77,86,54,78,179,19,1348,566
2228,653,586,67,127,96,121,91,68,150,0,1072,653
2229,325,266,59,17,19,43,33,63,150,0,819,325
2230,537,455,82,62,82,80,63,72,178,0,1296,537
2231,393,301,92,10,9,51,42,77,204,0,1035,393
2232,1471,901,570,477,423,197,135,101,138,10,4233,1481
2233,405,394,11,61,37,71,51,67,118,33,700,438
2234,260,131,129,61,53,45,30,24,47,0,721,260
2235,641,416,225,224,141,130,70,31,45,0,1518,641
2236,627,559,68,91,95,89,72,83,197,0,1167,627
2237,558,308,250,21,40,103,48,111,235,0,1829,558
2238,264,216,48,13,16,35,27,51,122,0,643,264
2239,459,409,50,66,69,65,53,61,145,0,863,459
2240,360,199,161,53,56,66,39,50,96,15,1060,375
2241,551,495,56,43,61,74,59,88,226,8,1029,559
2242,479,410,69,80,97,70,59,57,116,0,1086,479
2243,545,466,79,91,110,80,67,65,132,153,1070,698
2244,564,413,151,47,50,78,78,111,200,244,1401,808
2245,285,217,68,72,42,51,32,26,62,0,673,285
2246,502,365,137,93,64,89,69,56,131,0,1337,502
2247,263,204,59,58,41,53,35,29,47,0,747,263
2248,3737,2462,1275,1546,1335,221,296,151,188,14,11697,3751
2249,454,346,108,115,67,81,51,41,99,0,1120,454
2250,476,346,130,88,61,84,65,53,125,29,1027,505
2251,390,283,107,72,50,69,54,43,102,0,1072,390
2252,536,478,58,78,81,76,62,71,168,0,1093,536
2253,604,539,65,87,91,86,69,80,191,0,1162,604
2254,512,390,122,79,59,79,81,59,155,72,1261,584
2255,401,203,198,94,82,70,46,37,72,0,1263,401
2256,340,234,106,5,11,40,37,64,183,0,841,340
2257,577,398,179,9,19,68,64,108,309,0,1597,577
2258,2155,1420,735,891,770,127,171,87,109,8,6132,2163
2259,627,535,92,95,71,82,75,86,218,0,1315,627
2260,495,250,245,116,101,87,56,46,89,0,1275,495
2261,382,193,189,90,78,67,43,35,69,0,1209,382
2262,340,181,159,101,78,52,34,33,42,0,1048,340
2263,324,199,125,73,47,57,42,37,68,74,1090,398
2264,385,236,149,87,56,68,50,44,80,0,983,385
2265,437,297,140,65,63,76,40,51,142,0,1099,437
2266,307,188,119,70,45,54,40,35,63,0,981,307
2267,247,159,88,42,38,48,24,30,65,0,764,247
2268,490,334,156,73,70,86,45,58,158,0,1368,490
2269,468,301,167,74,64,81,50,57,142,33,1222,501
2270,492,335,157,73,71,86,46,58,158,0,1443,492
2271,333,227,106,49,48,58,31,39,108,8,888,341
2272,3330,1955,1375,1277,1135,376,259,161,122,0,8644,3330
2273,548,344,204,118,133,99,60,54,84,0,2011,548
2274,119,110,9,5,6,17,14,20,57,288,170,407
2275,101,94,7,5,5,15,12,17,47,0,221,101
2276,1165,1162,3,531,294,144,103,52,41,101,2129,1266
2277,2650,2586,64,1269,595,364,223,129,70,79,2997,2729
2278,247,236,11,97,62,36,23,15,14,91,348,338
2279,400,259,141,208,115,35,26,9,7,70,1026,470
2280,635,411,224,330,183,56,41,15,10,10,1267,645
2281,58,47,11,6,6,9,6,9,22,12,151,70
2282,431,284,147,178,154,25,34,17,23,6,1097,437
2283,911,842,69,7,21,107,126,202,448,0,1876,911
2284,880,846,34,15,23,89,129,156,468,0,1901,880
2285,1254,1208,46,63,48,147,195,218,583,0,2692,1254
2286,670,646,24,65,48,83,82,110,282,0,1564,670
2287,1644,1591,53,54,55,175,223,316,821,33,3479,1677
2288,993,966,27,65,61,138,126,168,435,0,2038,993
2289,538,509,29,134,108,73,66,53,104,0,1069,538
2290,871,843,28,152,122,112,97,109,279,51,1787,922
2291,15,11,4,2,3,2,2,3,3,1688,35,1703
2292,244,234,10,45,36,38,33,29,63,1574,515,1818
2293,659,626,33,124,90,101,110,87,147,1542,1525,2201
2294,312,296,16,59,43,48,52,41,69,896,889,1208
2295,3307,3281,26,1114,587,421,449,259,477,159,7163,3466
2296,307,258,49,76,33,57,46,26,69,9,643,316
2297,772,747,25,155,96,98,90,105,228,28,1646,800
2298,438,412,26,109,75,59,64,42,89,0,806,438
2299,822,815,7,277,146,105,112,64,118,3,1639,825
2300,18,17,1,5,3,3,2,2,3,0,18,18
2301,515,472,43,135,94,78,57,51,100,0,688,515
2302,1605,1472,133,420,293,242,178,160,312,0,1907,1605
2303,6366,5837,529,1666,1163,961,705,633,1238,0,8731,6366
2304,621,591,30,112,62,74,89,67,217,0,1447,621
2305,400,379,21,99,81,54,49,40,77,0,902,400
2306,803,773,30,204,124,127,106,83,159,0,1663,803
2307,462,440,22,122,83,60,57,41,99,0,942,462
2308,478,452,26,119,96,64,59,47,93,10,1227,488
2309,476,449,27,87,71,79,72,42,125,0,1147,476
2310,352,339,13,123,94,33,25,24,53,11,616,363
2311,767,726,41,190,154,103,94,76,150,134,1905,901
2312,471,430,41,106,65,76,59,51,114,0,1102,471
2313,432,394,38,98,59,69,54,46,106,0,890,432
2314,2135,1958,177,559,390,322,237,212,415,0,2845,2135
2315,1132,1038,94,296,207,171,125,113,220,0,2059,1132
2316,1646,1509,137,431,301,248,182,164,320,3,2672,1649
2317,2055,1884,171,538,375,310,228,204,400,0,3340,2055
2318,963,945,18,229,105,154,179,101,195,1,2117,964
2319,839,763,76,142,119,120,83,128,247,0,1724,839
2320,307,276,31,69,66,30,19,36,87,0,655,307
2321,1436,1306,130,244,204,206,142,219,421,54,2484,1490
2322,1395,1273,122,315,192,224,175,150,339,177,2884,1572
2323,707,684,23,147,108,91,86,81,194,17,1293,724
2324,571,552,19,118,88,74,70,65,156,0,1068,571
2325,505,488,17,81,51,58,60,66,189,0,1084,505
2326,695,608,87,125,79,102,81,89,219,19,1384,714
2327,528,423,105,108,60,94,71,62,133,3,1021,531
2328,3879,3557,322,1015,709,585,430,386,754,85,5422,3964
2329,278,220,58,56,35,51,36,29,71,0,609,278
2330,483,382,101,97,61,89,63,50,123,226,1154,709
2331,666,631,35,155,97,90,91,72,161,0,1400,666
2332,460,366,94,105,62,79,57,52,105,191,987,651
2333,369,292,77,74,46,68,48,38,95,20,847,389
2334,497,472,25,70,31,56,71,68,201,6,1163,503
2335,619,489,130,124,78,115,81,64,157,0,1421,619
2336,475,398,77,117,52,88,70,39,109,0,997,475
2337,791,761,30,142,96,111,123,84,235,4,1666,795
2338,874,857,17,208,96,140,162,91,177,97,1856,971
2339,1065,847,218,244,143,182,131,121,244,0,2097,1065
2340,578,534,44,108,73,100,85,59,153,98,1481,676
2341,989,929,60,247,170,134,144,95,199,0,2374,989
2342,436,429,7,78,53,66,63,54,122,840,911,1276
2343,1059,1043,16,289,230,136,122,100,182,0,2101,1059
2344,956,941,15,261,207,123,110,91,164,0,1654,956
2345,0,0,0,0,0,0,0,0,0,4,0,4
2346,760,665,95,137,86,112,89,97,239,0,1539,760
2347,796,781,15,189,87,128,148,83,161,4,1533,800
2348,365,355,10,24,22,51,46,62,160,11,671,376
2349,629,606,23,113,76,88,97,66,189,17,1251,646
2350,407,400,7,73,50,62,59,51,112,46,918,453
2351,1056,924,132,190,120,155,123,135,333,0,2041,1056
2352,653,586,67,147,140,64,39,76,187,100,1375,753
2353,790,763,27,127,79,91,93,104,296,0,1536,790
2354,1181,1171,10,373,229,177,155,105,142,5567,2385,6748
2355,1417,1350,67,263,193,220,187,171,383,0,3167,1417
2356,332,304,28,76,65,44,45,35,67,0,890,332
2357,785,755,30,124,76,91,78,114,302,0,1689,785
2358,402,382,20,56,25,45,57,55,164,0,993,402
2359,490,449,41,112,95,65,66,51,101,54,1246,544
2360,331,319,12,71,43,38,37,42,100,0,748,331
2361,370,352,18,58,23,47,52,53,137,0,900,370
2362,558,534,24,90,63,72,71,68,194,3,1133,561
2363,592,567,25,96,67,76,75,72,206,0,1311,592
2364,459,443,16,98,59,53,52,59,138,0,1035,459
2365,464,441,23,84,46,55,66,50,163,0,1114,464
2366,623,591,32,87,39,70,88,85,254,7,1571,630
2367,443,427,16,22,17,52,69,77,206,0,908,443
2368,645,622,23,138,83,75,72,83,194,7,1494,652
2369,939,903,36,149,91,108,93,136,362,0,2036,939
2370,727,704,23,127,101,93,81,91,234,1,1412,728
2371,315,298,17,48,34,43,41,41,108,0,701,315
2372,560,537,23,119,89,76,67,68,141,0,1153,560
2373,597,574,23,111,87,93,80,71,155,30,1155,627
2374,825,791,34,176,131,112,99,100,207,3,1708,828
2375,1778,1751,27,486,385,229,204,169,305,7,2865,1785
2376,263,252,11,43,30,34,34,32,90,0,541,263
2377,668,646,22,239,151,55,55,51,117,0,1214,668
2378,1274,1215,59,337,229,166,156,114,272,6,2113,1280
2379,355,338,17,94,64,46,43,32,76,36,819,391
2380,458,437,21,121,82,60,56,41,98,0,945,458
2381,318,302,16,60,43,49,53,42,71,295,717,613
2382,674,642,32,125,92,105,89,81,182,0,1421,674
2383,647,597,50,120,81,112,95,67,172,0,1561,647
2384,503,487,16,88,70,64,56,63,162,16,917,519
2385,1106,1064,42,281,170,174,147,114,220,21,2204,1127
2386,404,387,17,65,46,52,51,49,141,0,824,404
2387,237,229,8,38,24,27,28,31,89,0,518,237
2388,632,611,21,226,143,52,52,48,111,84,1256,716
2389,1484,1427,57,520,396,138,106,101,223,138,3017,1622
2390,294,234,60,67,40,50,36,33,68,26,715,320
2391,459,421,38,105,89,61,62,48,94,0,1183,459
2392,402,391,11,104,82,67,40,45,64,17,814,419
2393,349,340,9,90,71,58,35,39,56,41,792,390
2394,490,393,97,101,56,87,66,57,123,0,1066,490
2395,1172,1128,44,298,180,185,155,121,233,174,2259,1346
2396,330,312,18,50,36,45,43,43,113,0,685,330
2397,718,689,29,153,114,98,86,87,180,0,1294,718
2398,579,569,10,104,71,88,84,72,160,0,1343,579
2399,675,669,6,213,131,101,89,60,81,1951,1080,2626
2400,299,285,14,47,18,38,42,43,111,0,769,299
2401,1033,1024,9,327,201,155,136,92,122,658,2188,1691
2402,947,910,37,176,138,148,128,113,244,827,1599,1774
2403,1888,1825,63,675,426,155,156,143,333,9,3930,1897
2404,973,947,26,252,198,163,98,109,153,1,1746,974
2405,582,548,34,106,87,97,88,52,152,0,1312,582
2406,558,511,47,128,109,74,75,58,114,115,1364,673
2407,986,955,31,197,122,125,115,134,293,0,2204,986
2408,379,369,10,25,23,53,48,64,166,0,768,379
2409,659,633,26,104,64,76,65,95,255,0,1481,659
2410,460,438,22,73,28,58,65,66,170,0,1132,460
2411,528,511,17,106,66,67,61,72,156,1,1234,529
2412,1183,1122,61,274,173,159,162,127,288,0,2413,1183
2413,9,8,1,2,2,1,1,1,2,0,13,9
2414,501,463,38,4,12,59,69,111,246,3,1100,504
2415,0,0,0,0,0,0,0,0,0,0,0,0
2416,205,194,11,31,22,28,26,27,71,0,438,205
2417,221,209,12,34,24,30,28,29,76,0,491,221
2418,256,245,11,41,29,33,33,31,89,4,491,260
2419,722,678,44,180,124,98,105,69,146,0,1236,722
2420,486,457,29,121,83,66,71,47,98,0,843,486
2421,0,0,0,0,0,0,0,0,0,10,0,10
2422,1207,1107,100,316,221,182,134,120,234,0,1326,1207
2423,533,529,4,180,95,68,72,42,76,0,1171,533
2424,425,422,3,143,75,54,58,33,62,3,974,428
2425,562,558,4,189,100,71,76,44,82,182,1437,744
2426,398,394,4,126,77,60,52,35,48,0,875,398
2427,350,340,10,91,71,59,35,39,55,83,680,433
2428,399,388,11,103,81,67,40,45,63,0,779,399
2429,158,154,4,41,32,26,16,18,25,0,311,158
2430,165,161,4,43,34,28,17,19,24,0,236,165
2431,254,247,7,66,52,42,26,28,40,0,497,254
2432,525,497,28,130,106,71,65,52,101,30,1228,555
2433,127,116,11,29,25,17,17,13,26,0,318,127
2434,313,301,12,110,84,29,22,21,47,0,642,313
2435,148,142,6,52,40,14,11,10,21,0,278,148
2436,130,119,11,30,25,17,17,14,27,16,256,146
2437,94,74,20,19,12,17,12,10,24,0,248,94
2438,110,87,23,22,14,20,14,11,29,0,248,110
2439,107,85,22,21,13,20,14,11,28,0,276,107
2440,120,95,25,24,15,22,16,12,31,0,274,120
2441,529,475,54,119,114,51,32,62,151,0,1045,529
2442,429,390,39,73,61,61,42,65,127,0,876,429
2443,1237,1125,112,210,175,177,122,188,365,0,2308,1237
2444,355,323,32,60,50,51,35,54,105,152,632,507
2445,371,227,144,90,89,55,40,38,59,0,873,371
2446,0,0,0,0,0,0,0,0,0,0,0,0
2447,0,0,0,0,0,0,0,0,0,0,0,0
2448,754,385,369,210,120,97,87,92,148,0,2141,754
2449,0,0,0,0,0,0,0,0,0,0,0,0
2450,632,527,105,74,91,101,71,92,203,0,2121,632
2451,309,258,51,36,45,49,35,45,99,0,821,309
2452,1260,1051,209,148,182,201,142,183,404,0,2768,1260
2453,597,573,24,296,125,92,52,22,10,0,1405,597
2454,172,165,7,85,36,26,15,6,4,0,313,172
2455,5260,5183,77,2109,1348,820,497,294,192,8,19841,5268
2456,139,110,29,49,32,22,16,10,10,0,328,139
2457,862,683,179,307,201,138,98,59,59,10,2381,872
2458,201,198,3,81,51,31,19,11,8,4,473,205
2459,586,464,122,208,137,94,67,40,40,0,977,586
2460,763,752,11,306,195,119,72,43,28,0,1796,763
2461,471,464,7,189,121,73,45,26,17,6,586,477
2462,48,45,3,12,8,7,7,5,9,419,148,467
2463,239,225,14,60,41,32,35,23,48,0,892,239
2464,429,403,26,107,74,58,62,41,87,1,615,430
2465,1064,761,303,75,70,165,230,127,397,51,2654,1115
2466,533,433,100,48,41,81,68,88,207,0,1280,533
2467,1451,971,480,132,137,259,176,231,516,0,4207,1451
2468,833,495,338,221,240,118,81,65,108,0,2085,833
2469,1103,951,152,14,54,100,122,201,612,0,2385,1103
2470,888,642,246,47,47,132,123,192,347,0,2224,888
2471,3317,2238,1079,330,403,574,471,529,1010,15,8608,3332
2472,1500,1082,418,95,133,208,171,297,596,11,3421,1511
2473,2048,1496,552,203,252,274,241,348,730,32,5559,2080
2474,1565,1320,245,41,102,207,220,332,663,0,3053,1565
2475,4449,3331,1118,80,174,583,560,981,2071,88,11347,4537
2476,1594,1200,394,37,99,236,166,286,770,51,4014,1645
2477,1334,991,343,66,89,165,150,275,589,15,3163,1349
2478,4171,3205,966,89,202,525,445,899,2011,94,10857,4265
2479,1888,1427,461,63,109,243,216,361,896,11,4906,1899
2480,1146,956,190,27,37,147,139,241,555,0,2753,1146
2481,1017,654,363,93,109,143,131,171,370,13,2825,1030
2482,673,514,159,127,123,94,67,82,180,30,1614,703
2483,1154,905,249,86,91,201,151,199,426,6,2746,1160
2484,1672,1243,429,162,163,285,214,255,593,6,4789,1678
2485,1532,1435,97,148,116,230,201,264,573,4,2464,1536
2486,1669,1350,319,223,183,299,193,237,534,0,2686,1669
2487,620,549,71,17,35,75,64,135,294,0,1413,620
2488,378,325,53,6,15,44,51,86,176,0,841,378
2489,415,267,148,10,15,64,52,97,177,0,1356,415
2490,706,420,286,187,204,100,69,55,91,414,2263,1120
2491,676,416,260,114,110,142,82,80,148,30,2286,706
2492,1762,1271,491,111,156,244,201,349,701,0,4752,1762
2493,427,308,119,27,38,59,49,85,169,0,1079,427
2494,448,288,160,11,17,69,56,105,190,0,1469,448
2495,618,438,180,40,45,98,81,114,240,0,1541,618
2496,396,281,115,26,29,63,52,73,153,0,1077,396
2497,432,259,173,55,52,67,57,65,136,0,1367,432
2498,542,325,217,69,65,84,72,81,171,13,1820,555
2499,387,232,155,49,47,60,51,58,122,0,1145,387
2500,905,508,397,89,111,151,110,139,305,0,3137,905
2501,427,303,124,101,80,67,46,41,92,11,1119,438
2502,1222,867,355,289,230,192,132,118,261,0,3165,1222
2503,888,769,119,138,129,131,100,127,263,0,1937,888
2504,1087,941,146,169,158,160,123,156,321,11,2370,1098
2505,466,399,67,24,37,54,54,86,211,0,1124,466
2506,476,407,69,25,37,55,55,87,217,0,1042,476
2507,563,362,201,51,60,79,73,95,205,13,2086,576
2508,982,709,273,62,87,136,112,195,390,0,1929,982
2509,534,262,272,53,68,106,67,82,158,266,2034,800
2510,347,304,43,10,15,38,49,65,170,0,863,347
2511,2484,1792,692,156,220,344,284,492,988,0,8191,2484
2512,360,317,43,20,32,41,40,64,163,0,765,360
2513,331,283,48,17,26,38,38,61,151,4,703,335
2514,501,429,72,26,39,58,58,92,228,0,1120,501
2515,1414,1251,163,39,79,171,146,308,671,0,3414,1414
2516,753,657,96,179,221,58,58,72,165,0,2160,753
2517,257,225,32,17,17,34,36,53,100,0,575,257
2518,750,647,103,68,84,81,127,102,288,0,1701,750
2519,575,465,110,77,63,103,67,82,183,4,1620,579
2520,987,733,254,49,66,122,111,204,435,21,2449,1008
2521,1294,988,306,244,237,181,128,158,346,13,3429,1307
2522,769,720,49,74,58,115,101,132,289,2,1289,771
2523,744,430,314,207,191,114,67,61,104,0,2448,744
2524,330,288,42,22,21,43,46,68,130,0,661,330
2525,2894,2524,370,688,850,221,222,277,636,0,6577,2894
2526,830,724,106,197,244,63,64,80,182,11,1600,841
2527,305,266,39,73,90,23,23,29,67,0,652,305
2528,384,332,52,42,52,36,45,63,146,13,994,397
2529,291,252,39,31,39,27,34,48,112,19,768,310
2530,648,561,87,70,87,61,76,106,248,0,1476,648
2531,592,510,82,54,67,64,101,80,226,26,1304,618
2532,502,383,119,94,92,70,50,61,135,0,1010,502
2533,657,475,182,35,35,98,91,142,256,0,1450,657
2534,1768,1434,334,232,236,295,209,242,554,34,5772,1802
2535,738,572,166,112,98,122,82,104,220,0,1233,738
2536,330,268,62,43,44,55,39,45,104,0,521,330
2537,1955,1586,369,257,261,327,231,267,612,0,4250,1955
2538,227,161,66,15,17,36,30,42,87,0,673,227
2539,672,477,195,44,49,107,88,124,260,0,1908,672
2540,288,185,103,7,11,44,36,68,122,17,907,305
2541,735,632,103,12,28,85,98,168,344,0,1605,735
2542,2056,1395,661,198,256,301,266,316,719,39,5749,2095
2543,1399,1135,264,184,186,234,166,191,438,0,3707,1399
2544,338,262,76,52,45,56,37,47,101,9,884,347
2545,404,313,91,62,53,67,45,57,120,30,1008,434
2546,623,303,320,77,67,121,70,91,197,0,1981,623
2547,210,102,108,26,22,41,24,31,66,0,707,210
2548,438,213,225,54,47,85,49,64,139,92,1342,530
2549,496,241,255,61,53,96,56,72,158,0,1702,496
2550,390,290,100,38,38,66,50,60,138,0,1118,390
2551,285,191,94,26,27,51,35,45,101,6,975,291
2552,414,277,137,38,39,74,50,66,147,0,1333,414
2553,321,215,106,29,30,57,39,51,115,47,1012,368
2554,387,219,168,21,24,81,59,69,133,0,1375,387
2555,281,159,122,15,17,59,43,50,97,0,1008,281
2556,466,264,202,25,28,97,71,83,162,0,1677,466
2557,624,488,136,118,104,113,73,72,144,0,1692,624
2558,404,316,88,76,68,73,47,47,93,0,920,404
2559,618,483,135,117,103,112,72,71,143,11,1381,629
2560,508,397,111,96,85,92,59,58,118,36,1225,544
2561,342,164,178,87,122,41,28,24,40,0,1300,342
2562,717,343,374,182,255,86,59,50,85,13,2800,730
2563,1709,819,890,433,609,205,141,120,201,0,6165,1709
2564,435,251,184,121,112,66,39,36,61,0,1371,435
2565,710,410,300,197,182,108,64,58,101,0,2172,710
2566,1210,699,511,336,310,185,109,100,170,15,2960,1225
2567,1224,727,497,325,353,174,119,96,157,0,3810,1224
2568,610,362,248,162,176,87,59,48,78,0,1854,610
2569,469,279,190,125,135,67,46,37,59,13,1464,482
2570,461,284,177,78,75,97,56,54,101,0,1459,461
2571,479,295,184,81,78,101,58,56,105,13,1435,492
2572,633,390,243,107,103,133,77,75,138,0,1965,633
2573,1243,1005,238,166,137,222,144,177,397,2,3137,1245
2574,1477,993,484,307,373,198,152,147,300,377,4412,1854
2575,807,542,265,168,204,108,83,81,163,47,2464,854
2576,496,333,163,103,125,67,51,50,100,17,1449,513
2577,978,657,321,203,247,131,101,98,198,6,2846,984
2578,976,693,283,231,184,153,106,94,208,24,2794,1000
2579,659,468,191,156,124,103,71,63,142,47,1629,706
2580,607,526,81,94,88,89,69,87,180,0,1237,607
2581,771,509,262,160,231,125,108,74,73,69,2483,840
2582,465,314,151,46,56,80,66,74,143,0,1133,465
2583,561,379,182,56,68,97,80,90,170,15,1608,576
2584,977,549,428,97,120,163,119,150,328,0,3166,977
2585,805,704,101,195,197,39,87,84,203,0,1683,805
2586,1537,1344,193,371,376,74,166,160,390,2,3338,1539
2587,642,580,62,98,101,85,62,83,213,0,1489,642
2588,715,646,69,110,112,95,68,92,238,4,1591,719
2589,304,148,156,37,33,59,34,44,97,0,1063,304
2590,312,152,160,38,33,61,35,46,99,0,1052,312
2591,381,291,90,72,70,53,38,47,101,6,1284,387
2592,5521,3643,1878,1148,1655,898,775,529,516,0,16609,5521
2593,247,175,72,16,18,39,32,46,96,0,733,247
2594,563,277,286,56,72,112,71,86,166,0,1911,563
2595,559,275,284,56,71,111,70,86,165,0,2006,559
2596,666,516,150,101,88,110,74,93,200,0,1835,666
2597,306,269,37,9,13,34,43,57,150,4,727,310
2598,309,271,38,9,13,34,43,58,152,0,758,309
2599,447,393,54,25,40,51,49,79,203,26,926,473
2600,540,317,223,55,65,96,60,76,188,0,1798,540
2601,909,534,375,92,109,162,102,128,316,4,2455,913
2602,275,162,113,28,33,49,31,39,95,0,923,275
2603,768,570,198,38,51,95,86,159,339,13,1720,781
2604,295,240,55,26,23,45,37,49,115,0,684,295
2605,392,318,74,35,30,60,50,65,152,19,915,411
2606,1423,981,442,96,111,185,129,236,666,0,3970,1423
2607,775,602,173,31,40,107,118,137,342,48,1713,823
2608,1882,1422,460,36,81,249,244,411,861,31,4609,1913
2609,1418,1138,280,11,49,204,167,302,685,31,3363,1449
2610,2912,2166,746,45,115,441,359,619,1333,34,7473,2946
2611,1278,863,415,15,33,220,133,307,570,0,3411,1278
2612,398,297,101,4,11,66,35,97,185,0,856,398
2613,1884,1559,325,88,96,323,236,375,766,23,4547,1907
2614,1846,1344,502,47,106,272,229,394,798,9,4359,1855
2615,246,184,62,7,13,38,36,53,99,88,558,334
2616,1199,931,268,13,38,139,171,300,538,14,2731,1213
2617,893,691,202,12,35,106,119,205,416,0,1902,893
2618,2638,2138,500,50,117,356,315,617,1183,31,6018,2669
2619,1602,1408,194,170,211,181,164,252,624,6,3339,1608
2620,1656,1299,357,28,74,216,185,374,779,253,3874,1909
2621,1452,1124,328,59,105,224,171,300,593,51,3913,1503
2622,605,469,136,62,62,81,78,103,219,0,1321,605
2623,224,173,51,23,23,30,29,38,81,6,508,230
2624,2733,2065,668,47,111,394,345,613,1223,0,7075,2733
2625,2027,1568,459,41,93,309,254,451,879,128,4825,2155
2626,1516,1212,304,67,85,238,155,330,641,11,3724,1527
2627,3071,2392,679,171,216,510,352,611,1211,37,6872,3108
2628,2675,1564,1111,186,245,474,261,506,1003,23,8310,2698
2629,534,404,130,9,19,92,65,125,224,20,1405,554
2630,975,636,339,18,37,147,139,221,413,0,2482,975
2631,421,303,118,9,14,62,61,100,175,0,1088,421
2632,3416,2590,826,160,197,523,364,793,1379,31,8349,3447
2633,1477,1172,305,13,46,157,219,351,691,31,3485,1508
2634,3275,2387,888,106,147,497,378,744,1403,26,8354,3301
2635,1474,1139,335,32,62,227,173,370,610,0,3781,1474
2636,993,743,250,33,52,86,82,133,607,0,2475,993
2637,719,557,162,29,52,111,85,149,293,216,3305,935
2638,4729,3260,1469,318,370,613,430,784,2214,0,14559,4729
2639,1250,1214,36,448,351,66,162,87,136,168,2024,1418
2640,491,415,76,55,84,74,57,92,129,412,902,903
2641,1260,1107,153,134,166,142,129,199,490,23,2539,1283
2642,703,518,185,36,47,112,83,142,283,6,1714,709
2643,754,549,205,19,43,111,93,161,327,0,1850,754
2644,373,319,54,13,28,59,48,76,149,0,787,373
2645,614,519,95,69,105,92,71,115,162,3,1236,617
2646,614,526,88,21,46,97,79,125,246,0,1369,614
2647,716,538,178,13,20,106,75,171,331,0,1620,716
2648,530,399,131,9,15,79,55,127,245,3,1171,533
2649,528,397,131,9,15,79,55,126,244,0,1364,528
2650,789,590,199,26,41,68,65,106,483,0,1471,789
2651,647,452,195,72,101,118,91,106,159,0,1414,647
2652,602,529,73,64,79,68,62,95,234,0,1452,602
2653,1673,1470,203,177,220,189,172,264,651,0,2652,1673
2654,2358,2072,286,250,311,266,242,372,917,23,3669,2381
2655,1029,648,381,198,398,119,100,90,124,0,3216,1029
2656,16593,10334,6259,2023,3606,1551,1410,2356,5647,0,55379,16593
2657,7434,4630,2804,906,1615,695,632,1056,2530,0,24281,7434
2658,792,593,199,21,41,122,117,172,319,0,1718,792
2659,1071,832,239,43,56,148,163,189,472,80,2217,1151
2660,408,285,123,46,64,74,57,67,100,0,1024,408
2661,562,420,142,19,29,49,46,75,344,0,1284,562
2662,844,670,174,7,26,90,125,200,396,14,2034,858
2663,724,544,180,13,21,108,76,173,333,54,1741,778
2664,801,622,179,8,25,93,114,201,360,0,1855,801
2665,249,193,56,3,10,30,33,57,116,0,570,249
2666,589,457,132,23,31,81,90,104,260,0,1369,589
2667,1076,833,243,43,78,166,127,223,439,0,2075,1076
2668,5136,4913,223,1727,1432,799,318,441,419,3,9270,5139
2669,3225,3085,140,1084,899,502,200,277,263,102,4860,3327
2670,579,428,151,33,39,100,71,117,219,85,1363,664
2671,475,351,124,27,32,82,58,96,180,14,1174,489
2672,548,424,124,56,57,73,71,93,198,26,1313,574
2673,560,434,126,58,58,75,72,95,202,57,1178,617
2674,507,393,114,52,52,68,65,86,184,17,1218,524
2675,619,486,133,10,27,81,69,140,292,0,1299,619
2676,600,419,181,67,94,109,85,98,147,0,1718,600
2677,923,581,342,178,357,106,90,81,111,0,2692,923
2678,702,491,211,78,110,128,99,115,172,0,1727,702
2679,1645,1290,355,385,543,116,116,168,317,54,4208,1699
2680,571,448,123,134,188,40,40,58,111,0,1411,571
2681,548,469,79,18,41,87,70,112,220,6,1240,554
2682,306,200,106,6,12,46,44,69,129,236,742,542
2683,773,579,194,21,40,119,114,168,311,3,1984,776
2684,738,552,186,20,38,113,109,160,298,0,1893,738
2685,467,366,101,109,154,33,33,48,90,31,1143,498
2686,502,379,123,9,18,87,61,117,210,26,1264,528
2687,127,105,22,6,6,22,16,25,52,0,254,127
2688,79,65,14,4,4,14,10,16,31,40,175,119
2689,1244,1030,214,58,64,214,156,247,505,142,2619,1386
2690,380,284,96,10,19,58,56,82,155,0,803,380
2691,287,215,72,8,15,44,42,62,116,6,648,293
2692,6776,5067,1709,226,352,587,558,908,4145,207,16291,6983
2693,593,460,133,6,19,69,84,149,266,14,1509,607
2694,674,521,153,9,26,80,90,155,314,26,1526,700
2695,433,315,118,11,25,64,54,92,187,51,925,484
2696,607,449,158,35,41,105,75,122,229,28,1657,635
2697,650,480,170,37,44,112,80,131,246,6,1714,656
2698,385,284,101,20,25,61,45,78,156,9,1080,394
2699,581,428,153,30,38,92,69,117,235,37,1639,618
2700,373,275,98,19,25,59,44,75,151,6,983,379
2701,904,700,204,93,93,121,116,154,327,0,1796,904
2702,1118,1040,78,177,227,83,98,141,392,0,1850,1118
2703,2441,2114,327,98,143,386,315,491,1008,63,5682,2504
2704,2271,1818,453,30,60,316,311,506,1048,21,5345,2292
2705,1192,984,208,22,36,140,115,305,574,13,2821,1205
2706,2173,1762,411,24,48,266,276,534,1025,56,5700,2229
2707,1944,1653,291,71,97,238,253,383,902,40,4035,1984
2708,1369,1147,222,25,50,197,193,280,624,23,3235,1392
2709,588,506,82,61,70,67,72,110,208,4,1414,592
2710,1485,1197,288,20,53,211,213,314,674,15,3588,1500
2711,6684,6681,3,241,447,1069,692,1287,2948,0,7876,6684
2712,1143,1011,132,56,58,107,156,271,495,2242,2696,3385
2713,583,488,95,97,158,81,77,62,108,0,1595,583
2714,177,148,29,30,48,24,23,19,33,0,528,177
2715,753,577,176,4,17,98,105,194,335,0,2002,753
2716,2162,1883,279,74,106,246,272,510,954,1318,5564,3480
2717,3699,3055,644,191,188,447,440,798,1635,0,8589,3699
2718,1617,1441,176,91,126,225,178,306,691,0,3641,1617
2719,495,389,106,35,43,61,71,98,187,0,1311,495
2720,1300,1072,228,276,276,104,124,183,337,0,3317,1300
2721,1218,910,308,12,33,127,177,319,550,15,3175,1233
2722,275,223,52,8,10,35,40,70,112,0,695,275
2723,718,593,125,4,15,88,116,174,321,0,1867,718
2724,1199,1100,99,139,166,103,118,157,516,0,2657,1199
2725,1995,1782,213,60,129,326,234,394,852,63,4580,2058
2726,1280,1006,274,90,111,157,185,253,484,0,3397,1280
2727,3710,3453,257,588,755,275,325,467,1300,56,6288,3766
2728,1531,1401,130,268,345,156,163,162,437,15,2767,1546
2729,5257,4809,448,921,1185,535,560,556,1500,0,10367,5257
2730,699,644,55,23,36,91,85,135,329,0,1272,699
2731,441,407,34,14,23,58,53,85,208,0,1061,441
2732,929,856,73,30,48,121,113,179,438,2,1702,931
2733,3099,2835,264,543,699,315,330,328,884,65,4885,3164
2734,1914,1756,158,222,265,165,189,251,822,0,3978,1914
2735,1452,1215,237,106,128,188,177,231,622,6,3163,1458
2736,574,488,86,21,29,70,75,113,266,0,1422,574
2737,406,374,32,13,21,53,49,78,192,2,753,408
2738,641,586,55,112,144,65,68,68,184,0,1224,641
2739,2413,1890,523,503,637,186,215,312,560,4,6267,2417
2740,286,232,54,8,10,36,41,73,118,0,735,286
2741,460,374,86,13,17,58,66,117,189,0,1206,460
2742,283,237,46,21,25,37,35,45,120,0,722,283
2743,520,435,85,38,46,67,63,83,223,0,1244,520
2744,686,574,112,50,61,89,84,109,293,25,1594,711
2745,1143,984,159,118,136,130,140,214,405,4,2152,1147
2746,794,667,127,62,59,77,84,168,344,52,1915,846
2747,2920,2451,469,228,219,282,309,616,1266,15,7089,2935
2748,1620,1486,134,188,225,139,160,213,695,0,2809,1620
2749,269,229,40,10,13,33,35,53,125,21,667,290
2750,837,712,125,30,42,102,109,165,389,0,2050,837
2751,857,718,139,16,31,123,121,175,391,15,1724,872
2752,346,300,46,14,20,55,45,70,142,13,995,359
2753,650,560,90,67,77,74,80,121,231,0,1453,650
2754,642,528,114,70,93,76,85,101,217,0,1673,642
2755,1879,1574,305,314,510,260,248,200,347,0,4291,1879
2756,743,582,161,155,196,57,66,96,173,33,1965,776
2757,1217,1001,216,132,176,144,162,192,411,15,2655,1232
2758,1266,1041,225,137,183,150,168,200,428,0,3043,1266
2759,3166,2652,514,529,859,438,418,337,585,0,5935,3166
2760,439,337,102,2,10,57,61,113,196,0,1195,439
2761,875,671,204,5,20,113,122,225,390,0,2294,875
2762,558,453,105,15,20,71,80,141,231,6,1485,564
2763,2995,2469,526,637,637,239,286,421,775,15,5740,3010
2764,610,503,107,130,130,49,58,86,157,0,1544,610
2765,836,670,166,68,92,121,85,158,312,0,2127,836
2766,2499,1730,769,54,108,349,302,579,1107,51,7353,2550
2767,3001,2105,896,85,119,446,339,677,1335,85,8193,3086
2768,382,246,136,2,11,46,58,92,173,0,1106,382
2769,2037,1483,554,75,111,328,280,423,820,48,5246,2085
2770,1318,1051,267,20,41,161,192,319,585,0,3128,1318
2771,15310,10085,5225,557,1095,1865,2321,3563,5909,365,44590,15675
2772,4023,2965,1058,29,99,553,535,1004,1803,19,9937,4042
2773,2835,2368,467,132,147,283,362,577,1334,0,5893,2835
2774,3243,2366,877,126,134,368,378,688,1549,0,9182,3243
2775,6547,5132,1415,331,483,1041,792,1322,2578,45,16050,6592
2776,2148,1710,438,94,137,238,238,435,1006,0,4639,2148
2777,1987,1450,537,11,65,267,310,467,867,56,5292,2043
2778,2793,2077,716,28,84,417,411,648,1205,11,6577,2804
2779,4067,2735,1332,51,122,619,568,986,1721,16,10466,4083
2780,1372,825,547,31,57,185,189,291,619,0,4105,1372
2781,1263,1006,257,55,81,140,140,256,591,0,3306,1263
2782,240,175,65,9,10,27,28,51,115,0,700,240
2783,547,329,218,12,23,74,75,116,247,0,1463,547
2784,487,293,194,11,20,66,67,103,220,19,1403,506
2785,1534,1221,313,67,98,170,170,311,718,0,2783,1534
2786,575,346,229,13,24,77,79,122,260,8,1507,583
2787,359,231,128,2,10,44,54,86,163,3,1032,362
2788,547,352,195,3,15,66,83,131,249,11,1594,558
2789,4997,4174,823,232,259,498,639,1016,2353,0,12021,4997
2790,1360,992,368,53,56,154,158,288,651,0,2945,1360
2791,3546,2587,959,137,147,402,413,752,1695,0,9696,3546
2792,1769,1325,444,33,88,304,275,434,635,51,5060,1820
2793,1527,1155,372,168,193,285,201,213,467,9,4418,1536
2794,1079,701,378,177,152,200,125,132,293,139,3139,1218
2795,1356,818,538,226,238,238,159,180,315,2,3499,1358
2796,456,317,139,29,37,70,58,96,166,0,1332,456
2797,1295,916,379,63,119,233,184,238,458,36,3185,1331
2798,338,206,132,9,22,59,46,61,141,6,1116,344
2799,1316,1160,156,109,137,232,180,240,418,32,2781,1348
2800,1318,718,600,37,74,214,192,314,487,23,4502,1341
2801,2002,1204,798,146,221,271,279,414,671,0,6626,2002
2802,3285,2197,1088,137,216,480,453,743,1256,0,10744,3285
2803,1475,1056,419,84,119,293,203,244,532,0,4399,1475
2804,1300,860,440,26,60,225,156,266,567,13,4026,1313
2805,2342,1549,793,47,108,405,281,479,1022,21,6063,2363
2806,630,487,143,134,162,95,70,65,104,17,1840,647
2807,3011,2181,830,118,216,531,467,570,1109,60,8712,3071
2808,1269,837,432,141,202,197,158,203,368,32,3523,1301
2809,197,130,67,22,31,31,25,31,57,0,619,197
2810,1635,872,763,48,120,302,226,318,621,9,5936,1644
2811,8097,4496,3601,220,377,1228,1006,1864,3402,141,25620,8238
2812,2054,1185,869,28,76,287,303,520,840,0,6479,2054
2813,1434,828,606,20,53,200,211,363,587,6,4236,1440
2814,5925,4439,1486,111,295,1020,923,1452,2124,170,15944,6095
2815,227,170,57,4,11,39,35,56,82,0,606,227
2816,372,196,176,14,34,66,49,67,142,4,1346,376
2817,956,560,396,40,67,143,135,206,365,6,2910,962
2818,220,145,75,24,35,34,27,35,65,0,732,220
2819,982,599,383,27,64,171,133,178,409,0,3084,982
2820,437,263,174,32,42,69,62,87,145,92,1343,529
2821,124,82,42,14,20,19,15,20,36,0,369,124
2822,833,501,332,61,92,113,116,172,279,0,2453,833
2823,2048,1200,848,85,144,306,290,442,781,0,7128,2048
2824,690,415,275,50,67,108,98,138,229,15,1426,705
2825,865,520,345,63,84,136,123,173,286,2,2620,867
2826,586,353,233,43,57,92,83,117,194,6,1749,592
2827,1122,611,511,31,63,182,163,268,415,2,3583,1124
2828,889,484,405,25,50,144,129,212,329,0,2782,889
2829,783,471,312,57,76,123,111,156,260,28,2183,811
2830,1559,1205,354,331,400,235,174,162,257,0,4136,1559
2831,720,416,304,10,27,101,106,182,294,13,2172,733
2832,908,631,277,59,74,139,115,190,331,21,2732,929
2833,535,377,158,69,69,98,62,80,157,83,1255,618
2834,1103,865,238,167,210,184,151,152,239,62,2721,1165
2835,2952,1730,1222,123,208,441,418,637,1125,0,9909,2952
2836,449,270,179,33,43,70,64,90,149,0,1334,449
2837,4410,2609,1801,1110,1707,328,177,407,681,0,13059,4410
2838,1130,668,462,284,437,84,45,104,176,6,3250,1136
2839,1019,588,431,14,38,142,150,258,417,0,3491,1019
2840,590,389,201,66,94,92,74,94,170,62,1847,652
2841,206,132,74,40,47,37,20,22,40,0,614,206
2842,532,341,191,102,123,95,52,57,103,4,1733,536
2843,600,340,260,62,80,123,77,99,159,0,2023,600
2844,1240,874,366,159,161,227,144,185,364,19,3041,1259
2845,463,327,136,59,60,85,54,69,136,207,1125,670
2846,365,257,108,47,47,67,42,54,108,58,985,423
2847,579,432,147,44,54,92,78,114,197,34,1542,613
2848,507,378,129,38,47,81,69,100,172,9,1373,516
2849,844,630,214,64,78,135,114,167,286,87,2433,931
2850,725,541,184,55,67,116,98,143,246,0,2159,725
2851,5237,3866,1371,655,790,679,578,933,1602,0,13913,5237
2852,230,165,65,13,18,46,32,38,83,0,657,230
2853,536,372,164,35,44,82,68,112,195,0,1534,536
2854,1186,824,362,76,97,182,150,249,432,0,3210,1186
2855,470,271,199,36,50,94,68,74,148,0,1485,470
2856,376,217,159,29,40,75,54,59,119,0,1155,376
2857,1000,612,388,166,274,159,107,98,196,62,3195,1062
2858,612,375,237,102,167,97,66,60,120,0,2214,612
2859,365,223,142,61,100,58,39,36,71,0,1080,365
2860,930,627,303,164,195,186,111,101,173,0,2413,930
2861,504,390,114,107,129,76,56,52,84,2,1198,506
2862,2007,1551,456,426,515,302,223,208,333,0,4422,2007
2863,441,232,209,16,40,78,58,79,170,6,1438,447
2864,938,510,428,137,205,151,132,116,197,0,3321,938
2865,682,450,232,76,108,106,85,109,198,0,2113,682
2866,390,238,152,11,25,68,53,71,162,0,1188,390
2867,657,463,194,84,85,120,76,98,194,0,1818,657
2868,1743,1021,722,73,123,260,247,376,664,2,5402,1745
2869,400,227,173,41,53,82,52,66,106,23,1391,423
2870,1637,928,709,169,219,336,211,271,431,0,5107,1637
2871,404,259,145,78,93,72,39,43,79,0,1289,404
2872,1649,1058,591,317,380,295,160,177,320,9,4669,1658
2873,451,336,115,34,42,72,61,89,153,0,1272,451
2874,1656,1223,433,207,250,215,183,295,506,2,5159,1658
2875,569,446,123,86,108,95,78,78,124,0,1486,569
2876,1060,611,449,81,112,211,153,168,335,0,3932,1060
2877,666,439,227,74,106,104,83,106,193,0,1837,666
2878,492,259,233,18,45,87,65,88,189,0,1614,492
2879,13,8,5,1,1,2,2,3,4,68,35,81
2880,1237,744,493,90,136,168,173,256,414,0,3866,1237
2881,2392,1439,953,174,264,324,334,494,802,6,7145,2398
2882,1378,829,549,100,152,187,192,285,462,181,3682,1559
2883,1421,855,566,103,157,193,198,294,476,4,4146,1425
2884,826,552,274,35,54,121,114,187,315,15,2604,841
2885,461,308,153,19,30,67,64,104,177,0,1468,461
2886,645,431,214,27,42,94,89,146,247,0,1911,645
2887,548,367,181,23,36,80,76,124,209,0,1584,548
2888,613,410,203,26,40,89,85,139,234,4,1590,617
2889,789,528,261,33,52,115,109,178,302,6,2098,795
2890,1478,988,490,62,97,216,204,334,565,23,4629,1501
2891,2016,1348,668,84,132,294,278,456,772,0,3662,2016
2892,869,581,288,36,57,127,120,197,332,4,2789,873
2893,3525,2358,1167,147,232,515,486,797,1348,26,10168,3551
2894,4498,3008,1490,188,296,657,621,1017,1719,58,14734,4556
2895,780,522,258,33,51,114,108,176,298,11,2641,791
2896,2968,1616,1352,83,167,482,431,708,1097,17,10091,2985
2897,62,46,16,1,3,11,10,15,22,0,173,62
2898,4515,3979,536,373,471,797,617,822,1435,0,13333,4515
2899,4050,2693,1357,135,215,635,635,803,1627,43,12104,4093
2900,1170,873,297,30,62,201,151,269,457,25,3256,1195
2901,1223,948,275,24,58,200,180,264,497,18,2959,1241
2902,1131,865,266,20,46,167,187,242,469,50,3446,1181
2903,1434,932,502,33,65,238,233,293,572,30,4684,1464
2904,3067,2130,937,49,103,461,484,701,1269,30,7923,3097
2905,1400,1035,365,165,157,253,180,252,393,753,3128,2153
2906,276,202,74,17,9,49,41,62,98,0,804,276
2907,794,632,162,16,39,133,117,174,315,0,2069,794
2908,2378,1858,520,42,95,379,366,526,970,58,6584,2436
2909,1783,1364,419,107,128,338,233,355,622,15,4506,1798
2910,792,601,191,14,33,120,119,184,322,55,2151,847
2911,616,427,189,174,223,54,38,51,76,20,1772,636
2912,877,570,307,40,49,175,143,164,306,0,2300,877
2913,322,203,119,7,14,53,42,78,128,28,1144,350
2914,1622,1046,576,23,53,265,230,385,666,38,5217,1660
2915,1285,925,360,22,41,195,194,303,530,0,3129,1285
2916,1389,1062,327,39,51,246,231,306,516,0,3316,1389
2917,273,197,76,13,20,51,32,54,103,118,543,391
2918,1931,1758,173,69,97,281,257,479,748,10,3648,1941
2919,1919,1464,455,54,69,280,241,441,834,30,4673,1949
2920,1639,1196,443,31,70,248,252,355,683,30,4165,1669
2921,1974,1136,838,26,61,291,305,475,816,18,5608,1992
2922,1674,1304,370,33,72,266,217,393,693,0,4113,1674
2923,1220,934,286,88,91,193,179,247,422,13,2701,1233
2924,813,539,274,112,107,156,118,113,207,25,2122,838
2925,844,612,232,40,50,154,134,156,310,0,1915,844
2926,346,218,128,7,15,57,45,84,138,18,1194,364
2927,442,284,158,6,21,72,59,99,185,0,1514,442
2928,1952,1353,599,551,706,173,120,162,240,3,5563,1955
2929,741,587,154,319,273,53,36,23,37,8,1376,749
2930,1252,992,260,540,461,90,60,38,63,271,2356,1523
2931,378,291,87,68,56,76,57,46,75,0,913,378
2932,426,344,82,8,19,69,65,96,169,0,909,426
2933,415,319,96,74,61,83,62,51,84,0,959,415
2934,405,312,93,72,60,81,61,50,81,0,1045,405
2935,353,234,119,48,46,68,51,49,91,0,832,353
2936,321,229,92,9,17,54,38,67,136,10,782,331
2937,316,225,91,9,17,53,37,66,134,20,848,336
2938,505,360,145,14,27,85,59,105,215,0,1357,505
2939,463,374,89,9,21,75,71,104,183,0,1013,463
2940,323,261,62,6,15,52,49,73,128,0,722,323
2941,592,471,121,12,29,99,87,130,235,0,1536,592
2942,364,263,101,21,25,70,55,69,124,0,1081,364
2943,482,348,134,28,32,93,73,92,164,5,1414,487
2944,795,570,225,90,88,158,132,115,212,0,1701,795
2945,296,212,84,33,33,59,49,43,79,18,701,314
2946,577,418,159,27,34,105,92,107,212,90,1494,667
2947,341,219,122,5,16,55,46,76,143,40,1210,381
2948,384,247,137,5,18,62,51,86,162,40,1411,424
2949,829,598,231,40,61,156,97,165,310,98,2045,927
2950,650,469,181,31,48,122,76,130,243,38,1445,688
2951,288,172,116,7,12,47,41,72,109,13,856,301
2952,509,304,205,13,22,84,73,128,189,0,1671,509
2953,236,141,95,6,10,39,34,59,88,13,859,249
2954,552,330,222,14,24,91,79,138,206,30,1912,582
2955,579,418,161,34,39,111,88,111,196,0,1632,579
2956,1363,1193,170,315,255,176,156,144,317,78,2694,1441
2957,332,209,123,7,14,55,43,81,132,33,1138,365
2958,253,163,90,3,12,41,34,57,106,8,737,261
2959,849,676,173,17,42,142,125,187,336,5,2044,854
2960,14,10,4,2,2,2,2,2,4,0,16,14
2961,378,219,159,60,106,39,47,46,80,0,1072,378
2962,1789,1022,767,28,68,304,310,403,676,26,5492,1815
2963,737,345,392,48,85,109,126,175,194,9542,2228,10279
2964,7521,4705,2816,436,940,1199,1243,1623,2080,0,21641,7521
2965,1201,827,374,30,106,197,184,248,436,0,3520,1201
2966,1,0,1,0,0,0,0,0,1,0,3,1
2967,758,548,210,84,145,114,104,135,176,0,2214,758
2968,1183,832,351,29,97,188,171,289,409,0,3040,1183
2969,2062,1647,415,53,122,340,311,484,752,0,4867,2062
2970,9303,7518,1785,411,777,1851,1075,2108,3081,26,18377,9329
2971,1253,942,311,15,50,184,204,313,487,0,3025,1253
2972,3440,2791,649,184,279,576,555,670,1176,443,8656,3883
2973,427,265,162,6,19,74,78,88,162,0,1192,427
2974,1351,876,475,101,156,275,218,221,380,195,3696,1546
2975,794,595,199,13,36,119,128,188,310,0,1787,794
2976,608,328,280,14,36,92,94,146,226,0,1829,608
2977,2526,1894,632,116,215,357,414,530,894,52,6869,2578
2978,4894,3627,1267,95,240,718,679,1048,2114,325,12034,5219
2979,6488,4207,2281,473,775,910,1009,1189,2132,65,19214,6553
2980,1797,1167,630,121,182,327,295,332,540,872,5170,2669
2981,1630,1114,516,176,208,292,250,281,423,260,5129,1890
2982,1168,731,437,115,143,200,169,235,306,65,3475,1233
2983,2038,1341,697,96,146,358,320,394,724,208,5776,2246
2984,1618,992,626,63,89,248,249,382,587,78,4544,1696
2985,1183,657,526,20,46,190,201,274,452,0,3376,1183
2986,1657,1197,460,95,133,269,296,329,535,0,4946,1657
2987,2540,2118,422,106,181,459,324,587,883,0,4649,2540
2988,1566,1258,308,19,81,237,235,424,570,78,3733,1644
2989,6451,5187,1264,282,579,805,811,1388,2586,169,15671,6620
2990,1034,672,362,16,67,168,162,254,367,0,2787,1034
2991,1917,1229,688,34,112,307,304,442,718,78,5178,1995
2992,461,378,83,14,34,70,69,97,177,26,1044,487
2993,2324,1644,680,99,198,438,302,477,810,0,5518,2324
2994,1505,1292,213,42,89,266,192,324,592,39,4138,1544
2995,4374,2685,1689,139,333,715,669,934,1584,52,12452,4426
2996,1496,1100,396,86,168,253,205,304,480,0,3654,1496
2997,886,646,240,30,60,152,113,216,315,169,2609,1055
2998,938,582,356,13,42,162,171,194,356,78,2879,1016
2999,1106,641,465,176,311,114,138,136,231,0,3482,1106
3000,485,317,168,17,39,79,78,112,160,0,1405,485
3001,971,635,336,35,77,159,156,224,320,13,2893,984
3002,393,257,136,14,31,64,63,91,130,0,968,393
3003,666,454,212,45,93,104,97,132,195,0,1915,666
3004,654,428,226,24,52,107,105,151,215,0,2064,654
3005,0,0,0,0,0,0,0,0,0,0,0,0
3006,10634,6896,3738,775,1271,1492,1654,1948,3494,0,35306,10634
3007,529,346,183,19,42,87,85,122,174,0,1453,529
3008,642,437,205,43,90,100,93,128,188,0,2126,642
3009,694,473,221,47,97,109,101,138,202,0,2340,694
3010,454,297,157,16,36,74,73,105,150,0,1453,454
3011,434,296,138,29,61,68,63,86,127,0,1298,434
3012,271,184,87,34,46,40,39,44,68,52,795,323
3013,33,22,11,4,6,5,5,5,8,0,69,33
3014,399,271,128,50,67,58,58,65,101,0,1016,399
3015,861,527,334,52,61,161,138,168,281,52,2469,913
3016,505,293,212,80,142,52,63,62,106,0,1439,505
3017,792,538,254,99,134,115,115,128,201,0,1700,792
3018,449,258,191,12,25,86,83,93,150,65,1519,514
3019,174,127,47,6,12,30,22,42,62,0,458,174
3020,392,240,152,24,28,73,63,76,128,13,1011,405
3021,619,482,137,181,171,55,66,53,93,234,1604,853
3022,644,466,178,52,72,122,110,117,171,221,1632,865
3023,222,160,62,18,25,42,38,40,59,104,594,326
3024,330,257,73,97,91,29,35,28,50,13,780,343
3025,527,302,225,15,30,101,98,109,174,78,1778,605
3026,413,253,160,25,29,77,66,81,135,0,1158,413
3027,1388,1041,347,23,63,208,224,329,541,39,4166,1427
3028,1366,1024,342,23,62,205,221,324,531,0,3827,1366
3029,2546,1374,1172,59,149,385,392,612,949,0,7566,2546
3030,736,397,339,17,43,111,113,177,275,39,2160,775
3031,197,162,35,6,15,30,29,42,75,91,558,288
3032,276,226,50,8,20,42,41,58,107,0,689,276
3033,959,787,172,29,71,145,143,203,368,65,2246,1024
3034,429,310,119,48,82,65,59,77,98,0,948,429
3035,302,218,84,34,58,46,41,54,69,0,524,302
3036,259,187,72,29,50,39,35,46,60,0,625,259
3037,664,480,184,74,127,100,91,119,153,0,1054,664
3038,651,543,108,27,46,118,83,150,227,0,1877,651
3039,708,590,118,30,50,128,90,164,246,0,1742,708
3040,490,409,81,20,35,89,63,113,170,0,1031,490
3041,16,12,4,1,1,3,2,4,5,0,54,16
3042,0,0,0,0,0,0,0,0,0,0,0,0
3043,0,0,0,0,0,0,0,0,0,0,0,0
3044,0,0,0,0,0,0,0,0,0,0,0,0
3045,5,4,1,0,0,1,1,1,2,0,14,5
3046,1124,763,361,141,190,164,164,182,283,78,3243,1202
3047,292,205,87,10,20,43,46,54,119,0,859,292
3048,3404,2543,861,156,275,517,427,750,1279,72,8899,3476
3049,2299,1456,843,57,178,367,294,493,910,39,6476,2338
3050,1568,1224,344,35,88,281,198,363,603,116,3583,1684
3051,2687,2053,634,281,377,417,308,476,828,9,7544,2696
3052,2458,1792,666,85,176,400,321,538,938,39,5617,2497
3053,1176,895,281,17,61,203,165,248,482,4,2758,1180
3054,2308,1878,430,70,142,362,303,479,952,91,4964,2399
3055,39,39,0,7,7,5,4,7,9,128,40,167
3056,1769,1099,670,51,119,223,231,388,757,97,6032,1866
3057,3161,2431,730,228,352,540,430,668,943,0,9639,3161
3058,337,243,94,16,27,54,44,73,123,0,849,337
3059,1180,827,353,84,131,166,150,226,423,0,3404,1180
3060,798,505,293,24,62,123,115,190,284,2,2041,800
3061,518,414,104,24,38,76,66,113,201,12,1303,530
3062,671,536,135,31,49,99,86,147,259,0,1593,671
3063,576,458,118,89,103,79,64,89,152,0,1444,576
3064,347,276,71,53,62,48,38,53,93,290,656,637
3065,448,323,125,21,36,72,59,97,163,0,987,448
3066,486,350,136,23,39,78,64,106,176,32,1059,518
3067,1066,793,273,55,83,160,133,222,413,23,2721,1089
3068,826,604,222,96,134,112,91,122,271,14,2007,840
3069,953,758,195,147,170,131,106,147,252,271,1569,1224
3070,433,305,128,15,29,64,69,80,176,0,1392,433
3071,903,635,268,31,61,133,144,166,368,0,2425,903
3072,992,738,254,51,77,149,124,206,385,0,2950,992
3073,369,270,99,43,60,50,41,55,120,0,700,369
3074,854,599,255,61,95,120,109,164,305,0,2340,854
3075,1559,1093,466,111,173,219,198,299,559,90,3966,1649
3076,582,465,117,27,43,86,74,127,225,0,1367,582
3077,437,325,112,23,34,66,55,91,168,0,1134,437
3078,409,304,105,21,32,62,51,85,158,155,913,564
3079,411,306,105,21,32,62,51,85,160,0,1187,411
3080,523,325,198,15,35,66,68,115,224,0,1886,523
3081,648,403,245,19,43,82,85,142,277,0,2329,648
3082,553,425,128,40,61,94,75,117,166,11,2001,564
3083,1025,788,237,74,114,175,140,216,306,0,3247,1025
3084,1180,1056,124,42,85,166,162,274,451,150,1944,1330
3085,2729,2160,569,147,246,467,358,569,942,243,5915,2972
3086,876,663,213,24,53,154,130,220,295,25,1845,901
3087,2092,1674,418,115,211,378,335,428,625,51,4572,2143
3088,1936,1657,279,62,130,296,244,467,737,28,4459,1964
3089,2742,2231,511,39,141,444,351,627,1140,89,6234,2831
3090,1005,820,185,24,62,182,153,235,349,38,2402,1043
3091,1900,1687,213,34,96,336,306,405,723,2490,4751,4390
3092,722,605,117,17,34,127,106,184,254,159,1458,881
3093,5,3,2,0,0,1,1,1,2,0,14,5
3094,543,337,206,16,36,68,71,119,233,0,2454,543
3095,1,1,0,0,0,0,0,0,1,0,3,1
3096,1,1,0,0,0,0,0,0,1,0,3,1
3097,0,0,0,0,0,0,0,0,0,0,0,0
3098,0,0,0,0,0,0,0,0,0,0,0,0
3099,1,1,0,0,0,0,0,0,1,0,5,1
3100,0,0,0,0,0,0,0,0,0,0,0,0
3101,305,248,57,4,16,49,39,70,127,38,795,343
3102,316,257,59,5,16,51,40,72,132,0,857,316
3103,192,156,36,3,10,31,25,44,79,19,446,211
3104,1095,910,185,23,84,221,134,242,391,5,2491,1100
3105,2256,2122,134,48,141,414,314,511,828,25,4120,2281
3106,2243,1631,612,56,142,373,368,433,871,57,5625,2300
3107,2193,1804,389,45,116,393,399,457,783,149,4449,2342
3108,3469,2462,1007,124,266,549,445,704,1381,0,8762,3469
3109,1502,1108,394,67,103,233,192,317,590,0,3771,1502
3110,3017,2287,730,177,226,448,455,524,1187,72,7149,3089
3111,6243,4436,1807,586,999,867,750,1015,2026,82,15894,6325
3112,454,323,131,43,63,69,57,75,147,0,1218,454
3113,1507,1210,297,134,192,255,195,247,484,5,3417,1512
3114,543,378,165,62,93,88,68,79,153,12,1307,555
3115,1553,1254,299,122,169,261,220,270,511,0,3186,1553
3116,912,795,117,58,81,120,129,182,342,4285,2873,5197
3117,952,679,273,62,97,177,112,164,340,0,2627,952
3118,5264,4353,911,1112,2030,445,351,454,872,516,11525,5780
3119,1639,1277,362,75,128,275,203,328,630,0,4055,1639
3120,762,645,117,32,63,120,128,129,290,0,1953,762
3121,493,394,99,17,34,89,55,92,206,2,886,495
3122,1064,850,214,36,74,193,119,198,444,0,2306,1064
3123,1850,1455,395,163,202,217,195,323,750,20,4358,1870
3124,1766,1321,445,33,106,327,237,349,714,831,4655,2597
3125,2691,2161,530,239,343,455,348,441,865,146,6184,2837
3126,2852,2256,596,594,603,435,359,322,539,0,6700,2852
3127,480,346,134,18,33,76,60,102,191,0,1249,480
3128,8761,7363,1398,382,572,1018,865,1645,4279,22,19530,8783
3129,3248,2335,913,138,252,575,428,649,1206,0,7839,3248
3130,4003,3505,498,149,312,677,538,827,1500,0,8207,4003
3131,2579,2279,300,83,205,472,357,514,948,52,4769,2631
3132,3405,2279,1126,201,349,545,552,632,1126,30,9011,3435
3133,1612,1174,438,60,120,214,267,313,638,22,4871,1634
3134,1381,1120,261,41,61,212,154,360,553,122,3312,1503
3135,3936,3840,96,72,282,718,616,885,1363,0,6196,3936
3136,2107,1706,401,83,151,383,272,451,767,24,4605,2131
3137,5128,4224,904,155,323,961,611,1179,1899,69,11293,5197
3138,1366,1073,293,38,61,283,176,309,499,13,3101,1379
3139,3279,2602,677,55,191,587,462,775,1209,72,8087,3351
3140,871,695,176,77,98,157,118,144,277,15,2469,886
3141,1318,1023,295,175,336,188,95,199,325,0,3120,1318
3142,1374,1132,242,241,287,215,171,178,282,435,2916,1809
3143,1651,1316,335,179,230,296,221,289,436,96,3343,1747
3144,1695,1177,518,82,126,344,214,367,562,32,4047,1727
3145,1965,1323,642,59,137,374,271,450,674,66,5113,2031
3146,1274,997,277,250,372,178,149,148,177,32,3396,1306
3147,1327,772,555,189,249,206,202,179,302,40,4383,1367
3148,512,318,194,66,80,80,70,86,130,13,1846,525
3149,1507,865,642,144,164,262,233,255,449,53,4393,1560
3150,596,342,254,57,65,103,92,101,178,21,1722,617
3151,2625,2094,531,85,238,471,337,571,923,0,5744,2625
3152,3443,2549,894,74,217,706,463,807,1176,32,9001,3475
3153,2189,1594,595,53,133,380,278,527,818,19,5811,2208
3154,2092,1624,468,453,560,312,254,229,284,16,6101,2108
3155,984,694,290,93,113,180,131,172,295,29,2687,1013
3156,2364,1737,627,59,119,413,345,577,851,45,6582,2409
3157,2459,1911,548,159,190,446,295,481,888,40,6447,2499
3158,1205,557,648,63,82,235,160,251,414,289,4271,1494
3159,2314,1378,936,234,251,428,357,394,650,82,6649,2396
3160,748,510,238,31,48,135,107,151,276,69,2195,817
3161,1776,1476,300,67,129,278,278,355,669,40,3847,1816
3162,1712,1344,368,117,179,297,205,353,561,13,3913,1725
3163,1800,1419,381,45,114,304,248,416,673,24,4142,1824
3164,1591,1268,323,35,103,312,228,374,539,0,3702,1591
3165,2240,1774,466,62,139,409,299,551,780,194,5144,2434
3166,2675,1622,1053,228,339,526,400,452,730,56,7967,2731
3167,4393,3080,1313,391,492,837,605,833,1235,61,11750,4454
3168,2862,2328,534,158,226,536,316,612,1014,32,6283,2894
3169,2631,2186,445,118,188,501,342,575,907,141,5762,2772
3170,1361,1054,307,22,50,255,169,345,520,45,3182,1406
3171,1198,1053,145,306,339,158,126,115,154,533,2121,1731
3172,784,682,102,129,186,129,90,97,153,90,1710,874
3173,2846,2337,509,162,236,562,320,605,961,117,6139,2963
3174,1776,1596,180,190,256,342,240,283,465,0,3296,1776
3175,1689,1486,203,65,115,330,180,379,620,138,3683,1827
3176,2339,2057,282,86,192,432,369,479,781,82,4263,2421
3177,2193,1819,374,74,153,437,334,469,726,1570,4445,3763
3178,1617,1307,310,48,112,321,232,386,518,57,3467,1674
3179,833,599,234,100,146,126,105,131,225,18,2210,851
3180,1503,1176,327,43,106,306,203,344,501,0,3532,1503
3181,1227,1009,218,25,85,217,148,297,455,139,2911,1366
3182,1488,1150,338,31,107,277,215,351,507,171,3848,1659
3183,5524,4176,1348,298,547,990,807,1108,1774,75,13982,5599
3184,3513,3106,407,99,313,715,473,679,1234,188,6757,3701
3185,2229,1906,323,55,170,436,360,488,720,0,4253,2229
3186,2048,1685,363,53,145,403,296,485,666,6,4301,2054
3187,317,190,127,14,32,58,50,61,102,67,901,384
3188,810,553,257,19,54,135,104,184,314,33,2167,843
3189,2128,1740,388,123,251,368,295,478,613,275,4378,2403
3190,1845,1164,681,191,222,248,316,305,563,2,4535,1847
3191,222,168,54,5,15,40,30,49,83,0,443,222
3192,79,61,18,10,20,11,6,12,20,32,202,111
3193,1163,838,325,44,80,184,145,247,463,0,3018,1163
3194,268,219,49,15,32,46,37,60,78,0,611,268
3195,712,426,286,31,71,131,112,136,231,0,2342,712
3196,347,208,139,15,35,64,55,66,112,8,1217,355
3197,1146,782,364,26,76,191,147,260,446,0,3019,1146
3198,1072,771,301,128,188,162,136,169,289,0,3184,1072
3199,2038,1219,819,89,205,375,322,390,657,8,6590,2046
3200,1077,775,302,129,189,162,136,170,291,0,1983,1077
3201,324,233,91,39,57,49,41,51,87,6,977,330
3202,631,454,177,76,111,95,80,100,169,0,1889,631
3203,194,140,54,23,34,29,25,31,52,6,473,200
3204,323,220,103,7,21,54,41,73,127,0,875,323
3205,486,332,154,11,32,81,62,110,190,0,1060,486
3206,291,199,92,7,19,48,37,66,114,0,748,291
3207,361,246,115,8,24,60,46,82,141,0,992,361
3208,352,267,85,8,24,64,48,77,131,50,937,402
3209,719,545,174,15,49,131,98,158,268,0,1774,719
3210,717,543,174,15,49,131,98,157,267,0,1643,717
3211,172,133,39,23,44,25,12,26,42,5,456,177
3212,374,290,84,50,95,53,27,56,93,13,941,387
3213,517,401,116,69,132,74,37,78,127,13,1187,530
3214,521,408,113,102,152,73,61,61,72,178,1471,699
3215,975,763,212,191,285,136,114,113,136,0,1779,975
3216,2795,2170,625,605,749,417,340,307,377,0,5680,2795
3217,574,446,128,124,154,86,70,63,77,0,1579,574
3218,487,303,184,63,76,76,66,82,124,64,1595,551
3219,372,231,141,48,58,58,51,62,95,3,1103,375
3220,303,188,115,39,47,47,41,51,78,0,889,303
3221,650,404,246,84,101,101,88,109,167,470,1650,1120
3222,549,483,66,140,156,72,58,53,70,34,860,583
3223,418,295,123,40,48,76,56,73,125,11,1249,429
3224,771,544,227,73,89,141,103,135,230,16,2222,787
3225,403,350,53,66,96,66,46,50,79,11,827,414
3226,429,246,183,41,47,74,66,73,128,34,1200,463
3227,292,168,124,28,32,51,45,49,87,106,908,398
3228,634,442,192,72,109,103,80,92,178,0,1731,634
3229,432,311,121,16,30,69,54,92,171,0,1086,432
3230,535,466,69,34,48,71,76,107,199,0,1370,535
3231,471,410,61,30,42,62,67,94,176,0,1170,471
3232,256,223,33,16,23,34,36,51,96,10,623,266
3233,117,83,34,11,16,18,15,19,38,0,256,117
3234,598,425,173,57,83,91,75,99,193,17,1244,615
3235,425,302,123,40,59,64,53,70,139,0,1041,425
3236,664,472,192,63,92,101,83,110,215,0,1366,664
3237,350,250,100,23,36,65,41,60,125,0,1094,350
3238,481,343,138,31,49,90,57,83,171,0,1168,481
3239,783,558,225,51,80,146,92,135,279,0,1916,783
3240,942,731,211,108,152,156,118,126,282,15,2225,957
3241,511,397,114,59,83,85,64,68,152,0,1414,511
3242,595,462,133,68,96,98,75,80,178,2,1237,597
3243,375,310,65,79,145,32,25,32,62,0,991,375
3244,364,301,63,77,140,31,24,31,61,2,673,366
3245,306,244,62,10,21,55,34,57,129,0,634,306
3246,453,383,70,19,38,71,76,77,172,0,1029,453
3247,397,336,61,17,33,62,67,67,151,0,877,397
3248,354,300,54,15,29,56,60,60,134,0,847,354
3249,405,315,90,19,32,68,50,81,155,5,871,410
3250,423,295,128,48,73,69,53,62,118,335,1210,758
3251,2898,1976,922,118,187,522,415,585,1071,435,9583,3333
3252,143,98,45,3,9,24,18,32,57,0,289,143
3253,1696,0,1696,0,0,0,0,0,1696,379,3282,2075
3254,3917,2994,923,445,716,550,315,523,1368,166,10318,4083
3255,3061,2522,539,434,491,427,313,393,1003,348,6851,3409
3256,705,613,92,28,40,112,64,145,316,6,1594,711
3257,876,659,217,77,134,121,88,122,334,0,2008,876
3258,3013,2308,705,153,339,458,310,563,1190,54,7579,3067
3259,3138,2504,634,213,304,508,302,585,1226,58,7572,3196
3260,2221,1683,538,119,185,336,211,419,951,24,5385,2245
3261,1559,1327,232,97,118,241,141,277,685,13,3132,1572
3262,1905,1558,347,438,744,207,107,135,274,0,4811,1905
3263,991,804,187,25,46,136,110,221,453,0,2281,991
3264,963,742,221,96,192,129,76,150,320,0,2404,963
3265,2440,1960,480,147,254,400,232,379,1028,109,6351,2549
3266,1075,946,129,114,116,152,79,169,445,23,1604,1098
3267,1821,1503,318,58,97,292,170,317,887,132,4223,1953
3268,3065,2661,404,208,318,433,234,493,1379,81,6880,3146
3269,749,682,67,95,96,85,50,101,322,40,1678,789
3270,1452,1186,266,112,167,241,164,227,541,12,2996,1464
3271,2924,2250,674,136,180,326,352,608,1322,127,6810,3051
3272,208,182,26,3,7,48,14,43,93,0,529,208
3273,1132,977,155,69,107,238,139,206,373,12,2053,1144
3274,2420,2000,420,172,232,456,235,382,943,54,5061,2474
3275,1686,1335,351,99,155,260,196,313,663,33,3559,1719
3276,2805,2332,473,110,197,435,293,495,1275,13,5873,2818
3277,1305,1034,271,92,131,179,151,214,538,0,3027,1305
3278,3433,2863,570,415,475,365,312,467,1399,79,6738,3512
3279,880,614,266,14,26,68,136,189,447,106,2228,986
3280,2342,2024,318,198,269,312,252,370,941,0,5219,2342
3281,612,528,84,45,56,77,52,108,274,487,1187,1099
3282,2293,1931,362,80,149,287,248,446,1083,0,4758,2293
3283,2019,1742,277,326,330,223,174,240,726,107,3989,2126
3284,963,813,150,115,112,103,98,135,400,13,2285,976
3285,8148,4491,3657,1225,1821,820,890,1024,2368,129,30944,8277
3286,2400,2173,227,270,346,276,192,334,982,63,4559,2463
3287,3263,2723,540,276,362,352,274,497,1502,0,7219,3263
3288,3247,2775,472,365,399,348,307,459,1369,472,6258,3719
3289,1622,1159,463,384,556,125,104,104,349,0,3777,1622
3290,304,0,304,0,0,0,0,0,304,148,563,452
3291,3998,3178,820,233,274,385,342,695,2069,26,9645,4024
3292,2832,2445,387,148,205,316,265,506,1392,20,5670,2852
3293,1652,1295,357,185,181,154,163,258,711,0,2874,1652
3294,1335,1186,149,129,190,152,144,178,542,0,2767,1335
3295,2497,1995,502,182,218,274,231,426,1166,0,5731,2497
3296,0,0,0,0,0,0,0,0,0,0,0,0
3297,3907,3432,475,425,483,396,440,610,1553,11,8332,3918
3298,2726,2190,536,122,133,313,295,452,1411,0,6642,2726
3299,2356,2040,316,321,301,300,216,327,891,0,4779,2356
3300,2139,0,2139,0,0,0,0,0,2139,9,4199,2148
3301,2986,2420,566,130,176,346,280,503,1551,26,6414,3012
3302,2070,0,2070,0,0,0,0,0,2070,0,4845,2070
3303,5286,5059,227,586,744,737,512,725,1982,26,8515,5312
3304,249,187,62,22,38,34,25,35,95,0,499,249
3305,795,608,187,90,145,112,64,106,278,0,2474,795
3306,520,397,123,59,95,73,42,69,182,0,1109,520
3307,1289,985,304,146,236,181,104,172,450,20,3324,1309
3308,686,528,158,68,136,92,54,107,229,2,1816,688
3309,2913,2383,530,669,1137,317,163,206,421,192,5640,3105
3310,853,726,127,53,65,132,77,151,375,0,2040,853
3311,1454,1280,174,154,157,206,107,229,601,0,2638,1454
3312,6469,5889,580,824,833,732,435,868,2777,0,14559,6469
3313,1120,1020,100,143,144,127,75,150,481,67,1960,1187
3314,1474,1342,132,188,190,167,99,198,632,12,2831,1486
3315,206,188,18,26,27,23,14,28,88,0,515,206
3316,239,218,21,30,31,27,16,32,103,59,489,298
3317,363,300,63,12,19,58,34,63,177,15,832,378
3318,670,579,91,57,77,89,72,106,269,0,1477,670
3319,853,737,116,72,98,114,92,135,342,42,1678,895
3320,2391,2062,329,174,219,300,204,421,1073,911,4964,3302
3321,1525,841,684,229,341,153,167,192,443,79,6004,1604
3322,2399,2026,373,287,279,257,244,335,997,4,6407,2403
3323,747,676,71,84,108,86,60,104,305,0,1909,747
3324,607,550,57,68,87,70,49,84,249,0,1061,607
3325,194,167,27,10,14,22,18,35,95,0,384,194
3326,289,249,40,15,21,32,27,52,142,0,689,289
3327,412,344,68,35,46,44,35,63,189,0,757,412
3328,1618,1268,350,182,177,151,159,253,696,0,3997,1618
3329,79,62,17,9,9,7,8,12,34,0,163,79
3330,2010,1735,275,324,328,222,173,239,724,579,3019,2589
3331,437,377,60,71,71,48,38,52,157,6,649,443
3332,552,466,86,66,64,59,56,77,230,0,1187,552
