TAZ,HHLESSGQ,HHCHILDNO,HHCHILDYES,HHINC1,HHINC2,HHINC3,HHINC4,HHINC5,HHINC6,HHGQYES,HHGQNO,HHBASE
1,715,698,17,73,73,92,82,106,289,4,1164,719
2,258,96,162,49,27,42,21,43,76,22,771,280
3,2362,2218,144,1061,717,181,180,132,91,20,4073,2382
4,2339,2167,172,983,869,182,114,108,83,0,4302,2339
5,2995,2946,49,1327,1024,209,189,134,112,7,4713,3002
6,1327,1280,47,568,453,108,83,69,46,20,2346,1347
7,533,474,59,257,165,49,18,26,18,0,1039,533
8,699,684,15,327,248,39,36,30,19,0,1112,699
9,8841,7133,1708,1446,707,1113,980,1380,3215,0,28449,8841
10,4061,3990,71,1478,1867,234,210,146,126,107,6412,4168
11,859,764,95,415,266,79,29,43,27,0,1673,859
12,636,624,12,308,224,33,37,19,15,0,930,636
13,682,669,13,330,241,35,40,20,16,0,997,682
14,1033,1014,19,556,308,62,44,39,24,342,1465,1375
15,508,499,9,273,151,30,22,19,13,0,721,508
16,1250,1227,23,673,372,75,53,47,30,281,1774,1531
17,1417,1391,26,762,422,85,61,53,34,0,2009,1417
18,976,950,26,605,215,53,41,41,21,353,1547,1329
19,1017,990,27,631,224,56,43,43,20,202,1611,1219
20,737,724,13,378,233,35,48,26,17,118,1218,855
21,1757,1720,37,604,781,127,104,76,65,191,2773,1948
22,1271,1244,27,437,565,92,75,55,47,55,2007,1326
23,5128,5039,89,1866,2357,295,265,185,160,64,8098,5192
24,913,895,18,442,322,47,53,27,22,461,1335,1374
25,1467,1439,28,710,517,76,85,43,36,0,2145,1467
26,1770,1715,55,843,647,105,74,64,37,77,2876,1847
27,1109,1074,35,528,405,66,46,40,24,0,1802,1109
28,1761,1706,55,839,643,104,73,63,39,664,2862,2425
29,1101,1072,29,533,359,86,43,49,31,15,1808,1116
30,1466,1428,38,710,478,115,57,66,40,126,2409,1592
31,528,514,14,256,172,41,20,24,15,531,867,1059
32,668,644,24,286,228,54,42,35,23,0,1180,668
33,1196,1154,42,512,408,97,75,62,42,0,2115,1196
34,634,629,5,265,231,55,34,32,17,8,970,642
35,675,590,85,310,223,48,42,33,19,0,1261,675
36,784,686,98,360,259,56,49,39,21,1,1466,785
37,849,743,106,390,281,60,53,42,23,0,1586,849
38,569,506,63,275,176,53,19,28,18,0,1108,569
39,1025,911,114,495,318,95,35,51,31,0,1995,1025
40,2114,2059,55,1023,690,165,82,94,60,181,3473,2295
41,1071,1043,28,518,349,84,42,48,30,44,1759,1115
42,1796,1748,48,1114,395,98,75,76,38,2413,2846,4209
43,1162,1131,31,721,256,64,49,49,23,134,1840,1296
44,1154,1037,117,535,392,72,65,56,34,0,2185,1154
45,906,814,92,420,308,57,51,44,26,0,1716,906
46,870,782,88,403,296,55,49,42,25,0,1647,870
47,1113,1089,24,520,394,62,57,48,32,0,1770,1113
48,1163,1138,25,544,412,65,59,50,33,0,1850,1163
49,632,571,61,272,242,38,32,31,17,0,1189,632
50,1154,1043,111,496,443,69,59,56,31,3,2172,1157
51,1238,1118,120,532,475,74,64,60,33,11,2330,1249
52,1292,1272,20,591,463,82,72,55,29,28,2091,1320
53,1472,1449,23,673,528,93,82,63,33,0,2383,1472
54,813,800,13,372,292,51,45,35,18,4,1315,817
55,1031,998,33,468,373,59,63,41,27,0,1763,1031
56,457,442,15,207,165,26,28,18,13,3,782,460
57,853,826,27,387,308,49,52,34,23,0,1458,853
58,711,641,70,347,237,47,33,31,16,0,1415,711
59,956,862,94,466,318,63,44,41,24,0,1903,956
60,1435,1401,34,699,422,108,81,60,65,25,2197,1460
61,879,858,21,363,361,46,52,35,22,348,1247,1227
62,291,286,5,148,84,29,7,14,9,35,445,326
63,322,317,5,171,90,31,15,9,6,18,488,340
64,791,708,83,356,276,72,26,34,27,18,1637,809
65,555,549,6,313,137,35,30,26,14,472,888,1027
66,1079,1067,12,608,267,69,58,50,27,0,1728,1079
67,1981,1960,21,1117,491,126,106,93,48,72,3172,2053
68,1519,1505,14,499,668,132,87,71,62,80,2431,1599
69,2031,1988,43,698,903,147,121,88,74,306,3205,2337
70,1540,1510,30,739,536,97,69,55,44,51,2197,1591
71,1421,1393,28,682,495,90,64,50,40,62,2026,1483
72,1526,1489,37,631,626,80,91,60,38,515,2165,2041
73,593,579,14,285,175,49,28,33,23,10,916,603
74,1010,906,104,473,357,86,34,38,22,8,2131,1018
75,578,519,59,270,205,49,19,22,13,0,1219,578
76,3790,3728,62,1989,1012,270,237,171,111,95,6265,3885
77,2010,1977,33,1055,536,143,126,91,59,41,3321,2051
78,1167,1146,21,599,369,55,76,41,27,90,1928,1257
79,1382,1358,24,709,437,65,90,49,32,11,2284,1393
80,1440,1401,39,381,697,105,115,75,67,27,2279,1467
81,475,464,11,125,216,40,46,28,20,253,750,728
82,318,314,4,124,131,26,25,4,8,63,462,381
83,58,55,3,30,15,5,3,3,2,11,90,69
84,333,329,4,112,158,19,18,16,10,2,483,335
85,330,324,6,171,96,29,8,12,14,64,506,394
86,91,89,2,48,28,8,3,4,0,22,139,113
87,106,105,1,37,49,7,5,4,4,1,154,107
88,1354,1341,13,445,595,118,78,63,55,377,2167,1731
89,294,286,8,78,142,22,24,15,13,455,465,749
90,790,772,18,208,360,66,76,47,33,25,1247,815
91,902,882,20,237,411,76,87,54,37,15,1425,917
92,2244,2175,69,586,380,327,247,270,434,14,3604,2258
93,4038,3964,74,1505,1318,336,355,260,264,113,6377,4151
94,3382,3301,81,1063,735,385,378,361,460,22,5306,3404
95,2620,2546,74,761,523,333,299,271,433,4,4402,2624
96,709,692,17,286,230,56,57,39,41,0,1151,709
97,2534,2214,320,240,279,264,303,402,1046,99,5804,2633
98,1617,1403,214,159,169,177,181,269,662,19,3790,1636
99,1696,1471,225,167,203,173,220,248,685,0,3847,1696
100,68,59,9,11,14,6,7,6,24,0,137,68
101,295,239,56,25,40,28,36,52,114,0,725,295
102,773,672,101,79,87,92,92,126,297,0,1732,773
103,835,734,101,111,105,103,107,119,290,0,1736,835
104,367,323,44,49,46,45,47,52,128,0,764,367
105,384,338,46,51,48,47,49,55,134,115,799,499
106,532,468,64,71,67,66,68,76,184,0,1107,532
107,664,582,82,81,78,76,88,95,246,0,1411,664
108,685,601,84,84,80,78,91,98,254,23,1455,708
109,600,526,74,73,70,68,80,86,223,13,1275,613
110,790,693,97,96,92,90,105,113,294,0,1677,790
111,932,815,117,100,90,114,115,140,373,14,2030,946
112,974,852,122,104,94,119,120,147,390,28,2122,1002
113,884,773,111,94,85,108,109,133,355,0,1925,884
114,230,186,44,19,31,21,28,41,90,0,565,230
115,473,383,90,39,65,44,57,84,184,0,1164,473
116,647,560,87,83,76,76,92,91,229,0,1453,647
117,681,590,91,87,80,80,96,96,242,7,1529,688
118,992,859,133,127,117,116,141,139,352,7,2226,999
119,562,483,79,62,66,58,76,86,214,3,1284,565
120,858,738,120,95,101,89,115,132,326,0,1962,858
121,452,389,63,50,53,47,61,70,171,0,1033,452
122,471,405,66,52,56,49,63,72,179,0,1076,471
123,744,640,104,83,88,77,100,115,281,11,1702,755
124,743,642,101,72,76,83,95,116,301,3,1697,746
125,567,490,77,55,58,64,73,88,229,5,1296,572
126,497,429,68,48,51,56,64,77,201,2,1136,499
127,622,537,85,60,64,70,80,97,251,0,1422,622
128,566,489,77,61,61,62,65,94,223,0,1346,566
129,779,677,102,79,88,92,93,127,300,4,1746,783
130,566,492,74,58,64,67,67,92,218,0,1270,566
131,698,603,95,75,76,76,80,116,275,1,1662,699
132,469,410,59,44,52,49,56,74,194,10,1075,479
133,941,919,22,347,342,73,80,45,54,38,1429,979
134,876,681,195,103,78,75,122,125,373,6,2463,882
135,592,578,14,218,215,46,50,28,35,5,899,597
136,1234,1205,29,455,448,96,105,59,71,12,1874,1246
137,491,424,67,53,53,53,56,81,195,0,1168,491
138,1195,1175,20,534,442,68,67,42,42,101,1842,1296
139,1636,1608,28,731,605,93,91,58,58,1,2521,1637
140,1015,998,17,453,375,58,57,36,36,51,1564,1066
141,805,791,14,360,298,46,45,29,27,0,1240,805
142,195,179,16,65,60,14,27,15,14,0,387,195
143,975,896,79,325,300,71,134,73,72,0,1929,975
144,726,667,59,242,224,53,100,54,53,124,1436,850
145,814,748,66,271,251,60,112,61,59,54,1611,868
146,974,895,79,325,300,71,134,72,72,52,1927,1026
147,1038,963,75,245,362,123,110,87,111,66,1825,1104
148,768,712,56,181,268,91,81,64,83,0,1350,768
149,1165,1080,85,275,407,138,123,97,125,0,2049,1165
150,1863,1728,135,439,651,220,197,155,201,37,3275,1900
151,744,690,54,176,260,88,79,62,79,137,1308,881
152,838,777,61,198,293,99,89,70,89,86,1474,924
153,619,557,62,78,119,85,65,89,183,0,1207,619
154,546,492,54,69,105,75,58,78,161,123,1065,669
155,781,703,78,98,151,108,83,112,229,3,1525,784
156,377,340,37,47,73,52,40,54,111,0,736,377
157,948,854,94,119,183,131,100,136,279,25,1850,973
158,605,591,14,244,196,48,49,34,34,0,983,605
159,640,625,15,259,207,50,52,36,36,0,1039,640
160,921,900,21,372,298,72,75,51,53,0,1495,921
161,632,563,69,120,126,74,84,78,150,0,1288,632
162,727,671,56,289,203,69,63,48,55,36,1286,763
163,371,342,29,148,104,35,32,24,28,3,657,374
164,1501,1385,116,598,419,143,129,99,113,0,2656,1501
165,305,272,33,58,61,36,41,38,71,0,622,305
166,521,464,57,99,104,61,69,64,124,357,1062,878
167,258,230,28,49,51,30,34,32,62,0,527,258
168,509,454,55,97,101,60,68,63,120,0,1038,509
169,860,798,62,286,218,89,100,81,86,0,1494,860
170,866,803,63,288,219,90,101,81,87,0,1505,866
171,524,486,38,174,133,54,61,49,53,0,911,524
172,924,903,21,397,289,85,56,44,53,42,1391,966
173,1178,1152,26,507,369,108,71,57,66,0,1775,1178
174,1432,1432,0,598,621,64,81,32,36,178,1971,1610
175,635,635,0,265,275,28,36,14,17,15,874,650
176,552,537,15,216,217,32,49,19,19,0,846,552
177,944,919,25,370,371,54,83,32,34,0,1444,944
178,1333,1298,35,522,524,77,118,46,46,0,2040,1333
179,725,694,31,179,277,60,108,38,63,0,1387,725
180,575,550,25,142,220,48,86,30,49,205,1102,780
181,649,594,55,142,123,86,85,76,137,0,1241,649
182,970,888,82,213,184,129,127,114,203,0,1855,970
183,468,428,40,103,89,62,61,55,98,0,894,468
184,1338,1224,114,294,254,177,176,157,280,0,2559,1338
185,896,820,76,197,170,119,118,105,187,13,1714,909
186,500,491,9,187,179,37,52,20,25,10,772,510
187,1464,1437,27,548,524,109,153,58,72,199,2260,1663
188,1013,995,18,379,363,76,106,40,49,0,1564,1013
189,479,439,40,66,62,63,67,71,150,2,990,481
190,376,345,31,52,48,49,52,56,119,14,778,390
191,647,594,53,89,83,84,90,96,205,0,1337,647
192,510,490,20,106,124,52,79,54,95,3258,1039,3768
193,652,626,26,136,159,67,101,69,120,3,1328,655
194,1139,1094,45,237,278,117,177,121,209,21,2318,1160
195,845,811,34,176,206,87,131,89,156,11,1721,856
196,1317,1213,104,506,511,89,103,55,53,119,2379,1436
197,1493,1375,118,573,579,100,117,63,61,0,2696,1493
198,1968,1940,28,796,792,104,139,79,58,17,2859,1985
199,893,798,95,348,305,69,82,42,47,0,1678,893
200,1191,1064,127,464,406,92,110,56,63,0,2239,1191
201,639,571,68,249,218,49,59,30,34,15,1202,654
202,473,423,50,184,161,37,44,22,25,0,888,473
203,467,427,40,141,177,40,51,27,31,0,929,467
204,703,643,60,213,267,60,77,40,46,15,1399,718
205,1434,1312,122,434,544,123,157,82,94,97,2855,1531
206,851,819,32,205,345,77,97,49,78,75,1618,926
207,1258,1210,48,303,510,114,143,73,115,230,2393,1488
208,604,584,20,137,150,57,99,67,94,59,1181,663
209,679,657,22,154,168,64,111,76,106,103,1328,782
210,610,590,20,139,151,57,100,68,95,42,1192,652
211,772,747,25,175,191,72,127,86,121,281,1509,1053
212,730,685,45,110,186,94,80,91,169,10,1424,740
213,487,457,30,74,124,62,53,61,113,58,950,545
214,599,562,37,91,152,77,65,75,139,10,1168,609
215,881,827,54,133,224,113,96,110,205,21,1717,902
216,713,663,50,145,266,84,84,56,78,26,1383,739
217,984,915,69,200,367,116,116,77,108,0,1909,984
218,975,849,126,102,99,112,127,157,378,5,2114,980
219,1018,886,132,107,104,117,132,164,394,0,2206,1018
220,539,469,70,57,55,62,70,87,208,3,1169,542
221,501,436,65,53,51,57,65,81,194,1,1086,502
222,572,498,74,60,58,66,74,92,222,1,1239,573
223,615,534,81,60,64,67,69,102,253,8,1442,623
224,799,693,106,78,84,87,90,133,327,0,1873,799
225,568,493,75,56,59,62,64,94,233,80,1332,648
226,541,503,38,110,202,64,64,42,59,94,1049,635
227,375,349,26,76,140,44,44,29,42,2,727,377
228,1562,1501,61,280,455,209,175,185,258,0,2765,1562
229,956,919,37,171,279,128,107,113,158,0,1692,956
230,1652,1596,56,222,396,275,152,216,391,0,2774,1652
231,426,411,15,57,102,71,39,56,101,0,716,426
232,652,630,22,88,156,108,60,85,155,0,1095,652
233,0,0,0,0,0,0,0,0,0,91,0,91
234,77,60,17,9,7,7,11,11,32,7,217,84
235,511,460,51,64,99,71,54,73,150,0,998,511
236,0,0,0,0,0,0,0,0,0,0,0,0
237,50,48,2,6,11,4,3,4,22,84,62,134
238,572,549,23,119,139,59,89,61,105,85,1165,657
239,1298,1246,52,146,173,173,137,192,477,0,2148,1298
240,1547,1388,159,138,183,226,137,231,632,21,2963,1568
241,769,697,72,70,75,105,75,122,322,0,1408,769
242,686,512,174,73,56,77,93,106,281,70,2102,756
243,1521,1459,62,208,225,233,149,226,480,140,2757,1661
244,1334,1172,162,113,169,173,97,216,566,0,2727,1334
245,1144,811,333,90,114,159,129,163,489,34,3797,1178
246,1330,1263,67,114,139,134,128,235,580,0,3079,1330
247,812,377,435,101,84,105,73,125,324,0,2629,812
248,1010,915,95,196,233,160,103,125,193,6,1872,1016
249,799,671,128,181,175,116,92,91,144,62,1544,861
250,2151,1949,202,418,497,341,219,267,409,43,3984,2194
251,1676,1597,79,219,436,269,187,219,346,14,2937,1690
252,485,462,23,63,126,78,54,63,101,3,850,488
253,989,943,46,129,257,159,110,129,205,18,1734,1007
254,453,432,21,59,68,67,47,65,147,0,794,453
255,465,444,21,60,69,69,48,67,152,6,816,471
256,984,939,45,127,147,146,101,141,322,4,1726,988
257,946,903,43,122,141,140,97,136,310,0,1660,946
258,626,574,52,58,95,97,62,94,220,3,1143,629
259,1235,1133,102,115,187,192,122,185,434,43,2253,1278
260,1758,1613,145,164,267,274,173,264,616,17,3207,1775
261,1446,1355,91,316,74,151,193,229,483,140,3546,1586
262,1018,954,64,222,52,106,136,161,341,44,2496,1062
263,863,809,54,188,44,90,115,136,290,0,2115,863
264,793,743,50,173,40,83,106,125,266,1,1944,794
265,619,563,56,120,13,63,83,91,249,0,1481,619
266,579,527,52,112,12,59,78,85,233,1,1384,580
267,919,836,83,178,19,93,123,135,371,1,2197,920
268,1166,1060,106,226,24,119,157,171,469,89,2789,1255
269,455,401,54,42,47,60,44,78,184,191,884,646
270,964,924,40,80,95,110,97,149,433,0,2048,964
271,482,411,71,114,3,31,79,80,175,58,1382,540
272,659,427,232,68,57,95,75,102,262,11,2519,670
273,521,305,216,77,58,83,52,71,180,147,1759,668
274,166,62,104,31,18,27,14,28,48,0,496,166
275,712,628,84,66,73,94,69,122,288,41,1381,753
276,491,433,58,45,50,65,48,84,199,0,954,491
277,527,465,62,49,54,70,51,90,213,8,1024,535
278,403,361,42,33,50,56,35,68,161,0,805,403
279,515,462,53,42,64,72,45,87,205,0,1031,515
280,668,599,69,55,83,93,58,113,266,0,1337,668
281,557,500,57,45,69,78,48,94,223,1,1115,558
282,497,443,54,37,61,70,39,83,207,1,969,498
283,770,686,84,58,94,108,61,129,320,0,1500,770
284,627,559,68,47,77,88,50,105,260,0,1223,627
285,619,538,81,47,69,86,46,101,270,0,1234,619
286,430,374,56,33,48,60,32,70,187,0,858,430
287,491,427,64,37,54,68,36,80,216,0,980,491
288,526,457,69,40,58,73,39,86,230,0,1050,526
289,557,484,73,42,62,78,41,91,243,64,1111,621
290,1034,937,97,94,100,142,101,163,434,0,1893,1034
291,816,739,77,74,79,112,80,129,342,0,1494,816
292,687,659,28,57,68,78,69,106,309,0,1460,687
293,378,362,16,31,37,43,38,59,170,0,802,378
294,507,479,28,50,44,56,53,83,221,0,1059,507
295,352,333,19,34,31,39,37,58,153,0,736,352
296,576,397,179,52,53,75,71,86,239,57,2042,633
297,615,426,189,50,49,65,76,94,281,27,2163,642
298,205,122,83,29,15,17,15,34,95,172,599,377
299,5900,3241,2659,2167,1889,536,556,382,370,0,17309,5900
300,576,545,31,56,50,64,60,94,252,36,1202,612
301,506,478,28,50,44,56,53,83,220,0,1055,506
302,2745,2649,96,417,239,414,298,388,989,1,4868,2746
303,1701,1642,59,258,148,257,185,241,612,5,3016,1706
304,1302,1194,108,306,14,150,159,225,448,45,3410,1347
305,729,669,60,172,8,84,89,126,250,31,1910,760
306,630,611,19,112,47,70,88,98,215,66,1251,696
307,918,842,76,216,10,106,112,159,315,18,2406,936
308,615,535,80,135,4,70,61,105,240,20,1945,635
309,989,844,145,234,5,63,161,164,362,19,2838,1008
310,445,380,65,106,2,29,73,74,161,0,1277,445
311,438,381,57,96,3,50,43,75,171,25,1384,463
312,243,226,17,38,24,32,34,37,78,50,642,293
313,543,473,70,120,3,62,54,92,212,0,1717,543
314,438,402,36,87,2,53,46,72,178,71,1348,509
315,399,366,33,80,1,48,42,66,162,24,1225,423
316,686,445,241,71,60,99,78,106,272,38,2621,724
317,542,499,43,128,2,93,22,86,211,11,1569,553
318,490,318,172,50,43,71,56,76,194,0,1870,490
319,331,286,45,28,29,36,32,54,152,0,879,331
320,391,300,91,19,55,51,28,66,172,5,1037,396
321,325,249,76,16,46,42,23,55,143,0,861,325
322,240,127,113,34,28,32,25,34,87,27,845,267
323,354,188,166,50,41,47,36,50,130,15,1246,369
324,548,441,107,37,63,74,47,86,241,60,1288,608
325,506,407,99,34,58,69,44,79,222,22,1189,528
326,376,221,155,27,52,49,49,56,143,0,1541,376
327,501,263,238,74,66,84,45,68,164,0,1840,501
328,263,138,125,39,35,44,24,36,85,0,965,263
329,356,301,55,22,49,47,26,59,153,23,817,379
330,660,559,101,40,91,87,48,109,285,36,1516,696
331,437,370,67,26,60,57,32,72,190,32,1003,469
332,620,499,121,42,71,84,54,97,272,175,1456,795
333,655,566,89,56,58,70,64,107,300,4,1741,659
334,575,497,78,49,51,62,56,94,263,0,1528,575
335,641,520,121,41,66,70,71,99,294,0,1560,641
336,675,548,127,43,69,74,75,104,310,0,1642,675
337,559,454,105,36,57,61,62,86,257,0,1360,559
338,430,349,81,28,44,47,48,66,197,3,1046,433
339,237,192,45,15,24,26,26,37,109,0,576,237
340,510,338,172,33,56,57,53,90,221,22,1818,532
341,262,173,89,17,29,29,27,46,114,0,934,262
342,409,271,138,26,45,45,42,72,179,22,1457,431
343,396,262,134,26,44,44,41,70,171,13,1409,409
344,431,285,146,28,48,48,44,76,187,59,1534,490
345,694,558,136,47,80,94,60,108,305,37,1629,731
346,886,716,170,52,125,111,72,136,390,43,2051,929
347,437,353,84,26,62,55,35,67,192,34,1013,471
348,341,276,65,20,48,43,28,53,149,17,790,358
349,328,265,63,19,46,41,27,51,144,92,760,420
350,379,290,89,19,53,49,27,64,167,5,1006,384
351,727,533,194,38,85,108,52,111,333,0,2083,727
352,688,515,173,32,75,96,50,127,308,5,1768,693
353,815,598,217,42,95,122,58,125,373,22,2334,837
354,336,252,84,16,37,47,24,62,150,0,863,336
355,605,479,126,43,43,72,72,92,283,581,1918,1186
356,454,328,126,24,55,50,49,76,200,29,1494,483
357,364,263,101,19,44,40,39,61,161,0,1198,364
358,422,305,117,23,51,47,45,71,185,0,1389,422
359,507,366,141,27,61,56,55,85,223,0,1671,507
360,352,254,98,19,42,39,38,59,155,54,1160,406
361,315,228,87,17,38,35,34,53,138,7,1038,322
362,486,344,142,38,39,62,60,70,217,6,1691,492
363,469,332,137,36,37,60,58,68,210,0,1633,469
364,347,246,101,27,28,44,43,50,155,4,1210,351
365,343,243,100,27,27,44,42,49,154,0,1196,343
366,235,166,69,26,26,32,28,36,87,28,770,263
367,349,246,103,38,38,48,41,53,131,0,1145,349
368,504,376,128,54,41,56,68,78,207,8,1546,512
369,157,117,40,17,13,18,21,24,64,0,481,157
370,744,476,268,66,54,90,86,113,335,0,2712,744
371,747,514,233,70,55,105,81,102,334,0,2762,747
372,760,516,244,56,69,76,102,122,335,0,2836,760
373,517,330,187,46,37,62,59,79,234,4,1886,521
374,382,302,80,27,27,46,46,58,178,0,1211,382
375,890,671,219,58,103,99,96,137,397,7,3120,897
376,169,127,42,11,19,19,18,26,76,0,592,169
377,316,238,78,21,36,35,34,49,141,0,1107,316
378,196,148,48,13,23,22,21,30,87,0,686,196
379,542,366,176,30,51,64,58,92,247,15,2063,557
380,431,291,140,24,41,51,46,73,196,11,1640,442
381,363,245,118,20,34,43,39,61,166,0,1382,363
382,362,245,117,20,34,43,39,61,165,21,1378,383
383,365,247,118,21,35,43,39,62,165,45,1389,410
384,281,193,88,27,27,37,39,37,114,0,1006,281
385,365,251,114,34,27,51,39,50,164,15,1350,380
386,362,248,114,35,35,47,51,48,146,0,1298,362
387,361,256,105,28,36,50,41,52,154,0,1197,361
388,276,190,86,26,20,39,30,38,123,2,1020,278
389,438,300,138,43,43,57,61,58,176,0,1572,438
390,799,547,252,101,87,108,101,109,293,0,2974,799
391,499,324,175,45,71,67,60,73,183,24,1914,523
392,544,353,191,49,77,74,65,79,200,0,2085,544
393,417,381,36,44,56,55,47,63,152,40,831,457
394,614,562,52,64,82,81,69,93,225,112,1224,726
395,444,406,38,46,59,59,50,67,163,1,885,445
396,763,698,65,80,102,101,86,115,279,17,1519,780
397,1121,1069,52,164,84,136,122,174,441,502,2204,1623
398,932,889,43,136,70,113,102,145,366,0,1833,932
399,1431,1403,28,414,548,146,119,108,96,19,2532,1450
400,1322,1298,24,427,212,194,156,155,178,0,2337,1322
401,448,438,10,145,171,44,37,27,24,0,792,448
402,413,394,19,60,31,50,45,64,163,0,812,413
403,2382,1691,691,271,558,342,275,314,622,0,7221,2382
404,441,313,128,50,103,63,51,58,116,0,1337,441
405,307,279,28,24,43,36,27,46,131,0,636,307
406,1527,1466,61,172,203,203,161,226,562,0,2527,1527
407,718,652,66,56,101,85,62,108,306,1248,1488,1966
408,697,677,20,123,52,77,98,108,239,0,1383,697
409,11,10,1,2,1,1,2,2,3,617,29,628
410,596,549,47,141,2,103,24,95,231,1,1724,597
411,369,340,29,87,1,63,15,59,144,46,1068,415
412,759,496,263,88,84,101,82,107,297,0,2605,759
413,431,281,150,50,47,58,46,61,169,0,1478,431
414,311,233,78,15,34,44,23,58,137,17,798,328
415,606,406,200,55,47,84,67,98,255,0,2188,606
416,747,501,246,68,58,103,83,120,315,0,2701,747
417,837,569,268,62,75,84,112,134,370,8,3122,845
418,822,569,253,66,65,87,102,126,376,72,2888,894
419,678,464,214,85,73,91,85,92,252,73,2525,751
420,419,225,194,51,47,55,40,77,149,8,1717,427
421,308,165,143,38,34,41,29,56,110,0,1265,308
422,408,216,192,58,47,54,42,57,150,115,1436,523
423,652,626,26,74,87,87,69,96,239,0,1079,652
424,494,474,20,56,66,66,52,73,181,0,817,494
425,801,769,32,90,106,106,84,118,297,1,1325,802
426,1107,1079,28,201,67,125,162,177,375,10,2074,1117
427,719,701,18,131,44,81,105,115,243,0,1346,719
428,550,379,171,49,51,72,67,82,229,23,1948,573
429,383,264,119,34,36,50,47,57,159,1,1358,384
430,383,264,119,34,36,50,47,57,159,12,1358,395
431,423,292,131,38,39,55,52,63,176,10,1498,433
432,736,523,213,50,88,78,86,124,310,45,2544,781
433,660,469,191,45,79,70,78,111,277,64,2280,724
434,287,204,83,20,34,31,34,48,120,23,994,310
435,301,214,87,21,36,32,35,51,126,0,1041,301
436,356,253,103,24,42,38,42,60,150,0,1232,356
437,417,296,121,29,50,44,49,70,175,0,1441,417
438,989,576,413,119,97,146,105,154,368,95,3375,1084
439,958,916,42,238,214,122,108,115,161,13,2306,971
440,1912,1606,306,434,418,278,220,219,343,186,3695,2098
441,691,580,111,157,151,100,80,79,124,128,1336,819
442,70,67,3,17,16,9,8,8,12,233,169,303
443,757,636,121,172,165,110,87,87,136,21,1462,778
444,2720,2465,255,529,629,431,277,338,516,75,5039,2795
445,1164,1044,120,245,16,149,117,183,454,2,2580,1166
446,1180,1058,122,248,16,151,119,185,461,5,2615,1185
447,360,323,37,76,5,46,36,56,141,0,798,360
448,128,117,11,13,15,18,11,22,49,23,244,151
449,586,404,182,53,54,76,72,87,244,1,2078,587
450,0,0,0,0,0,0,0,0,0,0,0,0
451,1459,1337,122,153,166,201,124,253,562,18,2774,1477
452,1904,1860,44,615,728,186,158,115,102,103,3367,2007
453,722,690,32,179,162,92,81,87,121,104,1737,826
454,488,467,21,121,109,62,55,59,82,8,1175,496
455,0,0,0,0,0,0,0,0,0,4,0,4
456,109,104,5,27,24,14,12,13,19,25,262,134
457,1118,1097,21,361,179,164,132,131,151,154,1977,1272
458,1540,1505,35,497,589,150,128,93,83,27,2723,1567
459,443,434,9,128,170,45,37,34,29,205,784,648
460,303,282,21,48,29,40,43,46,97,0,801,303
461,310,289,21,49,30,41,44,47,99,0,820,310
462,59,57,2,9,5,9,6,8,22,0,104,59
463,5707,5508,199,866,497,861,619,807,2057,46,10120,5753
464,1239,1196,43,188,108,187,134,175,447,4,2196,1243
465,532,513,19,81,46,80,58,75,192,0,944,532
466,0,0,0,0,0,0,0,0,0,0,0,0
467,3627,3323,304,379,414,499,308,629,1398,0,6898,3627
468,0,0,0,0,0,0,0,0,0,32,0,32
469,10,9,1,1,1,1,1,2,4,3,19,13
470,690,632,58,72,79,95,59,120,265,3,1312,693
471,79,72,7,8,9,11,7,14,30,8,150,87
472,0,0,0,0,0,0,0,0,0,0,0,0
473,2168,1986,182,227,247,298,184,376,836,0,4124,2168
474,459,288,171,71,50,69,35,69,165,0,1262,459
475,792,496,296,123,87,118,61,118,285,8,2177,800
476,811,301,510,153,86,133,67,136,236,3,2421,814
477,412,242,170,30,57,54,53,62,156,0,1687,412
478,984,578,406,72,137,129,127,147,372,0,4027,984
479,447,234,213,66,59,75,40,60,147,0,1644,447
480,417,219,198,61,55,70,37,56,138,0,1531,417
481,299,159,140,42,34,40,31,42,110,1,1054,300
482,60,41,19,6,6,8,8,8,24,0,213,60
483,4076,2894,1182,464,955,586,471,537,1063,0,12355,4076
484,1913,1358,555,218,448,275,221,252,499,10,5798,1923
485,161,121,40,10,19,18,17,25,72,10,562,171
486,263,198,65,17,30,29,28,40,119,0,923,263
487,247,178,69,13,30,27,27,42,108,0,813,247
488,698,663,35,60,73,71,67,123,304,0,1616,698
489,672,638,34,58,70,68,65,119,292,0,1555,672
490,283,276,7,91,108,28,23,17,16,998,501,1281
491,597,555,42,63,44,67,64,86,273,0,1479,597
492,1294,1215,79,139,139,158,139,192,527,0,2968,1294
493,837,747,90,78,73,94,94,113,385,93,2103,930
494,204,182,22,19,18,23,23,28,93,11,513,215
495,250,223,27,23,22,28,28,34,115,0,627,250
496,307,274,33,29,27,34,34,41,142,21,771,328
497,441,344,97,28,52,50,47,71,193,2,1195,443
498,324,253,71,20,38,37,34,52,143,0,876,324
499,363,283,80,23,43,41,38,58,160,0,983,363
500,347,271,76,22,41,39,37,56,152,0,939,347
501,574,448,126,36,68,65,61,92,252,12,1554,586
502,405,316,89,25,48,46,43,65,178,0,1096,405
503,335,261,74,21,40,38,35,54,147,8,908,343
504,356,298,58,20,40,44,34,63,155,4,947,360
505,598,501,97,33,68,74,58,105,260,0,1589,598
506,319,267,52,18,36,39,31,56,139,9,846,328
507,479,402,77,27,54,59,46,84,209,0,1271,479
508,294,246,48,16,33,36,28,52,129,0,780,294
509,284,238,46,16,32,35,28,50,123,0,755,284
510,251,210,41,14,28,31,24,44,110,0,668,251
511,452,362,90,31,72,47,41,65,196,0,1247,452
512,507,406,101,34,80,53,46,73,221,0,1396,507
513,621,497,124,42,98,64,56,90,271,30,1713,651
514,400,320,80,27,63,41,36,58,175,0,1103,400
515,553,443,110,38,88,57,50,80,240,65,1525,618
516,428,343,85,29,68,44,38,62,187,11,1180,439
517,560,527,33,50,78,56,38,93,245,18,1487,578
518,310,292,18,28,43,31,21,51,136,0,822,310
519,395,372,23,35,55,40,27,66,172,0,1047,395
520,241,227,14,22,33,24,16,40,106,0,639,241
521,777,654,123,72,67,91,75,128,344,0,1829,777
522,616,518,98,57,53,72,60,101,273,45,1449,661
523,590,486,104,50,67,74,58,93,248,0,1645,590
524,549,452,97,47,63,69,54,87,229,6,1532,555
525,429,353,76,36,49,54,42,68,180,0,1196,429
526,343,282,61,29,39,43,34,54,144,6,955,349
527,332,273,59,28,38,42,33,53,138,0,925,332
528,315,259,56,27,36,40,31,50,131,0,877,315
529,444,365,79,38,51,56,44,70,185,0,1239,444
530,615,518,97,57,53,72,60,101,272,0,1447,615
531,389,317,72,32,44,46,37,64,166,0,1068,389
532,336,273,63,28,38,40,32,56,142,0,924,336
533,381,310,71,32,43,45,36,63,162,0,1047,381
534,333,271,62,28,38,40,32,55,140,0,916,333
535,504,415,89,29,60,66,49,76,224,0,1429,504
536,342,282,60,20,41,45,33,52,151,22,970,364
537,596,491,105,34,71,79,58,90,264,0,1690,596
538,366,301,65,21,43,48,36,56,162,6,1039,372
539,495,407,88,29,59,65,48,75,219,0,1405,495
540,314,258,56,18,37,41,30,48,140,0,890,314
541,506,415,91,41,50,68,44,86,217,0,1378,506
542,434,356,78,35,43,58,38,74,186,0,1181,434
543,461,378,83,37,46,62,40,78,198,0,1255,461
544,460,378,82,37,45,62,40,78,198,7,1253,467
545,949,847,102,91,91,117,84,168,398,0,1956,949
546,539,481,58,52,52,67,48,96,224,4,1111,543
547,875,761,114,85,84,107,74,146,379,0,2002,875
548,625,558,67,60,60,77,56,111,261,0,1289,625
549,841,748,93,81,96,115,70,135,344,0,1672,841
550,905,805,100,87,104,123,76,145,370,26,1800,931
551,554,482,72,54,53,67,47,93,240,0,1268,554
552,2712,2622,90,207,277,311,276,438,1203,2,6205,2714
553,712,619,93,69,69,87,60,119,308,97,1630,809
554,495,412,83,36,53,61,47,87,211,0,1236,495
555,487,424,63,47,47,59,41,82,211,0,1116,487
556,501,417,84,37,54,62,48,88,212,0,1251,501
557,247,203,44,20,23,32,21,44,107,0,631,247
558,458,376,82,37,43,59,39,82,198,0,1170,458
559,407,334,73,33,38,53,35,73,175,0,1039,407
560,355,292,63,29,33,46,31,64,152,0,907,355
561,308,286,22,33,22,35,33,45,140,10,762,318
562,677,604,73,63,59,76,76,91,312,11,1700,688
563,685,609,76,66,78,93,57,110,281,17,1362,702
564,478,398,80,35,52,59,46,84,202,0,1194,478
565,365,273,92,26,38,41,39,59,162,15,1081,380
566,568,425,143,40,59,64,61,92,252,10,1684,578
567,425,318,107,30,44,48,46,69,188,0,1260,425
568,516,386,130,36,54,58,56,84,228,0,1529,516
569,501,375,126,35,52,56,54,81,223,0,1483,501
570,500,374,126,35,52,56,54,81,222,0,1480,500
571,819,693,126,78,87,104,68,127,355,8,2027,827
572,747,632,115,71,79,95,62,116,324,0,1849,747
573,599,507,92,57,63,76,50,93,260,8,1482,607
574,715,605,110,68,76,91,59,111,310,29,1770,744
575,537,454,83,51,57,68,45,83,233,0,1328,537
576,404,342,62,39,43,51,34,63,174,11,1000,415
577,577,480,97,40,72,69,61,90,245,0,1577,577
578,708,590,118,49,88,84,75,110,302,198,1936,906
579,431,359,72,30,54,51,46,67,183,0,1178,431
580,515,429,86,36,64,61,55,80,219,0,1409,515
581,595,495,100,41,74,71,63,93,253,0,1628,595
582,450,375,75,31,56,54,48,70,191,0,1231,450
583,395,323,72,29,46,47,39,61,173,0,1120,395
584,427,349,78,31,50,51,43,66,186,0,1210,427
585,486,397,89,35,57,58,48,75,213,0,1378,486
586,629,514,115,46,73,76,63,97,274,19,1782,648
587,392,320,72,28,46,47,39,60,172,0,1112,392
588,425,347,78,31,50,51,42,65,186,19,1205,444
589,447,365,82,32,52,54,45,69,195,0,1266,447
590,1859,1746,113,200,200,226,200,275,758,0,4263,1859
591,411,386,25,44,44,50,44,61,168,0,943,411
592,1841,1729,112,198,198,224,198,273,750,0,4221,1841
593,1075,1010,65,116,116,131,116,159,437,0,2466,1075
594,579,471,108,48,65,69,55,96,246,0,1590,579
595,635,521,114,51,63,85,55,108,273,0,1728,635
596,324,317,7,33,33,41,37,48,132,4,527,328
597,0,0,0,0,0,0,0,0,0,0,0,0
598,310,232,78,22,32,35,33,50,138,0,918,310
599,1408,1322,86,151,152,171,152,209,573,0,3229,1408
600,60,58,2,5,6,7,6,10,26,3014,137,3074
601,164,146,18,15,14,18,18,22,77,0,413,164
602,555,456,99,45,52,72,48,100,238,0,1418,555
603,398,390,8,115,152,41,33,30,27,0,703,398
604,45,44,1,13,17,5,4,3,3,0,79,45
605,2848,2792,56,824,1091,291,237,216,189,0,5039,2848
606,19,19,0,5,7,2,2,1,2,0,33,19
607,361,355,6,190,110,31,11,14,5,67,552,428
608,117,115,2,62,36,10,3,5,1,23,179,140
609,105,103,2,55,32,9,3,4,2,13,161,118
610,494,488,6,167,235,28,27,23,14,9,716,503
611,0,0,0,0,0,0,0,0,0,3,0,3
612,218,215,3,74,104,13,12,10,5,0,316,218
613,98,97,1,37,44,5,6,4,2,0,144,98
614,175,172,3,65,79,9,10,6,6,13,256,188
615,525,521,4,185,242,34,24,21,19,7,764,532
616,1500,1091,409,91,176,195,122,254,662,0,4062,1500
617,619,514,105,55,51,80,65,100,268,0,1498,619
618,1572,1131,441,133,192,178,200,288,581,181,5077,1753
619,1492,998,494,78,153,183,136,253,689,0,4425,1492
620,2435,1774,661,150,184,296,210,425,1170,8,6277,2443
621,11,7,4,0,0,2,1,3,5,0,32,11
622,3290,2771,519,341,372,439,413,568,1157,8,7283,3298
623,1300,961,339,110,152,114,192,228,504,0,3954,1300
624,1307,893,414,85,131,163,144,204,580,22,4559,1329
625,1978,1531,447,129,209,283,135,323,899,10,5851,1988
626,1529,1095,434,101,148,175,159,265,681,25,5597,1554
627,457,338,119,37,65,67,54,78,156,0,1362,457
628,1780,1241,539,151,213,239,223,332,622,10,6303,1790
629,592,381,211,43,59,71,66,95,258,19,1822,611
630,3067,2099,968,271,404,431,414,546,1001,4,9077,3071
631,1906,1224,682,90,246,233,188,283,866,31,5623,1937
632,1640,1267,373,112,133,200,166,254,775,97,3762,1737
633,1932,1820,112,201,139,247,191,278,876,45,4106,1977
634,1232,962,270,92,91,149,106,223,571,0,3155,1232
635,1795,1272,523,132,152,212,172,321,806,0,4599,1795
636,2056,1571,485,164,146,243,165,345,993,0,5211,2056
637,1706,1174,532,96,173,173,197,299,768,24,5348,1730
638,1741,1239,502,121,148,175,205,259,833,298,5142,2039
639,330,279,51,23,27,17,53,58,152,0,827,330
640,915,750,165,39,78,32,140,182,444,0,2503,915
641,638,502,136,32,57,15,115,118,301,20,1750,658
642,541,471,70,38,46,42,80,99,236,3,1358,544
643,301,255,46,18,27,23,44,51,138,48,744,349
644,1986,1302,684,93,189,254,195,321,934,38,6638,2024
645,2117,1366,751,160,234,254,209,343,917,1,7101,2118
646,1536,1010,526,95,156,171,169,245,700,149,4639,1685
647,2415,1293,1122,196,253,293,256,393,1024,0,9005,2415
648,942,751,191,72,89,122,113,150,396,0,2302,942
649,394,301,93,33,32,43,47,65,174,0,1054,394
650,356,272,84,30,29,39,42,58,158,1,953,357
651,388,297,91,32,31,43,46,64,172,0,1039,388
652,470,423,47,30,52,56,46,74,212,0,809,470
653,606,426,180,41,51,55,69,114,276,106,1862,712
654,1931,1034,897,156,203,234,205,315,818,0,7199,1931
655,847,557,290,52,86,95,93,135,386,16,2560,863
656,6529,5137,1392,317,849,494,1090,1133,2646,342,16146,6871
657,717,471,246,44,73,80,79,114,327,16,2165,733
658,977,827,150,57,86,75,144,166,449,382,2410,1359
659,344,242,102,23,29,31,39,65,157,50,1057,394
660,466,327,139,32,39,42,53,88,212,0,1431,466
661,957,698,259,76,97,100,115,151,418,25,2844,982
662,576,298,278,35,58,65,53,102,263,0,2087,576
663,402,208,194,24,40,45,37,71,185,0,1457,402
664,981,805,176,83,109,132,118,146,393,22,2256,1003
665,304,259,45,13,39,29,41,52,130,0,644,304
666,4421,2934,1487,240,522,675,402,715,1867,52,12918,4473
667,755,658,97,53,64,58,111,138,331,39,1898,794
668,301,255,46,18,27,23,44,51,138,0,741,301
669,503,260,243,31,51,57,46,89,229,32,1823,535
670,3421,2200,1221,250,338,409,383,546,1495,106,10536,3527
671,942,782,160,84,77,122,98,152,409,24,2279,966
672,1374,1163,211,80,121,106,202,233,632,60,3389,1434
673,447,378,69,26,39,34,66,76,206,0,1104,447
674,2773,2359,414,119,353,260,376,473,1192,0,5876,2773
675,216,168,48,6,23,18,32,36,101,0,583,216
676,410,320,90,12,44,34,61,69,190,0,1108,410
677,370,289,81,11,39,31,55,62,172,17,1001,387
678,880,640,240,53,103,115,71,149,389,0,2382,880
679,661,452,209,43,66,82,73,103,294,0,2305,661
680,183,137,46,16,22,26,23,31,65,8,477,191
681,152,114,38,13,18,22,19,26,54,0,395,152
682,331,258,73,10,35,27,49,56,154,0,894,331
683,616,378,238,56,74,75,65,107,239,0,2272,616
684,1057,649,408,96,126,129,111,184,411,0,3897,1057
685,379,259,120,25,38,47,42,59,168,0,1320,379
686,750,488,262,44,75,77,81,137,336,0,2705,750
687,832,541,291,49,83,86,90,153,371,0,2999,832
688,579,383,196,27,67,60,63,98,264,13,2068,592
689,491,325,166,23,57,51,53,83,224,3,1754,494
690,1077,712,365,50,124,112,117,183,491,135,3845,1212
691,512,339,173,24,59,53,56,87,233,9,1829,521
692,3155,2407,748,274,262,398,353,456,1412,6,7540,3161
693,1020,811,209,74,98,138,79,178,453,0,2678,1020
694,4498,2881,1617,256,494,585,421,714,2028,10,13982,4508
695,723,551,172,34,93,91,88,121,296,0,1881,723
696,280,214,66,13,36,35,34,47,115,6,729,286
697,3215,2414,801,276,386,465,402,543,1143,0,8352,3215
698,1312,1000,312,61,169,166,160,219,537,12,3413,1324
699,800,664,136,71,66,103,83,129,348,11,1936,811
700,4616,3064,1552,251,545,705,420,746,1949,0,13486,4616
701,4189,2780,1409,227,495,640,381,677,1769,30,12239,4219
702,509,379,130,32,55,69,52,83,218,0,1680,509
703,894,665,229,56,97,121,92,146,382,27,2952,921
704,784,584,200,49,85,106,80,128,336,95,2586,879
705,8632,8030,602,986,958,1160,955,1317,3256,0,17815,8632
706,1655,1222,433,132,235,244,194,281,569,18,4930,1673
707,558,445,113,43,53,72,67,89,234,7,1364,565
708,3653,2874,779,177,475,277,610,634,1480,0,9033,3653
709,991,780,211,48,129,75,165,172,402,0,2450,991
710,761,644,117,52,63,40,122,133,351,14,1905,775
711,233,197,36,16,19,12,37,41,108,21,583,254
712,347,273,74,17,31,8,62,64,165,0,951,347
713,525,354,171,28,60,59,51,94,233,16,1761,541
714,420,284,136,23,48,47,41,75,186,5,1408,425
715,808,546,262,43,92,90,79,145,359,0,2712,808
716,721,573,148,52,69,98,56,126,320,0,1894,721
717,422,338,84,23,41,29,67,74,188,0,1081,422
718,1030,825,205,57,99,70,165,181,458,0,2639,1030
719,530,425,105,29,51,36,85,93,236,11,1360,541
720,119,97,22,8,12,16,11,19,53,0,328,119
721,2292,1521,771,124,271,350,209,371,967,115,6696,2407
722,845,541,304,48,93,110,79,134,381,17,2626,862
723,703,450,253,40,77,91,66,112,317,0,2184,703
724,0,0,0,0,0,0,0,0,0,0,0,0
725,0,0,0,0,0,0,0,0,0,106,0,106
726,440,297,143,24,50,49,43,79,195,0,1477,440
727,1045,854,191,74,102,144,95,169,461,0,2873,1045
728,1150,859,291,94,111,113,152,195,485,63,3356,1213
729,1070,800,270,88,104,106,141,182,449,45,3124,1115
730,1622,1184,438,128,164,170,195,257,708,0,4817,1622
731,449,373,76,40,37,58,47,73,194,24,1087,473
732,228,182,46,17,22,30,27,36,96,16,557,244
733,391,312,79,30,37,51,47,62,164,15,956,406
734,6885,5651,1234,581,765,927,829,1024,2759,0,15844,6885
735,882,794,88,55,97,104,86,139,401,0,1517,882
736,18,16,2,1,2,2,2,3,8,0,32,18
737,1925,1242,683,146,212,231,190,312,834,13,6456,1938
738,320,272,48,23,36,38,47,44,132,0,756,320
739,1272,1055,217,66,163,134,166,149,594,10,3115,1282
740,1489,1302,187,114,168,171,186,186,664,0,3383,1489
741,261,219,42,17,34,30,40,32,108,0,659,261
742,819,510,309,42,97,101,91,143,345,157,2546,976
743,341,253,88,16,50,40,48,54,133,40,1018,381
744,2116,1986,130,313,331,293,250,233,696,0,3805,2116
745,1280,1065,215,131,236,187,177,162,387,0,2862,1280
746,1262,1000,262,109,264,173,164,158,394,0,3148,1262
747,3543,3041,502,370,641,490,440,437,1165,0,7688,3543
748,788,571,217,53,160,111,124,79,261,3,2275,791
749,1309,1022,287,87,256,159,175,156,476,111,3420,1420
750,2716,2196,520,93,551,293,186,448,1145,0,7003,2716
751,3443,3031,412,197,548,427,282,584,1405,0,7149,3443
752,407,322,85,15,39,23,57,61,212,0,1145,407
753,1421,1084,337,53,140,103,198,241,686,0,4060,1421
754,624,497,127,33,78,61,111,101,240,6,1624,630
755,854,616,238,54,78,62,115,130,415,255,2186,1109
756,378,265,113,32,43,31,52,66,154,52,1299,430
757,1420,1055,365,141,254,192,164,188,481,8,3674,1428
758,1142,902,240,76,224,147,153,164,378,0,3038,1142
759,1140,932,208,112,208,148,148,143,381,22,2796,1162
760,2315,1698,617,154,218,275,227,355,1086,20,5832,2335
761,1811,1302,509,125,171,163,212,317,823,31,5509,1842
762,2235,1540,695,132,182,206,259,383,1073,168,5866,2403
763,3753,2855,898,319,424,362,539,653,1456,112,9697,3865
764,2129,1628,501,123,393,257,186,371,799,22,4994,2151
765,418,337,81,27,48,36,55,64,188,0,1041,418
766,335,270,65,21,39,29,44,51,151,0,835,335
767,273,220,53,17,31,24,36,42,123,0,681,273
768,1509,1314,195,82,150,134,213,273,657,225,3076,1734
769,871,758,113,47,86,77,123,158,380,23,1775,894
770,403,336,67,17,47,43,44,69,183,46,926,449
771,1650,1430,220,59,322,184,113,289,683,11,3897,1661
772,760,659,101,27,148,85,52,133,315,34,1795,794
773,754,653,101,27,147,84,51,132,313,0,1781,754
774,683,595,88,37,68,61,97,124,296,7,1392,690
775,867,729,138,48,85,82,123,152,377,0,1940,867
776,601,391,210,30,62,56,66,109,278,12,1825,613
777,425,276,149,22,44,39,47,77,196,0,1289,425
778,295,192,103,15,30,27,33,54,136,8,897,303
779,482,278,204,28,65,60,55,86,188,0,1687,482
780,736,425,311,43,99,91,84,131,288,130,2576,866
781,726,419,307,42,98,90,83,129,284,35,2544,761
782,448,388,60,16,87,50,31,79,185,566,1058,1014
783,463,267,196,27,62,57,53,82,182,0,1622,463
784,1063,919,144,87,123,112,155,181,405,230,2150,1293
785,932,806,126,76,108,98,136,159,355,21,1886,953
786,639,523,116,52,90,84,89,80,244,0,1594,639
787,997,862,135,82,115,105,145,170,380,0,2016,997
788,411,345,66,26,53,47,63,51,171,0,1039,411
789,455,382,73,29,59,52,70,56,189,0,1151,455
790,525,439,86,36,66,59,48,81,235,0,1214,525
791,790,660,130,53,100,90,71,121,355,0,1824,790
792,320,253,67,12,31,18,45,48,166,0,902,320
793,1410,1186,224,79,139,133,200,247,612,18,3157,1428
794,1591,1263,328,125,235,184,191,212,644,70,4095,1661
795,850,710,140,77,105,98,95,130,345,111,1918,961
796,1178,984,194,107,145,135,132,180,479,0,2659,1178
797,746,616,130,41,100,74,118,87,326,26,1887,772
798,654,545,109,27,77,70,71,112,297,37,1502,691
799,752,627,125,31,88,81,81,128,343,1,1727,753
800,321,267,54,13,38,35,35,55,145,8,737,329
801,514,413,101,21,56,52,58,83,244,0,1164,514
802,251,202,49,10,27,26,28,41,119,0,568,251
803,655,527,128,26,71,67,74,106,311,0,1482,655
804,1131,909,222,46,123,115,128,184,535,0,2561,1131
805,277,223,54,11,30,28,31,45,132,0,628,277
806,624,515,109,34,83,62,98,72,275,57,1579,681
807,609,521,88,57,84,72,80,84,232,79,1349,688
808,1339,1145,194,125,185,159,176,184,510,131,2966,1470
809,340,291,49,32,47,40,45,47,129,51,753,391
810,7286,6030,1256,682,1076,908,894,955,2771,8,16550,7294
811,2237,2076,161,105,254,254,243,391,990,1,3920,2238
812,1474,1368,106,69,167,167,160,258,653,12,2582,1486
813,1016,943,73,48,115,115,110,178,450,0,1781,1016
814,578,428,150,27,84,67,81,91,228,93,1724,671
815,326,203,123,17,39,40,36,57,137,24,1015,350
816,359,251,108,30,41,30,49,63,146,68,1236,427
817,1315,1047,268,134,241,184,159,189,408,0,3274,1315
818,2472,1968,504,251,453,346,300,355,767,0,6155,2472
819,831,632,199,48,117,113,106,128,319,23,2193,854
820,739,562,177,42,104,100,95,114,284,28,1950,767
821,406,309,97,23,57,55,52,63,156,38,1071,444
822,409,311,98,23,58,56,52,63,157,0,1079,409
823,1330,1133,197,120,167,161,143,190,549,0,2827,1330
824,341,270,71,13,33,19,47,51,178,0,959,341
825,462,352,110,17,46,33,64,78,224,0,1321,462
826,998,944,54,69,131,113,122,170,393,0,1747,998
827,903,714,189,34,87,51,126,136,469,0,2541,903
828,647,551,96,46,72,77,94,88,270,0,1527,647
829,658,622,36,45,87,75,81,112,258,0,1152,658
830,562,531,31,39,74,64,69,96,220,5,984,567
831,755,714,41,52,99,86,92,129,297,54,1323,809
832,250,199,51,13,31,25,44,40,97,0,649,250
833,466,371,95,24,58,46,83,75,180,0,1212,466
834,632,517,115,51,89,83,88,79,242,20,1576,652
835,3674,3007,667,299,520,481,510,461,1403,0,9163,3674
836,185,162,23,11,33,21,14,29,77,0,373,185
837,2148,1777,371,131,390,272,187,346,822,172,5114,2320
838,1605,1238,367,133,193,195,166,268,650,38,4267,1643
839,367,307,60,36,77,51,38,57,108,0,788,367
840,1553,824,729,115,281,199,159,264,535,22,5262,1575
841,1446,690,756,119,261,194,117,265,490,129,5558,1575
842,1317,1031,286,57,229,168,95,191,577,0,3389,1317
843,668,569,99,27,136,74,39,112,280,0,1630,668
844,1727,1411,316,91,387,225,168,282,574,35,4408,1762
845,2593,1988,605,117,601,367,228,459,821,0,6261,2593
846,422,172,250,27,84,61,36,75,139,0,1620,422
847,1625,1103,522,151,322,216,204,231,501,0,4677,1625
848,1084,855,229,110,204,167,169,136,298,39,2920,1123
849,808,581,227,98,138,114,64,122,272,87,2107,895
850,1768,694,1074,231,410,293,126,296,412,104,8609,1872
851,1577,632,945,226,351,252,133,270,345,27,7240,1604
852,1857,1399,458,197,313,289,235,319,504,200,4331,2057
853,1079,871,208,147,161,171,124,173,303,0,2552,1079
854,1192,912,280,146,215,177,113,211,330,10,3256,1202
855,1839,1525,314,247,312,293,170,293,524,11,4442,1850
856,5262,4774,488,739,936,842,474,765,1506,8,11440,5270
857,2721,2210,511,311,359,356,284,502,909,69,6621,2790
858,1267,1001,266,154,149,179,141,230,414,0,3251,1267
859,1261,1001,260,144,146,164,152,238,417,0,3225,1261
860,2362,1884,478,249,402,347,278,346,740,41,5868,2403
861,2275,1780,495,202,478,288,254,347,706,43,5545,2318
862,2303,1907,396,150,485,305,161,389,813,105,5800,2408
863,1987,1616,371,237,299,274,222,314,641,27,4674,2014
864,776,622,154,120,81,110,95,142,228,0,2109,776
865,4622,2047,2575,751,1011,703,331,696,1130,15,19252,4637
866,2600,1239,1361,381,553,469,229,430,538,77,10227,2677
867,3002,1617,1385,276,592,423,354,483,874,36,8476,3038
868,987,898,89,141,167,159,103,151,266,57,1930,1044
869,220,176,44,34,23,31,27,40,65,539,598,759
870,487,390,97,75,51,69,59,89,144,0,1323,487
871,1185,798,387,73,214,138,109,189,462,0,3002,1185
872,411,328,83,23,71,51,65,49,152,0,1091,411
873,250,195,55,31,22,32,28,51,86,0,677,250
874,267,208,59,33,23,34,30,55,92,0,725,267
875,459,358,101,57,40,59,51,95,157,0,1246,459
876,1099,825,274,72,142,147,161,125,452,35,3006,1134
877,1011,776,235,36,183,116,62,171,443,0,2679,1011
878,772,593,179,28,140,88,47,131,338,3,2045,775
879,345,266,79,52,51,46,37,58,101,0,933,345
880,590,516,74,34,105,67,44,93,247,0,1189,590
881,1625,1421,204,93,288,185,122,256,681,19,3278,1644
882,1232,1077,155,70,218,140,92,194,518,16,2484,1248
883,665,537,128,90,99,105,77,106,188,0,1573,665
884,163,109,54,24,20,18,20,33,48,758,473,921
885,353,235,118,53,43,40,44,71,102,0,1026,353
886,1103,922,181,107,232,152,115,173,324,0,2366,1103
887,388,324,64,38,82,53,41,61,113,25,832,413
888,1478,1345,133,211,250,238,154,226,399,2,2889,1480
889,458,354,104,69,68,62,49,78,132,3,1239,461
890,921,854,67,133,139,140,112,127,270,0,1669,921
891,923,856,67,134,140,141,113,128,267,0,1672,923
892,1113,1032,81,161,168,170,136,154,324,160,2016,1273
893,783,459,324,60,133,101,108,94,287,46,2539,829
894,286,168,118,22,49,37,40,34,104,0,928,286
895,5001,4390,611,450,829,651,475,748,1848,346,9287,5347
896,1128,786,342,118,189,126,136,194,365,0,3194,1128
897,466,190,276,30,92,68,40,83,153,0,1787,466
898,1270,1111,159,73,225,145,95,200,532,36,2561,1306
899,651,382,269,50,110,84,90,78,239,0,2110,651
900,409,353,56,71,195,36,33,44,30,125,910,534
901,279,241,38,49,133,24,22,30,21,0,623,279
902,561,378,183,35,102,65,52,90,217,13,1423,574
903,1238,1020,218,51,223,122,98,186,558,0,2914,1238
904,616,492,124,35,107,77,98,73,226,8,1634,624
905,448,385,63,30,79,53,40,73,173,36,978,484
906,1180,1014,166,80,209,140,104,191,456,12,2579,1192
907,542,466,76,37,96,64,48,88,209,9,1185,551
908,908,627,281,70,137,106,93,137,365,0,2468,908
909,612,249,363,39,121,89,53,109,201,340,2346,952
910,621,340,281,38,101,83,69,107,223,2,2161,623
911,568,402,166,48,106,76,57,87,194,0,1603,568
912,421,383,38,60,71,68,44,64,114,0,823,421
913,605,561,44,88,92,92,74,84,175,0,1096,605
914,515,282,233,31,84,69,58,89,184,37,1791,552
915,497,352,145,42,93,67,50,76,169,0,1402,497
916,727,515,212,61,135,97,73,111,250,38,2050,765
917,640,453,187,54,119,86,64,98,219,39,1806,679
918,1049,847,202,114,282,130,103,150,270,0,2442,1049
919,328,265,63,36,88,41,32,47,84,0,764,328
920,744,641,103,74,147,107,69,124,223,0,1845,744
921,2592,2138,454,280,458,354,312,440,748,144,6431,2736
922,2120,1642,478,198,379,287,245,352,659,209,5874,2329
923,1540,1170,370,137,299,248,148,266,442,1,4308,1541
924,2078,1793,285,227,372,335,202,308,634,0,4904,2078
925,528,423,105,48,135,83,49,87,126,0,1381,528
926,2630,2055,575,283,520,360,269,444,754,0,6572,2630
927,559,449,110,54,123,82,54,93,153,0,1342,559
928,1048,816,232,94,209,166,110,159,310,0,2906,1048
929,8,7,1,2,2,1,1,1,1,3539,13,3547
930,1477,1174,303,143,242,205,189,244,454,13,4013,1490
931,628,570,58,112,130,82,86,87,131,24,1223,652
932,576,472,104,64,110,78,65,88,171,28,1378,604
933,1299,982,317,112,225,182,128,243,409,13,3523,1312
934,1114,904,210,102,193,182,94,200,343,0,2947,1114
935,1442,1225,217,179,247,218,129,247,422,0,3436,1442
936,1563,1229,334,146,345,238,150,252,432,10,4100,1573
937,1171,867,304,122,240,150,123,210,326,0,3023,1171
938,957,748,209,73,178,136,115,141,314,0,2635,957
939,0,0,0,0,0,0,0,0,0,0,0,0
940,1029,989,40,116,196,190,86,173,268,367,2248,1396
941,3014,2518,496,300,464,420,389,492,949,304,7626,3318
942,1396,1137,259,184,344,205,169,208,286,10,3309,1406
943,952,767,185,129,274,115,107,127,200,0,2177,952
944,650,506,144,101,164,90,76,95,124,0,1550,650
945,2118,1856,262,261,567,258,330,283,419,38,4150,2156
946,1023,877,146,148,225,130,142,126,252,0,2130,1023
947,561,490,71,97,164,61,81,65,93,0,1088,561
948,2587,2036,551,477,852,320,233,330,375,20,6099,2607
949,619,540,79,107,181,67,89,72,103,0,1201,619
950,1027,808,219,189,338,127,93,131,149,0,2421,1027
951,925,807,118,160,270,101,133,108,153,0,1793,925
952,3087,2904,183,397,570,396,431,483,810,296,5433,3383
953,0,0,0,0,0,0,0,0,0,0,0,0
954,0,0,0,0,0,0,0,0,0,0,0,0
955,16793,14680,2113,4910,4373,2299,1926,1615,1670,24,28990,16817
956,1497,1153,344,146,279,230,157,273,412,7,3946,1504
957,1332,1253,79,171,246,171,186,208,350,26,2343,1358
958,427,334,93,46,85,58,44,72,122,0,1069,427
959,1151,963,188,148,287,156,122,152,286,0,2516,1151
960,716,648,68,150,163,102,93,97,111,3634,945,4350
961,548,442,106,75,157,66,62,73,115,0,1255,548
962,667,499,168,74,123,100,64,116,190,0,1680,667
963,711,602,109,71,130,126,70,109,205,7,1783,718
964,878,719,159,103,196,102,101,147,229,0,2060,878
965,1039,851,188,122,232,121,119,174,271,0,2436,1039
966,622,510,112,73,139,72,71,104,163,14,1458,636
967,723,569,154,67,159,110,69,116,202,0,1898,723
968,790,638,152,124,172,107,83,128,176,0,1927,790
969,1093,860,233,202,360,135,99,139,158,0,2578,1093
970,537,440,97,59,103,72,60,82,161,0,1282,537
971,1181,953,228,128,318,146,116,168,305,6,2750,1187
972,151,129,22,22,33,19,21,19,37,0,315,151
973,715,613,102,104,157,91,100,88,175,0,1490,715
974,635,495,140,98,160,88,74,93,122,0,1515,635
975,170,149,21,21,46,21,26,23,33,0,332,170
976,1055,830,225,195,348,131,95,135,151,0,2489,1055
977,2017,1571,446,312,509,278,236,294,388,36,4810,2053
978,192,174,18,34,40,25,26,27,40,0,374,192
979,791,672,119,98,136,119,71,136,231,83,1884,874
980,824,748,76,147,171,108,112,114,172,0,1605,824
981,656,596,60,117,136,86,90,91,136,0,1276,656
982,451,366,85,61,127,66,48,64,85,0,1074,451
983,299,242,57,40,84,44,32,42,57,0,713,299
984,1523,1345,178,237,402,194,199,200,291,0,2995,1523
985,784,636,148,106,220,115,83,111,149,0,1868,784
986,1640,1448,192,256,433,209,214,216,312,0,3225,1640
987,1728,1394,334,270,377,233,182,279,387,0,4218,1728
988,1178,1040,138,184,311,150,154,155,224,0,2317,1178
989,784,692,92,122,207,100,102,103,150,3,1541,787
990,313,254,59,42,88,46,33,44,60,21,746,334
991,0,0,0,0,0,0,0,0,0,0,0,0
992,793,587,206,83,163,102,83,142,220,4,2047,797
993,544,455,89,70,136,74,58,72,134,0,1188,544
994,389,299,90,50,71,56,36,64,112,0,998,389
995,453,348,105,58,83,65,42,75,130,0,1161,453
996,235,181,54,30,43,34,22,39,67,0,603,235
997,225,173,52,29,41,32,21,37,65,0,577,225
998,683,642,41,88,126,88,95,107,179,95,1202,778
999,697,592,105,86,119,105,63,119,205,0,1660,697
1000,0,0,0,0,0,0,0,0,0,0,0,0
1001,1212,1014,198,155,302,164,129,160,302,0,2648,1212
1002,368,283,85,36,68,56,39,67,102,0,972,368
1003,451,351,100,41,90,71,47,68,134,0,1251,451
1004,423,329,94,38,85,67,44,64,125,18,1172,441
1005,1143,916,227,103,292,181,106,188,273,0,2990,1143
1006,584,437,147,65,107,87,56,102,167,0,1471,584
1007,737,552,185,82,136,110,71,129,209,94,1855,831
1008,627,504,123,60,138,92,61,104,172,0,1505,627
1009,443,328,115,46,91,57,47,80,122,0,1145,443
1010,5752,4807,945,585,1194,1011,485,878,1599,34,14581,5786
1011,3888,3399,489,1137,1012,532,446,374,387,0,6712,3888
1012,0,0,0,0,0,0,0,0,0,0,0,0
1013,3485,2736,749,560,499,542,532,440,912,20,9257,3505
1014,1531,1164,367,171,220,200,311,205,424,0,4099,1531
1015,1877,1418,459,327,214,324,254,203,555,11,5233,1888
1016,1501,1116,385,254,181,240,228,193,405,0,4189,1501
1017,899,703,196,130,81,142,193,92,261,6,2426,905
1018,205,163,42,31,28,34,30,27,55,0,521,205
1019,1626,1293,333,243,218,270,240,211,444,0,4131,1626
1020,3352,2792,560,627,518,525,413,496,773,11,7960,3363
1021,10937,9661,1276,1172,2547,1315,1331,1854,2718,3,22547,10940
1022,10254,7647,2607,2831,5919,537,452,340,175,0,23424,10254
1023,3665,3239,426,912,996,681,367,330,379,0,8273,3665
1024,865,525,340,97,161,149,106,93,259,32,3223,897
1025,2186,1837,349,408,367,319,220,393,479,7,5972,2193
1026,793,644,149,116,172,117,67,140,181,20,2334,813
1027,2465,2187,278,399,436,362,272,402,594,0,5981,2465
1028,3808,3446,362,733,611,472,473,672,847,8,9206,3816
1029,1326,898,428,198,233,231,156,186,322,0,3848,1326
1030,1350,1096,254,187,242,214,153,194,360,22,3128,1372
1031,1963,1498,465,287,270,303,267,286,550,0,4884,1963
1032,2935,2115,820,438,357,491,323,421,905,39,7638,2974
1033,2634,2118,516,361,380,343,512,330,708,161,6762,2795
1034,1065,897,168,116,167,125,228,105,324,171,2675,1236
1035,4543,3913,630,846,649,695,661,604,1088,115,10254,4658
1036,1002,836,166,154,160,161,128,131,268,0,2233,1002
1037,911,723,188,150,143,148,110,126,234,0,2229,911
1038,1599,1084,515,221,262,268,231,232,385,0,4917,1599
1039,7,5,2,5,1,0,0,1,0,0,17,7
1040,1383,1088,295,216,263,188,139,261,316,0,3766,1383
1041,5741,4699,1042,1016,1695,884,518,749,879,13,11891,5754
1042,898,705,193,118,239,118,96,134,193,0,2008,898
1043,12,11,1,5,2,2,0,3,0,0,0,12
1044,98,93,5,28,25,23,4,8,10,0,0,98
1045,0,0,0,0,0,0,0,0,0,0,0,0
1046,7353,7098,255,1385,1556,641,1157,1118,1496,25,14141,7378
1047,3524,3201,323,858,702,387,519,508,550,0,7971,3524
1048,24,20,4,5,4,3,2,5,5,4,64,28
1049,679,496,183,100,101,112,99,90,177,11,1962,690
1050,0,0,0,0,0,0,0,0,0,0,0,0
1051,3813,3206,607,432,913,441,538,647,842,0,8469,3813
1052,3831,3740,91,1486,1729,20,393,126,77,0,0,3831
1053,4,4,0,0,1,0,0,1,2,0,8,4
1054,2200,2135,65,559,284,209,367,335,446,0,0,2200
1055,1274,959,315,272,302,257,119,151,173,0,3687,1274
1056,188,110,78,30,59,10,45,27,17,0,718,188
1057,10736,9725,1011,2381,3469,1631,1100,1017,1138,0,24095,10736
1058,1637,1207,430,319,336,229,185,305,263,604,6025,2241
1059,199,136,63,25,42,29,23,38,42,0,643,199
1060,1949,1707,242,359,376,279,204,310,421,0,5326,1949
1061,1158,1003,155,168,236,168,103,231,252,0,3027,1158
1062,1235,1048,187,160,338,170,118,209,240,17,3201,1252
1063,1524,1378,146,245,237,223,136,315,368,27,3600,1551
1064,1482,1166,316,240,207,241,179,217,398,0,3730,1482
1065,1129,888,241,183,157,183,136,165,305,0,2842,1129
1066,0,0,0,0,0,0,0,0,0,0,0,0
1067,13,12,1,3,3,1,2,2,2,0,30,13
1068,3214,2919,295,782,640,353,473,463,503,0,7269,3214
1069,815,636,179,138,140,109,104,126,198,0,1813,815
1070,2915,2648,267,710,580,320,429,420,456,0,6593,2915
1071,1666,1370,296,246,457,210,181,244,328,0,4457,1666
1072,1515,1246,269,224,415,191,164,221,300,0,4053,1515
1073,1809,1574,235,182,203,220,245,245,714,0,4058,1809
1074,413,358,55,60,84,60,37,83,89,5,1079,418
1075,598,518,80,87,122,87,53,119,130,9,1564,607
1076,279,242,37,40,57,40,25,56,61,0,728,279
1077,4,3,1,1,2,0,0,0,1,0,8,4
1078,3002,2590,412,489,530,407,436,454,686,0,6236,3002
1079,281,228,53,41,61,41,24,49,65,0,826,281
1080,602,489,113,83,108,96,68,87,160,2,1395,604
1081,1742,1440,302,237,483,221,200,251,350,0,3866,1742
1082,347,236,111,43,74,50,40,67,73,0,1122,347
1083,190,129,61,24,40,27,22,37,40,0,613,190
1084,739,637,102,138,106,113,108,98,176,0,1667,739
1085,508,344,164,76,89,88,60,71,124,43,1474,551
1086,537,364,173,80,94,93,63,75,132,0,1560,537
1087,764,566,198,118,122,124,105,117,178,0,1990,764
1088,1659,1316,343,273,261,270,200,230,425,0,4061,1659
1089,783,621,162,129,123,128,94,109,200,0,1917,783
1090,603,447,156,94,97,98,82,93,139,13,1571,616
1091,912,723,189,150,143,149,110,126,234,0,2232,912
1092,222,198,24,38,30,38,33,28,55,0,468,222
1093,475,397,78,123,123,78,47,64,40,0,1286,475
1094,1452,1194,258,214,398,183,157,212,288,0,3885,1452
1095,4219,3876,343,960,453,340,758,753,955,13,9807,4232
1096,1919,1522,397,316,302,313,231,266,491,0,4696,1919
1097,505,450,55,87,69,86,75,64,124,4,1067,509
1098,2040,1817,223,350,278,347,305,257,503,0,4310,2040
1099,403,322,81,49,66,71,52,54,111,126,1024,529
1100,355,284,71,43,58,62,45,47,100,0,903,355
1101,720,575,145,88,118,127,92,96,199,0,1832,720
1102,520,434,86,80,83,84,66,68,139,0,1159,520
1103,279,219,60,45,39,45,34,41,75,0,702,279
1104,586,489,97,90,93,94,75,77,157,0,1306,586
1105,840,661,179,131,160,114,85,158,192,15,2286,855
1106,971,763,208,128,258,128,104,144,209,0,2172,971
1107,484,380,104,64,129,64,52,72,103,0,1082,484
1108,125,104,21,23,19,20,15,19,29,0,297,125
1109,1319,1049,270,197,177,219,195,171,360,7,3352,1326
1110,529,290,239,57,112,53,64,108,135,10,1819,539
1111,2722,2449,273,357,558,387,371,405,644,111,6071,2833
1112,15,15,0,4,1,2,1,5,2,0,32,15
1113,1208,1020,188,232,191,176,117,229,263,0,3230,1208
1114,1373,936,437,172,291,199,160,264,287,8,4436,1381
1115,401,315,86,65,56,65,48,59,108,0,1009,401
1116,0,0,0,0,0,0,0,0,0,0,0,0
1117,726,632,94,73,82,88,98,98,287,10,1628,736
1118,1276,1110,166,128,143,155,173,173,504,0,2863,1276
1119,2157,1641,516,334,271,244,292,398,618,11,5575,2168
1120,1015,666,349,82,183,109,139,188,314,0,3072,1015
1121,1074,757,317,57,255,142,204,123,293,0,3195,1074
1122,1431,986,445,76,350,203,257,154,391,7,4328,1438
1123,3079,2233,846,493,391,381,409,607,798,20,8765,3099
1124,697,580,117,101,149,97,104,89,157,0,1524,697
1125,2553,1944,609,306,548,348,430,297,624,0,6344,2553
1126,3167,2054,1113,376,652,455,446,447,791,13,8837,3180
1127,2100,1603,497,225,442,287,359,246,541,245,5094,2345
1128,7264,6278,986,1370,1336,1032,1258,706,1562,4,14289,7268
1129,3725,2977,748,466,837,525,567,497,833,0,8269,3725
1130,1392,1020,372,110,342,211,283,142,304,0,3878,1392
1131,2736,1893,843,284,634,399,478,291,650,18,7542,2754
1132,1336,902,434,164,287,168,265,146,306,0,3788,1336
1133,2263,1566,697,248,514,338,344,303,516,15,5864,2278
1134,2688,2062,626,291,455,282,377,493,790,87,6723,2775
1135,1977,1496,481,145,454,162,322,391,503,212,5112,2189
1136,1374,1048,326,91,357,123,206,250,347,0,3584,1374
1137,2697,2087,610,286,489,258,402,493,769,0,7240,2697
1138,3220,2826,394,525,397,420,437,556,885,150,6724,3370
1139,1088,845,243,136,179,115,144,216,298,129,2802,1217
1140,1187,956,231,180,187,175,151,224,270,0,2648,1187
1141,991,745,246,119,175,120,135,179,263,0,2657,991
1142,2576,2081,495,230,471,268,354,496,757,133,6537,2709
1143,1048,846,202,119,195,109,142,166,317,0,2639,1048
1144,1417,1117,300,164,223,137,198,274,421,34,3614,1451
1145,1993,1513,480,226,336,227,251,367,586,0,5442,1993
1146,1521,1093,428,143,266,132,218,277,485,0,4364,1521
1147,2026,1392,634,224,308,187,284,372,651,0,5846,2026
1148,2755,2138,617,250,469,267,401,495,873,325,7267,3080
1149,2224,1446,778,385,219,257,325,421,617,0,6488,2224
1150,1830,1205,625,144,339,202,274,344,527,0,5540,1830
1151,1589,1094,495,146,306,235,281,160,461,0,4584,1589
1152,2488,1759,729,260,470,357,468,270,663,0,6604,2488
1153,3247,2479,768,518,365,415,399,591,959,34,8454,3281
1154,2897,1983,914,302,503,268,410,501,913,42,8212,2939
1155,1625,1283,342,280,149,205,222,291,478,3,4144,1628
1156,3005,2712,293,459,528,410,273,566,769,185,6628,3190
1157,1773,1543,230,225,366,234,179,337,432,25,4280,1798
1158,1802,1628,174,233,373,267,176,326,427,0,4311,1802
1159,2938,2347,591,226,789,406,522,354,641,314,7643,3252
1160,3124,2320,804,399,614,407,598,332,774,0,7703,3124
1161,2382,1780,602,282,515,350,305,327,603,0,5517,2382
1162,1117,873,244,146,254,152,166,140,259,25,2461,1142
1163,2550,1641,909,356,519,347,387,336,605,0,7491,2550
1164,1922,1403,519,221,409,267,321,208,496,0,4922,1922
1165,1704,1210,494,219,339,216,285,227,418,13,4242,1717
1166,1621,1210,411,150,372,229,295,154,421,0,4244,1621
1167,1601,1249,352,175,296,207,297,191,435,14,3948,1615
1168,2373,1663,710,158,528,249,343,495,600,53,6579,2426
1169,1342,1140,202,208,172,181,174,231,376,1,2683,1343
1170,2130,1807,323,346,308,289,242,427,518,0,4923,2130
1171,1891,1420,471,171,332,196,282,370,540,7,5368,1898
1172,2144,1571,573,178,362,214,308,430,652,3,6058,2147
1173,1649,1267,382,267,247,238,191,308,398,24,3933,1673
1174,1978,1568,410,354,326,222,306,363,407,18,4776,1996
1175,3303,2522,781,283,785,374,491,613,757,280,8003,3583
1176,1416,1161,255,163,312,173,253,164,351,11,3378,1427
1177,1707,1455,252,244,342,251,148,337,385,35,4455,1742
1178,1756,1420,336,220,322,280,161,332,441,46,4829,1802
1179,2145,1552,593,245,499,303,424,196,478,14,5958,2159
1180,1349,908,441,83,363,137,190,261,315,0,3841,1349
1181,2491,2211,280,282,823,433,326,253,374,0,5863,2491
1182,991,595,396,116,200,102,142,193,238,63,3775,1054
1183,902,373,529,112,182,100,152,131,225,14,4110,916
1184,1093,628,465,57,283,202,179,111,261,70,4511,1163
1185,927,536,391,89,193,163,152,129,201,69,3883,996
1186,806,500,306,118,187,147,84,119,151,107,2661,913
1187,2135,1432,703,301,540,348,264,314,368,94,6234,2229
1188,304,284,20,49,74,45,42,40,54,86,741,390
1189,637,461,176,123,134,97,76,92,115,25,1648,662
1190,3437,2468,969,527,818,526,351,531,684,289,9292,3726
1191,1485,1303,182,186,373,155,196,224,351,0,2853,1485
1192,1209,1080,129,179,239,100,217,161,313,8,2624,1217
1193,2432,1859,573,302,579,276,347,335,593,46,6315,2478
1194,867,522,345,145,197,136,104,130,155,49,2716,916
1195,3251,2032,1219,382,848,397,405,528,691,34,9037,3285
1196,492,227,265,55,101,52,81,88,115,7,2285,499
1197,1276,767,509,182,310,184,166,163,271,94,4595,1370
1198,579,473,106,84,130,88,62,91,124,18,1234,597
1199,1948,1578,370,225,480,336,176,333,398,213,4589,2161
1200,3190,2649,541,439,911,349,413,444,634,0,7086,3190
1201,2629,2189,440,315,612,269,387,410,636,15,5966,2644
1202,611,496,115,72,134,64,107,85,149,3,1430,614
1203,2021,1652,369,230,415,231,404,240,501,22,4949,2043
1204,6596,5806,790,987,1242,748,844,1122,1653,29,13513,6625
1205,933,773,160,88,219,147,86,175,218,0,2306,933
1206,617,300,317,97,142,89,90,92,107,7,2478,624
1207,2550,1943,607,335,590,375,257,429,564,11,6280,2561
1208,2713,2046,667,295,572,349,368,415,714,53,7300,2766
1209,1892,1537,355,237,406,220,295,266,468,11,4838,1903
1210,1599,1356,243,207,334,219,217,241,381,158,3857,1757
1211,2415,1329,1086,316,629,384,294,324,468,0,8580,2415
1212,1372,574,798,124,379,242,153,223,251,0,5772,1372
1213,1063,484,579,81,292,168,195,85,242,88,4874,1151
1214,1295,1252,43,267,196,192,125,216,299,179,2833,1474
1215,560,454,106,66,123,59,98,78,136,13,1309,573
1216,975,736,239,176,222,123,125,145,184,74,2439,1049
1217,2625,1982,643,475,599,330,338,392,491,541,6567,3166
1218,989,512,477,162,242,150,102,158,175,0,3654,989
1219,510,430,80,102,112,51,85,74,86,0,1215,510
1220,2026,1706,320,407,445,204,339,293,338,0,4823,2026
1221,257,213,44,44,64,40,26,36,47,4162,612,4419
1222,109,99,10,15,25,19,9,17,24,99,247,208
1223,41033,36425,4608,4653,13549,7136,5363,4165,6167,0,96588,41033
1224,957,837,120,206,195,137,113,136,170,24,1829,981
1225,492,338,154,61,115,75,49,79,113,0,1428,492
1226,485,334,151,61,113,74,49,78,110,13,1410,498
1227,1159,1014,145,249,236,166,137,165,206,4,2216,1163
1228,1133,853,280,183,287,168,131,162,202,22,2988,1155
1229,2095,1582,513,379,478,263,269,313,393,1,5242,2096
1230,970,513,457,132,260,150,128,129,171,0,3434,970
1231,2043,1275,768,353,468,287,237,288,410,34,6265,2077
1232,457,306,151,65,116,74,56,67,79,0,1333,457
1233,761,630,131,72,178,120,70,143,178,0,1881,761
1234,1126,589,537,176,273,171,166,157,183,0,4106,1126
1235,298,154,144,49,73,45,31,48,52,296,1101,594
1236,3514,3152,362,706,717,560,451,492,588,59,7158,3573
1237,343,284,59,58,85,53,34,48,65,0,820,343
1238,326,236,90,63,69,49,39,47,59,30,845,356
1239,1516,1141,375,245,383,225,175,217,271,1,3997,1517
1240,1270,783,487,162,351,201,126,177,253,122,4195,1392
1241,787,594,193,142,180,99,101,117,148,388,1970,1175
1242,408,334,74,47,84,47,81,48,101,0,999,408
1243,1693,1623,70,220,371,184,246,299,373,1905,3895,3598
1244,527,427,100,62,116,55,92,73,129,0,1233,527
1245,425,345,80,50,93,44,75,59,104,0,994,425
1246,454,368,86,53,100,47,80,63,111,0,1061,454
1247,438,420,18,57,96,48,64,77,96,3,1009,441
1248,301,244,57,35,66,31,53,42,74,0,704,301
1249,418,193,225,46,86,45,69,75,97,3,1942,421
1250,592,484,108,86,133,90,64,93,126,0,1262,592
1251,441,303,138,55,103,68,44,70,101,0,1280,441
1252,322,300,22,52,78,48,45,43,56,559,783,881
1253,441,303,138,55,103,68,44,70,101,0,1280,441
1254,302,156,146,49,74,46,31,48,54,29,1115,331
1255,293,142,151,34,56,37,46,51,69,0,1147,293
1256,1761,1093,668,258,408,321,182,259,333,50,5816,1811
1257,147,47,100,19,31,19,20,25,33,8,634,155
1258,245,78,167,31,52,32,34,41,55,0,1054,245
1259,1752,1500,252,241,372,281,173,301,384,78,3695,1830
1260,172,89,83,28,42,26,18,28,30,0,634,172
1261,684,495,189,132,144,104,81,99,124,147,1771,831
1262,474,343,131,91,100,72,56,68,87,122,1227,596
1263,1050,760,290,202,222,159,125,152,190,0,2717,1050
1264,588,286,302,93,135,85,86,88,101,49,2360,637
1265,274,169,105,35,76,43,27,38,55,0,906,274
1266,459,283,176,59,127,73,46,64,90,0,1518,459
1267,674,390,284,82,160,108,76,104,144,25,2495,699
1268,640,204,436,82,136,83,89,108,142,0,2753,640
1269,1069,618,451,130,253,171,121,165,229,0,3957,1069
1270,393,325,68,37,92,62,36,74,92,0,971,393
1271,608,521,87,84,129,98,60,104,133,16,1283,624
1272,760,630,130,128,145,109,73,120,185,60,1770,820
1273,631,589,42,102,153,94,88,84,110,389,1537,1020
1274,450,301,149,77,105,72,49,64,83,0,1316,450
1275,355,331,24,58,86,53,49,47,62,30,864,385
1276,365,244,121,63,85,59,40,52,66,0,1067,365
1277,161,108,53,28,37,26,18,23,29,62,471,223
1278,1593,1199,394,258,403,236,184,228,284,342,4199,1935
1279,494,331,163,85,115,79,54,71,90,26,1445,520
1280,177,109,68,23,49,28,18,25,34,0,584,177
1281,603,424,179,87,175,74,64,97,106,0,1613,603
1282,401,212,189,55,107,62,53,53,71,125,1421,526
1283,984,693,291,143,285,120,104,158,174,0,2634,984
1284,452,405,47,91,92,72,58,63,76,0,921,452
1285,0,0,0,0,0,0,0,0,0,0,0,0
1286,1291,1158,133,259,263,206,166,181,216,175,2629,1466
1287,232,189,43,45,55,37,22,34,39,37,528,269
1288,765,576,189,124,193,113,88,110,137,8,2017,773
1289,1043,851,192,204,247,167,101,151,173,72,2379,1115
1290,492,401,91,96,117,79,48,71,81,1,1122,493
1291,201,164,37,39,48,32,19,29,34,0,458,201
1292,259,211,48,51,61,41,25,38,43,13,592,272
1293,2053,1918,135,404,431,326,235,304,353,24,3767,2077
1294,1017,950,67,200,214,162,116,151,174,110,1868,1127
1295,537,460,77,74,114,86,53,92,118,0,1132,537
1296,235,176,59,31,61,32,29,38,44,98,534,333
1297,436,361,75,74,83,63,42,69,105,56,1014,492
1298,170,98,72,21,40,27,19,26,37,0,628,170
1299,649,598,51,102,116,86,67,121,157,0,1559,649
1300,844,778,66,133,151,112,87,157,204,64,2026,908
1301,535,493,42,84,96,71,55,100,129,0,1285,535
1302,240,139,101,29,57,38,27,37,52,4,886,244
1303,781,380,401,89,150,99,124,135,184,15,3058,796
1304,459,423,36,72,82,61,47,85,112,0,1102,459
1305,534,516,18,110,81,79,52,89,123,1285,1167,1819
1306,2116,1878,238,240,699,368,277,215,317,0,4982,2116
1307,18515,16436,2079,2100,6114,3220,2420,1879,2782,0,43583,18515
1308,1904,1666,238,409,388,273,225,270,339,0,3641,1904
1309,10749,5950,4799,1751,1798,1807,1642,1648,2103,46,44674,10795
1310,5552,2776,2776,693,1076,776,924,696,1387,25,26694,5577
1311,1041,716,325,107,217,127,144,155,291,6,3361,1047
1312,1952,1052,900,235,438,228,289,328,434,35,7338,1987
1313,1747,863,884,208,355,209,275,293,407,161,6853,1908
1314,3254,1728,1526,274,633,456,465,534,892,67,11657,3321
1315,1054,568,486,53,232,156,146,172,295,43,4430,1097
1316,999,581,418,81,204,135,134,178,267,62,4014,1061
1317,861,499,362,52,186,111,143,140,229,20,3334,881
1318,1102,523,579,116,174,143,161,210,298,48,4239,1150
1319,1670,1047,623,210,327,218,221,282,412,13,5711,1683
1320,1432,839,593,168,212,188,149,253,462,28,5032,1460
1321,857,681,176,126,116,156,65,132,262,0,2115,857
1322,1696,1093,603,144,284,263,152,317,536,8,5751,1704
1323,553,345,208,56,85,85,55,96,176,0,1812,553
1324,712,409,303,83,99,111,81,107,231,0,2506,712
1325,1161,588,573,131,147,142,162,225,354,14,4299,1175
1326,1267,789,478,132,184,172,138,237,404,10,4169,1277
1327,1002,605,397,150,167,137,124,161,263,17,3559,1019
1328,1665,1061,604,215,282,259,181,260,468,10,5609,1675
1329,199,147,52,28,48,25,24,27,47,0,530,199
1330,4318,3351,967,674,1650,510,541,405,538,0,11526,4318
1331,1796,1028,768,324,350,298,265,227,332,256,6654,2052
1332,1225,752,473,109,248,156,167,188,357,0,4323,1225
1333,3869,3511,358,452,726,622,420,709,940,8,8384,3877
1334,1146,654,492,80,217,193,166,180,310,56,4423,1202
1335,911,320,591,107,168,133,140,145,218,7,4730,918
1336,652,296,356,105,120,88,91,92,156,10,2942,662
1337,1357,450,907,138,278,174,261,187,319,6,7328,1363
1338,357,100,257,46,69,49,49,64,80,13,2017,370
1339,849,385,464,61,200,127,94,154,213,0,3930,849
1340,1118,556,562,80,277,187,150,183,241,0,4924,1118
1341,1658,827,831,279,319,297,227,210,326,13,6990,1671
1342,252,134,118,32,62,43,31,38,46,0,981,252
1343,1822,1319,503,203,388,288,243,288,412,34,5901,1856
1344,1309,654,655,211,259,230,171,167,271,0,5641,1309
1345,2014,1447,567,170,430,282,334,316,482,28,6319,2042
1346,507,352,155,55,124,74,47,77,130,0,1508,507
1347,1209,729,480,162,204,182,133,221,307,36,4303,1245
1348,795,512,283,108,131,113,72,148,223,39,2687,834
1349,1663,815,848,134,314,211,236,267,501,0,6361,1663
1350,1492,911,581,156,314,216,186,239,381,24,4983,1516
1351,3782,2134,1648,343,726,428,567,678,1040,34,12889,3816
1352,1115,401,714,182,189,157,169,176,242,14,5646,1129
1353,1206,479,727,105,264,209,117,211,300,78,5871,1284
1354,1218,560,658,134,307,214,124,185,254,27,5380,1245
1355,219,130,89,39,37,38,26,34,45,3,807,222
1356,839,308,531,126,135,130,125,128,195,0,3908,839
1357,2454,1762,692,524,398,465,273,329,465,0,7069,2454
1358,245,145,100,43,47,36,32,36,51,0,889,245
1359,2147,1434,713,210,458,327,304,306,542,231,7247,2378
1360,1191,745,446,123,250,145,225,181,267,18,3870,1209
1361,2292,1419,873,217,522,399,299,354,501,59,8375,2351
1362,1585,833,752,161,352,267,176,251,378,0,6319,1585
1363,966,544,422,95,220,160,105,161,225,460,3725,1426
1364,1272,644,628,115,308,187,163,206,293,7,5269,1279
1365,1555,1234,321,174,270,217,223,265,406,34,4383,1589
1366,1422,1078,344,140,291,188,207,207,389,24,4257,1446
1367,1393,1070,323,155,261,200,211,225,341,4,4073,1397
1368,442,299,143,43,98,60,51,76,114,0,1233,442
1369,1943,1183,760,232,308,282,203,365,553,25,6404,1968
1370,699,438,261,78,120,100,86,120,195,17,2389,716
1371,1176,593,583,120,195,166,118,240,337,0,4374,1176
1372,1433,891,542,150,242,204,129,266,442,4,4720,1437
1373,1190,733,457,109,221,172,123,197,368,8,4136,1198
1374,2160,1602,558,267,459,353,223,327,531,0,5966,2160
1375,1002,679,323,96,223,137,115,173,258,0,2792,1002
1376,342,223,119,43,67,52,49,57,74,0,1069,342
1377,175,111,64,28,47,24,20,23,33,10,593,185
1378,610,304,306,102,118,109,83,77,121,99,2570,709
1379,163,84,79,25,34,28,17,25,34,17,590,180
1380,157,80,77,24,33,27,16,24,33,0,567,157
1381,1056,715,341,102,235,144,121,182,272,0,2942,1056
1382,652,403,249,74,105,96,85,116,176,20,2337,672
1383,1819,1232,587,175,405,248,208,313,470,0,5071,1819
1384,481,289,192,45,77,69,67,82,141,0,1729,481
1385,6244,4845,1399,974,2386,737,783,586,778,0,16667,6244
1386,598,354,244,107,102,105,72,92,120,0,2200,598
1387,3008,1542,1466,468,633,518,314,453,622,0,10863,3008
1388,635,376,259,112,122,93,84,92,132,10,2307,645
1389,805,427,378,103,199,138,99,122,144,109,3135,914
1390,469,278,191,84,80,82,57,72,94,0,1725,469
1391,258,137,121,33,64,44,32,39,46,0,1007,258
1392,858,586,272,138,176,153,104,125,162,35,2817,893
1393,774,528,246,124,159,138,93,112,148,122,2539,896
1394,663,414,249,67,102,101,65,115,213,15,2176,678
1395,671,404,267,62,107,97,94,115,196,13,2410,684
1396,453,310,143,64,95,80,49,73,92,35,1526,488
1397,4837,3311,1526,687,1020,856,519,775,980,0,16306,4837
1398,1055,800,255,114,208,151,67,157,358,175,3290,1230
1399,527,325,202,59,84,77,68,94,145,18,1886,545
1400,235,147,88,26,40,34,29,40,66,0,802,235
1401,3267,2074,1193,515,883,439,370,437,623,0,11068,3267
1402,424,265,159,47,73,61,52,73,118,12,1450,436
1403,353,239,114,34,79,48,40,61,91,60,985,413
1404,2040,1418,622,223,500,297,190,309,521,1,6069,2041
1405,533,338,195,84,144,72,60,71,102,8,1806,541
1406,801,548,253,114,169,142,86,128,162,7,2700,808
1407,322,210,112,41,64,48,46,54,69,0,1004,322
1408,970,674,296,106,238,141,91,147,247,0,2886,970
1409,132,97,35,18,32,17,16,18,31,0,353,132
1410,4551,3532,1019,710,1739,537,571,427,567,0,12148,4551
1411,2862,1913,949,329,573,454,305,469,732,45,8168,2907
1412,1294,941,353,111,275,195,184,204,325,0,3782,1294
1413,2628,1791,837,299,542,352,552,237,646,0,7801,2628
1414,3608,2668,940,398,755,633,430,572,820,57,9225,3665
1415,1690,1118,572,176,318,227,332,187,450,11,5175,1701
1416,2048,1543,505,222,350,303,357,300,516,31,5741,2079
1417,1601,926,675,204,384,209,249,244,311,0,5110,1601
1418,1175,901,274,106,238,199,198,166,268,0,3304,1175
1419,1004,791,213,89,207,189,142,113,264,0,2827,1004
1420,1403,1029,374,127,279,211,284,153,349,13,4076,1416
1421,3419,2227,1192,274,820,430,433,625,837,38,10278,3457
1422,1656,1094,562,147,336,272,204,274,423,43,5123,1699
1423,740,358,382,98,150,88,103,135,166,1,2757,741
1424,2116,1360,756,139,546,224,290,422,495,32,6221,2148
1425,1830,1099,731,179,358,230,237,290,536,11,5202,1841
1426,1555,1059,496,132,366,197,206,274,380,0,4273,1555
1427,520,351,169,49,115,86,58,90,122,23,1534,543
1428,998,664,334,99,199,170,143,165,222,0,2985,998
1429,461,266,195,38,86,75,64,87,111,11,1492,472
1430,1756,1199,557,189,396,313,212,276,370,42,5241,1798
1431,1337,868,469,156,275,161,205,208,332,0,4015,1337
1432,1749,1176,573,179,325,303,224,287,431,41,5229,1790
1433,3813,2900,913,482,923,514,784,357,753,88,9681,3901
1434,1481,824,657,172,263,204,243,262,337,20,5314,1501
1435,721,506,215,60,137,122,72,137,193,0,2151,721
1436,1642,1129,513,138,385,162,238,321,398,35,4465,1677
1437,866,587,279,67,208,123,95,174,199,18,2731,884
1438,3909,2952,957,501,914,731,430,567,766,0,10064,3909
1439,1652,1082,570,142,366,319,189,282,354,23,4714,1675
1440,934,583,351,97,178,144,122,162,231,0,2890,934
1441,1316,819,497,116,256,200,168,224,352,11,4087,1327
1442,1606,1095,511,131,381,196,227,288,383,25,4332,1631
1443,2145,1631,514,224,512,237,325,400,447,7,5308,2152
1444,1245,982,263,184,218,210,135,224,274,198,3175,1443
1445,1294,940,354,78,349,110,228,225,304,113,3639,1407
1446,2317,1642,675,159,554,237,340,425,602,38,6323,2355
1447,2298,1748,550,265,583,302,300,393,455,11,5555,2309
1448,1750,1211,539,112,446,192,269,327,404,0,4884,1750
1449,813,470,343,103,195,106,127,124,158,13,2597,826
1450,388,224,164,49,93,51,60,59,76,1,1238,389
1451,639,370,269,81,153,83,100,98,124,0,2041,639
1452,325,228,97,27,62,55,32,62,87,10,969,335
1453,1521,736,785,202,309,180,212,277,341,24,5666,1545
1454,6453,4405,2048,693,1456,1150,781,1016,1357,0,19263,6453
1455,375,278,97,31,68,49,48,70,109,17,968,392
1456,1681,1244,437,140,306,220,214,312,489,0,4337,1681
1457,1948,1133,815,177,372,205,286,338,570,41,6404,1989
1458,538,310,228,45,100,88,75,102,128,11,1745,549
1459,468,316,152,44,104,77,52,81,110,0,1381,468
1460,587,396,191,55,130,97,65,101,139,34,1732,621
1461,1110,727,383,95,246,215,127,189,238,25,3167,1135
1462,613,414,199,57,136,101,68,106,145,9,1809,622
1463,874,647,227,73,159,115,111,162,254,67,2254,941
1464,540,300,240,63,96,74,88,96,123,11,1939,551
1465,648,454,194,54,123,109,64,123,175,0,1932,648
1466,464,303,161,43,100,60,55,87,119,22,1388,486
1467,790,517,273,72,170,102,94,147,205,25,2362,815
1468,237,155,82,22,51,31,28,44,61,30,709,267
1469,1269,903,366,159,274,136,180,186,334,13,3486,1282
1470,2174,1206,968,268,456,275,309,363,503,147,7419,2321
1471,498,306,192,63,82,71,69,81,132,144,1520,642
1472,1488,995,493,145,354,163,196,258,372,11,4428,1499
1473,1256,966,290,146,224,137,171,217,361,0,3418,1256
1474,2882,1893,989,251,640,310,446,478,757,67,8805,2949
1475,236,158,78,27,43,30,36,41,59,10,769,246
1476,2619,1515,1104,252,607,303,486,377,594,0,8183,2619
1477,1147,650,497,121,219,180,157,213,257,430,4101,1577
1478,3337,2137,1200,420,708,453,493,545,718,40,10022,3377
1479,983,602,381,119,122,122,134,170,316,0,3095,983
1480,1612,1090,522,181,320,204,227,256,424,0,4696,1612
1481,902,634,268,103,168,119,139,155,218,21,2835,923
1482,551,381,170,75,114,63,86,92,121,7,1679,558
1483,451,349,102,57,51,41,45,84,173,55,1190,506
1484,1255,784,471,167,271,135,173,203,306,0,3687,1255
1485,638,414,224,74,121,88,85,112,158,0,1959,638
1486,1043,652,391,138,225,113,144,169,254,48,3064,1091
1487,315,197,118,42,68,34,43,51,77,12,924,327
1488,238,154,84,28,45,33,32,42,58,18,730,256
1489,896,581,315,104,170,123,119,158,222,0,2750,896
1490,775,503,272,90,147,106,103,136,193,51,2378,826
1491,770,542,228,88,144,102,118,132,186,179,2419,949
1492,2874,1795,1079,381,620,310,397,466,700,0,8441,2874
1493,126,55,71,17,23,20,17,22,27,167,492,293
1494,569,364,205,72,121,77,84,93,122,6,1708,575
1495,298,130,168,41,55,47,40,53,62,36,1165,334
1496,123,54,69,17,23,19,16,22,26,0,480,123
1497,440,193,247,60,82,70,59,78,91,34,1718,474
1498,631,386,245,77,78,78,86,109,203,18,1988,649
1499,1308,873,435,148,240,168,197,226,329,8,4256,1316
1500,1183,841,342,148,256,126,168,174,311,0,3249,1183
1501,321,208,113,37,61,44,43,57,79,51,984,372
1502,2096,918,1178,285,389,331,279,371,441,64,8184,2160
1503,532,367,165,73,110,61,83,89,116,13,1620,545
1504,796,516,280,93,151,109,106,140,197,200,2442,996
1505,523,296,227,55,100,82,71,97,118,137,1868,660
1506,783,541,242,107,162,90,122,131,171,28,2386,811
1507,196,86,110,27,36,31,26,35,41,20,766,216
1508,573,396,177,78,118,66,90,96,125,0,1747,573
1509,580,483,97,84,124,80,86,74,132,105,1269,685
1510,793,660,133,114,170,110,118,101,180,0,1733,793
1511,384,320,64,55,82,53,57,49,88,0,839,384
1512,3449,2697,752,449,785,469,511,434,801,0,7598,3449
1513,81,66,15,9,18,10,14,9,21,0,193,81
1514,64,52,12,7,14,8,11,7,17,0,153,64
1515,77,63,14,9,17,9,14,9,19,0,183,77
1516,3,3,0,1,1,0,0,1,0,0,0,3
1517,3562,3235,327,867,709,391,525,513,557,0,8056,3562
1518,37,19,18,6,9,6,4,6,6,1,137,38
1519,1352,1183,169,290,276,194,160,192,240,1,2584,1353
1520,5,5,0,1,1,1,0,1,1,4,12,9
1521,1315,984,331,171,339,179,161,213,252,130,2983,1445
1522,211,191,20,30,49,37,18,33,44,6,476,217
1523,2105,1721,384,305,474,319,227,332,448,13,4489,2118
1524,545,446,99,79,123,83,59,86,115,0,1163,545
1525,0,0,0,0,0,0,0,0,0,0,0,0
1526,603,493,110,87,136,91,65,95,129,0,1286,603
1527,1269,936,333,177,307,163,156,172,294,0,3390,1269
1528,1180,871,309,164,285,151,145,160,275,0,3152,1180
1529,1673,1062,611,264,452,225,190,224,318,0,5666,1673
1530,2867,2312,555,1052,1092,246,217,132,128,1,6288,2868
1531,1636,1286,350,136,234,174,251,307,534,0,3347,1636
1532,622,418,204,49,110,66,89,110,198,11,1742,633
1533,102,64,38,8,16,9,17,21,31,0,302,102
1534,277,174,103,21,44,25,47,58,82,18,819,295
1535,1479,985,494,80,124,140,183,268,684,84,4058,1563
1536,982,592,390,47,93,79,117,189,457,18,2798,1000
1537,5,3,2,0,0,0,1,1,3,0,14,5
1538,282,167,115,14,27,25,33,50,133,0,845,282
1539,858,508,350,42,82,75,100,153,406,0,2572,858
1540,1579,1061,518,76,139,154,202,283,725,0,4293,1579
1541,4633,3430,1203,356,676,361,563,694,1983,0,12722,4633
1542,2631,1790,841,191,349,255,423,425,988,15,7012,2646
1543,1247,947,300,77,120,121,161,215,553,0,3100,1247
1544,1147,753,394,43,89,91,129,192,603,18,3357,1165
1545,403,259,144,31,53,36,57,79,147,18,1141,421
1546,935,594,341,55,88,90,103,167,432,36,2820,971
1547,992,783,209,59,79,83,99,188,484,0,2542,992
1548,368,256,112,21,32,36,40,70,169,15,976,383
1549,1038,835,203,70,93,98,106,187,484,164,2248,1202
1550,2656,1831,825,180,241,232,327,487,1189,0,7351,2656
1551,0,0,0,0,0,0,0,0,0,0,0,0
1552,274,174,100,21,51,32,41,49,80,4,774,278
1553,1010,712,298,72,143,102,144,180,369,0,2609,1010
1554,287,218,69,17,30,25,35,47,133,0,744,287
1555,638,449,189,48,80,67,92,110,241,17,1686,655
1556,522,394,128,29,52,54,63,92,232,5,1361,527
1557,335,210,125,23,46,29,44,61,132,0,975,335
1558,856,538,318,58,119,75,113,155,336,0,2489,856
1559,2436,1629,807,135,248,248,283,426,1096,20,6226,2456
1560,275,170,105,26,42,23,32,44,108,13,760,288
1561,1020,678,342,55,101,91,103,191,479,199,2847,1219
1562,1069,680,389,62,101,103,118,191,494,7,3227,1076
1563,88,54,34,8,14,7,10,14,35,0,243,88
1564,870,660,210,50,90,75,106,144,405,0,2251,870
1565,1008,735,273,50,94,94,113,184,473,16,2551,1024
1566,3957,2783,1174,300,495,418,573,682,1489,0,10452,3957
1567,441,330,111,24,37,41,46,84,209,0,1118,441
1568,271,204,67,15,27,28,33,48,120,16,707,287
1569,433,302,131,31,42,39,48,81,192,42,1068,475
1570,492,331,161,39,87,52,70,87,157,26,1378,518
1571,342,223,119,24,35,35,42,61,145,0,922,342
1572,656,478,178,32,61,61,74,120,308,15,1658,671
1573,1206,970,236,82,108,114,123,217,562,0,2614,1206
1574,5226,4610,616,771,1308,354,594,587,1612,0,13350,5226
1575,462,346,116,26,38,43,49,88,218,195,1173,657
1576,1610,1035,575,123,213,143,230,315,586,0,4558,1610
1577,25,16,9,2,3,2,3,5,10,0,73,25
1578,1194,750,444,80,165,105,157,216,471,0,3473,1194
1579,736,444,292,35,70,60,87,142,342,0,2098,736
1580,389,313,76,26,35,37,40,70,181,0,843,389
1581,373,237,136,22,35,36,41,67,172,0,1126,373
1582,3333,2170,1163,229,343,343,408,594,1416,0,8974,3333
1583,1083,641,442,53,104,94,126,193,513,0,3249,1083
1584,1870,1546,324,146,191,202,186,314,831,0,4153,1870
1585,255,177,78,15,22,25,28,48,117,0,677,255
1586,8,7,1,1,2,1,1,1,2,0,19,8
1587,269,189,80,20,34,28,39,46,102,0,711,269
1588,1383,963,420,98,133,124,154,259,615,0,3411,1383
1589,592,467,125,35,47,49,59,112,290,36,1517,628
1590,935,773,162,73,96,101,93,157,415,165,2075,1100
1591,1439,1269,170,212,360,97,163,162,445,0,3676,1439
1592,310,184,126,15,30,27,36,55,147,0,931,310
1593,839,564,275,40,74,82,107,150,386,85,2280,924
1594,266,179,87,13,23,26,34,48,122,0,723,266
1595,441,277,164,30,61,39,58,80,173,133,1284,574
1596,2392,1477,915,223,368,200,279,386,936,0,6609,2392
1597,150,93,57,14,23,13,18,24,58,0,413,150
1598,584,412,172,42,83,59,83,104,213,0,1507,584
1599,629,443,186,45,89,64,90,112,229,11,1625,640
1600,5914,4024,1890,430,785,574,951,956,2218,0,15762,5914
1601,0,0,0,0,0,0,0,0,0,0,0,0
1602,280,178,102,16,26,27,31,50,130,0,845,280
1603,239,166,73,14,21,23,26,45,110,9,633,248
1604,835,525,310,65,132,76,141,175,246,20,2469,855
1605,388,293,95,21,38,40,47,69,173,0,1011,388
1606,903,573,330,70,169,105,136,161,262,38,2548,941
1607,657,428,229,45,68,68,80,117,279,0,1768,657
1608,521,390,131,29,43,48,55,99,247,0,1323,521
1609,354,247,107,25,34,32,39,66,158,95,875,449
1610,2913,1959,954,231,514,309,415,515,929,45,8159,2958
1611,1273,886,387,74,112,123,138,241,585,22,3373,1295
1612,983,728,255,76,144,77,120,147,419,0,2698,983
1613,18,16,2,3,5,1,2,2,5,0,46,18
1614,0,0,0,0,0,0,0,0,0,0,0,0
1615,413,262,151,32,77,48,62,74,120,11,1165,424
1616,213,150,63,15,30,22,30,38,78,0,550,213
1617,2903,1898,1005,451,487,483,364,416,702,0,8385,2903
1618,656,386,270,65,123,101,87,97,183,83,2414,739
1619,443,330,113,60,84,75,50,74,100,0,1163,443
1620,887,633,254,99,194,150,120,119,205,17,2612,904
1621,777,432,345,92,143,98,115,130,199,7,2650,784
1622,414,256,158,54,68,50,60,66,116,15,1400,429
1623,2431,1836,595,414,526,416,286,349,440,0,6209,2431
1624,448,285,163,50,108,61,67,69,93,10,1416,458
1625,564,395,169,78,111,91,58,98,128,37,1635,601
1626,830,549,281,100,177,125,130,122,176,25,2471,855
1627,1092,690,402,129,253,151,151,153,255,16,3421,1108
1628,1165,690,475,110,254,149,165,190,297,0,3804,1165
1629,2228,1605,623,287,396,356,257,363,569,8,6348,2236
1630,1227,685,542,86,182,146,142,192,479,20,4231,1247
1631,124,87,37,18,29,19,17,18,23,0,338,124
1632,831,508,323,84,144,110,69,137,287,15,2580,846
1633,594,386,208,58,107,96,64,112,157,0,1824,594
1634,581,392,189,61,113,91,59,98,159,0,1829,581
1635,1646,1034,612,227,395,222,206,264,332,349,5233,1995
1636,839,637,202,87,154,128,86,152,232,11,2223,850
1637,1659,1100,559,180,381,246,225,253,374,27,5000,1686
1638,1162,729,433,114,195,181,119,213,340,98,3624,1260
1639,1138,621,517,83,210,149,145,185,366,106,3732,1244
1640,1123,716,407,106,202,148,151,203,313,0,3437,1123
1641,452,321,131,40,49,61,55,74,173,0,1309,452
1642,1634,878,756,142,213,182,173,273,651,45,5535,1679
1643,1739,960,779,153,231,194,192,292,677,64,5776,1803
1644,3484,2416,1068,413,533,485,425,575,1053,17,10115,3501
1645,1114,666,448,105,151,129,122,190,417,77,3709,1191
1646,603,468,135,76,77,74,77,87,212,87,1560,690
1647,1383,1015,368,185,229,210,159,267,333,99,3467,1482
1648,2015,1384,631,209,376,300,237,337,556,31,5929,2046
1649,1384,931,453,141,268,210,159,219,387,22,4123,1406
1650,1541,947,594,199,292,232,206,255,357,22,4961,1563
1651,1179,792,387,125,281,145,160,205,263,32,3676,1211
1652,320,155,165,26,54,38,41,57,104,0,1182,320
1653,249,147,102,25,47,38,33,37,69,28,916,277
1654,875,658,217,83,84,97,104,116,391,0,2175,875
1655,724,592,132,115,115,49,82,148,215,1,1821,725
1656,704,539,165,105,158,85,95,114,147,0,1759,704
1657,263,157,106,22,43,34,31,49,84,0,831,263
1658,424,297,127,62,101,65,58,62,76,0,1159,424
1659,726,459,267,85,168,100,101,102,170,16,2276,742
1660,593,341,252,50,73,65,58,97,250,0,1929,593
1661,730,390,340,65,153,87,93,125,207,11,2584,741
1662,1049,837,212,164,241,181,107,148,208,10,2768,1059
1663,380,219,161,32,47,42,37,62,160,7,1237,387
1664,249,182,67,33,53,40,26,42,55,0,704,249
1665,666,437,229,87,141,105,91,104,138,9,1884,675
1666,408,283,125,56,65,49,49,69,120,31,1180,439
1667,1799,1261,538,264,427,275,246,265,322,57,4917,1856
1668,2632,1845,787,386,625,402,360,387,472,141,7195,2773
1669,468,227,241,38,78,56,61,83,152,0,1732,468
1670,102,58,44,8,15,12,11,17,39,1,363,103
1671,271,154,117,21,40,31,30,45,104,39,966,310
1672,297,168,129,23,44,34,33,49,114,44,1060,341
1673,4497,2970,1527,476,724,632,536,711,1418,0,13280,4497
1674,5121,3382,1739,542,825,720,610,810,1614,0,15122,5121
1675,308,184,124,26,51,40,37,57,97,0,974,308
1676,355,233,122,47,75,56,48,55,74,11,1006,366
1677,759,437,322,64,94,84,74,124,319,18,2469,777
1678,782,583,199,106,148,133,88,131,176,49,2055,831
1679,394,235,159,33,65,51,47,73,125,6,1242,400
1680,1077,766,311,96,116,146,131,177,411,15,3121,1092
1681,529,327,202,69,87,64,77,84,148,7,1786,536
1682,741,543,198,100,157,120,77,126,161,30,2094,771
1683,502,285,217,39,75,57,56,83,192,0,1790,502
1684,7,5,2,1,1,1,1,1,2,60,20,67
1685,632,443,189,87,124,102,65,109,145,0,1834,632
1686,213,156,57,29,45,35,22,36,46,0,601,213
1687,3962,3216,746,538,806,655,424,645,894,0,9656,3962
1688,849,689,160,115,173,140,91,138,192,0,2070,849
1689,1288,1045,243,175,262,213,138,210,290,0,3138,1288
1690,684,555,129,93,139,113,73,111,155,0,1667,684
1691,159,110,49,22,25,19,19,27,47,19,461,178
1692,230,117,113,20,42,26,30,35,77,0,795,230
1693,318,177,141,38,50,38,44,52,96,0,1115,318
1694,342,244,98,38,75,58,46,46,79,18,1007,360
1695,2736,2221,515,372,557,453,293,446,615,0,6668,2736
1696,1360,1104,256,185,277,225,146,222,305,0,3315,1360
1697,680,449,231,72,110,96,81,108,213,0,2008,680
1698,647,427,220,68,104,91,77,102,205,30,1910,677
1699,281,109,172,28,57,34,46,43,73,23,1131,304
1700,785,593,192,134,170,134,92,113,142,4,2004,789
1701,778,506,272,75,140,126,83,146,208,0,2388,778
1702,431,302,129,68,85,66,48,70,94,136,1150,567
1703,838,588,250,131,165,129,94,135,184,12,2235,850
1704,473,332,141,74,93,73,53,76,104,0,1260,473
1705,337,258,79,50,76,41,46,55,69,0,842,337
1706,511,345,166,54,100,80,52,86,139,0,1608,511
1707,1496,938,558,147,251,233,153,274,438,0,4668,1496
1708,451,251,200,53,71,54,62,74,137,7,1581,458
1709,191,132,59,26,30,23,23,32,57,17,552,208
1710,305,188,117,40,50,37,44,49,85,13,1030,318
1711,318,123,195,32,64,38,52,48,84,0,1281,318
1712,279,137,142,29,58,42,38,48,64,30,1040,309
1713,593,416,177,93,117,91,66,96,130,0,1580,593
1714,703,493,210,97,138,113,72,122,161,183,2038,886
1715,519,364,155,81,102,80,58,84,114,8,1382,527
1716,918,644,274,144,181,141,102,148,202,11,2447,929
1717,391,274,117,54,77,63,40,68,89,0,1135,391
1718,472,296,176,46,79,74,48,86,139,0,1472,472
1719,639,454,185,57,69,86,78,105,244,7,1852,646
1720,286,154,132,25,37,32,30,48,114,0,968,286
1721,361,194,167,31,47,40,38,60,145,11,1223,372
1722,332,211,121,37,80,45,49,51,70,0,1048,332
1723,356,276,80,45,45,44,45,52,125,4,919,360
1724,120,72,48,11,16,14,13,21,45,18,398,138
1725,304,217,87,34,66,51,41,41,71,8,896,312
1726,298,194,104,41,64,44,36,45,68,0,878,298
1727,1295,992,303,193,291,157,175,210,269,481,3236,1776
1728,965,719,246,131,182,164,109,161,218,1,2537,966
1729,373,191,182,33,68,42,49,57,124,0,1285,373
1730,471,330,141,69,112,72,64,69,85,0,1288,471
1731,96,63,33,15,16,16,12,14,23,0,277,96
1732,411,262,149,46,99,56,61,63,86,0,1299,411
1733,397,253,144,45,96,54,59,61,82,0,1255,397
1734,446,301,145,47,87,70,45,75,122,0,1406,446
1735,645,317,328,67,134,96,88,111,149,19,2406,664
1736,786,437,349,94,144,99,116,132,201,7,2683,793
1737,237,164,73,33,38,29,29,40,68,0,686,237
1738,309,119,190,31,63,37,51,47,80,13,1242,322
1739,298,115,183,30,60,36,49,45,78,0,1198,298
1740,619,403,216,85,134,91,74,94,141,27,1827,646
1741,180,117,63,25,39,26,22,27,41,19,532,199
1742,839,546,293,115,182,124,101,128,189,0,2477,839
1743,400,222,178,47,63,48,55,66,121,25,1404,425
1744,391,234,157,33,64,50,46,72,126,7,1234,398
1745,730,535,195,98,154,119,76,124,159,4,2065,734
1746,0,0,0,0,0,0,0,0,0,0,0,0
1747,557,364,193,86,93,93,70,80,135,0,1609,557
1748,417,236,181,32,62,47,47,69,160,0,1486,417
1749,584,386,198,62,94,82,70,92,184,22,1724,606
1750,297,196,101,31,48,42,35,47,94,14,876,311
1751,81,66,15,11,16,13,9,13,19,7,198,88
1752,670,470,200,98,159,102,92,99,120,0,1831,670
1753,20,12,8,2,4,2,2,3,7,0,56,20
1754,865,540,325,81,156,103,93,149,283,0,2496,865
1755,190,119,71,18,34,23,20,33,62,0,550,190
1756,326,204,122,31,59,39,35,56,106,4,942,330
1757,457,308,149,48,89,71,47,77,125,0,1440,457
1758,875,739,136,77,118,82,86,114,398,4,2295,879
1759,857,689,168,65,84,106,85,131,386,0,2337,857
1760,316,210,106,24,35,42,34,44,137,3,945,319
1761,1115,761,354,62,107,128,120,195,503,178,3148,1293
1762,2706,1981,725,140,276,300,281,450,1259,28,7432,2734
1763,2121,1560,561,112,181,248,216,355,1009,150,5717,2271
1764,688,541,147,58,45,72,52,111,350,0,1823,688
1765,836,550,286,51,90,101,71,143,380,0,2169,836
1766,1086,844,242,57,95,120,93,212,509,20,2910,1106
1767,1453,1101,352,91,143,152,148,241,678,10,3933,1463
1768,1216,801,415,98,169,170,153,179,447,503,3667,1719
1769,1363,884,479,59,167,168,152,231,586,27,4374,1390
1770,1228,871,357,65,98,155,120,218,572,38,3748,1266
1771,1336,966,370,87,141,189,128,233,558,6,3921,1342
1772,743,588,155,68,65,89,86,121,314,39,1839,782
1773,814,673,141,52,80,91,65,137,389,21,2063,835
1774,1252,860,392,217,402,178,172,123,160,13,3456,1265
1775,497,302,195,49,92,73,56,65,162,24,1685,521
1776,661,461,200,68,104,93,83,100,213,7,2134,668
1777,723,497,226,89,280,98,89,80,87,8,2572,731
1778,184,85,99,23,61,26,22,21,31,0,687,184
1779,692,523,169,63,73,80,86,112,278,31,2004,723
1780,946,598,348,107,286,136,133,107,177,14,3469,960
1781,527,384,143,47,87,66,80,83,164,10,1625,537
1782,509,376,133,32,42,59,45,98,233,0,1387,509
1783,1090,810,280,95,110,124,117,161,483,10,2757,1100
1784,761,646,115,58,84,95,80,118,326,1,1799,762
1785,1265,1081,184,92,139,150,121,185,578,11,3195,1276
1786,858,695,163,72,108,111,90,133,344,0,1935,858
1787,1058,795,263,68,121,117,102,158,492,7,3235,1065
1788,920,710,210,40,94,95,134,144,413,14,2813,934
1789,609,464,145,42,54,69,56,102,286,0,1715,609
1790,588,392,196,40,69,83,56,102,238,11,1654,599
1791,1977,1399,578,190,320,265,242,296,664,53,5575,2030
1792,1396,1295,101,96,143,160,151,238,608,1533,3518,2929
1793,303,216,87,19,37,41,31,46,129,0,769,303
1794,721,516,205,47,94,99,62,121,298,18,2188,739
1795,1246,968,278,104,87,165,104,231,555,7,3726,1253
1796,565,417,148,92,161,71,78,64,99,0,1473,565
1797,342,204,138,49,107,47,42,39,58,0,1124,342
1798,732,555,177,98,136,116,99,99,184,33,2033,765
1799,817,631,186,97,122,124,95,117,262,94,2234,911
1800,605,298,307,73,218,105,72,63,74,167,2288,772
1801,617,416,201,87,206,62,97,65,100,298,2006,915
1802,1296,814,482,102,146,144,152,209,543,52,4508,1348
1803,795,440,355,63,121,113,116,135,247,59,3235,854
1804,248,188,60,16,27,28,24,38,115,0,599,248
1805,578,346,232,42,79,72,68,88,229,14,1671,592
1806,281,230,51,29,26,33,25,50,118,79,631,360
1807,265,205,60,23,40,33,27,36,106,0,737,265
1808,176,148,28,15,22,21,19,26,73,0,392,176
1809,171,132,39,15,26,21,17,24,68,0,475,171
1810,426,346,80,36,49,45,45,59,192,0,1019,426
1811,484,361,123,86,145,72,55,63,63,9,1427,493
1812,285,190,95,20,34,40,27,49,115,0,802,285
1813,364,293,71,28,36,45,36,56,163,4,994,368
1814,454,382,72,39,57,55,49,68,186,12,1012,466
1815,415,312,103,27,47,46,40,62,193,0,1268,415
1816,342,277,65,29,43,44,36,53,137,8,770,350
1817,237,205,32,19,28,30,24,37,99,0,500,237
1818,532,460,72,42,63,67,54,83,223,52,1122,584
1819,463,376,87,39,53,49,49,64,209,153,1109,616
1820,879,680,199,77,133,110,90,121,348,0,2444,879
1821,426,337,89,39,37,51,49,70,180,13,1053,439
1822,396,307,89,23,38,52,39,69,175,50,941,446
1823,629,443,186,56,76,81,58,109,249,18,1979,647
1824,367,297,70,31,46,47,38,57,148,0,828,367
1825,265,215,50,22,33,34,28,41,107,0,597,265
1826,681,552,129,57,85,88,71,106,274,0,1535,681
1827,230,173,57,15,26,25,22,34,108,25,703,255
1828,5362,3795,1567,515,869,719,657,802,1800,0,15123,5362
1829,172,136,36,16,15,21,20,28,72,6,425,178
1830,1239,864,375,127,196,175,155,187,399,0,3997,1239
1831,393,274,119,40,62,56,49,59,127,0,1268,393
1832,625,483,142,74,93,95,72,89,202,124,1709,749
1833,128,90,38,11,15,16,12,22,52,0,403,128
1834,313,221,92,28,38,40,29,54,124,0,987,313
1835,521,367,154,46,63,67,48,90,207,0,1640,521
1836,332,234,98,29,40,42,31,58,132,0,1046,332
1837,927,753,174,78,106,98,97,128,420,49,2220,976
1838,177,137,40,10,17,23,18,31,78,7,421,184
1839,302,225,77,54,91,45,35,40,37,9,889,311
1840,472,373,99,27,43,65,33,81,223,38,1167,510
1841,335,239,96,21,41,45,35,51,142,180,850,515
1842,504,399,105,29,46,70,35,87,237,11,1245,515
1843,1017,827,190,81,107,131,92,163,443,0,2306,1017
1844,473,350,123,29,39,55,42,91,217,50,1287,523
1845,103,48,55,13,34,14,12,12,18,45,386,148
1846,372,172,200,47,122,52,44,43,64,0,1391,372
1847,400,315,85,60,75,55,65,52,93,75,1175,475
1848,382,301,81,57,72,52,62,50,89,32,1121,414
1849,539,438,101,45,62,57,56,74,245,0,1291,539
1850,2683,1899,784,258,435,360,329,401,900,0,7567,2683
1851,222,157,65,21,36,30,27,33,75,20,626,242
1852,729,480,249,59,101,102,92,107,268,122,2199,851
1853,310,216,94,32,49,44,39,47,99,24,1001,334
1854,314,188,126,23,43,39,37,48,124,0,908,314
1855,610,365,245,44,83,76,72,93,242,9,1764,619
1856,373,300,73,28,37,46,37,57,168,0,1018,373
1857,615,532,83,48,73,78,63,96,257,109,1295,724
1858,157,109,48,16,25,22,20,24,50,0,508,157
1859,249,174,75,26,39,35,31,38,80,7,805,256
1860,376,174,202,47,124,52,44,44,65,0,1406,376
1861,423,279,144,34,59,59,53,62,156,0,1276,423
1862,581,354,227,59,62,91,61,89,219,95,1697,676
1863,709,559,150,106,134,97,115,93,164,10,2081,719
1864,299,166,133,25,44,40,34,42,114,0,1068,299
1865,537,299,238,45,79,72,60,75,206,6,1920,543
1866,242,112,130,30,80,34,29,28,41,0,905,242
1867,311,189,122,32,33,49,32,48,117,124,908,435
1868,332,222,110,34,65,47,39,58,89,0,1043,332
1869,445,374,71,51,48,63,51,68,164,19,970,464
1870,398,308,90,47,59,61,46,57,128,33,1087,431
1871,372,293,79,56,70,51,60,49,86,19,1092,391
1872,132,104,28,20,25,18,21,17,31,0,387,132
1873,304,235,69,36,45,46,35,43,99,0,831,304
1874,326,218,108,33,63,47,39,56,88,32,1024,358
1875,779,656,123,67,98,95,85,116,318,0,1737,779
1876,1405,1182,223,121,176,171,153,209,575,132,3132,1537
1877,387,326,61,33,49,47,42,58,158,182,862,569
1878,149,93,56,17,32,24,12,29,35,0,507,149
1879,166,110,56,18,40,20,28,20,40,0,564,166
1880,316,196,120,35,67,52,25,60,77,0,1072,316
1881,732,439,293,93,147,104,80,118,190,11,2290,743
1882,429,257,172,55,86,61,47,69,111,90,1342,519
1883,547,328,219,70,110,78,60,88,141,133,1713,680
1884,697,460,237,75,167,85,120,82,168,64,2358,761
1885,178,143,35,13,17,22,18,27,81,0,486,178
1886,169,112,57,13,19,23,18,23,73,107,505,276
1887,450,300,150,31,53,63,43,78,182,0,1267,450
1888,230,177,53,15,29,37,23,32,94,9,587,239
1889,343,260,83,22,34,36,35,57,159,0,930,343
1890,945,769,176,75,99,121,86,151,413,0,2142,945
1891,505,281,224,42,75,68,57,71,192,0,1805,505
1892,244,175,69,16,32,34,21,41,100,0,739,244
1893,587,350,237,84,184,81,71,67,100,14,1926,601
1894,151,100,51,12,17,20,16,21,65,2,452,153
1895,481,302,179,38,54,54,56,78,201,0,1672,481
1896,742,488,254,45,80,90,63,127,337,890,1923,1632
1897,568,431,137,36,62,63,54,86,267,301,1376,869
1898,234,185,49,13,21,32,16,40,112,0,579,234
1899,213,169,44,12,19,29,15,37,101,0,527,213
1900,2117,1461,656,137,270,279,244,329,858,0,6154,2117
1901,501,357,144,32,61,67,52,76,213,190,1270,691
1902,263,157,106,38,82,36,32,30,45,7,864,270
1903,1175,811,364,76,150,155,136,183,475,0,3415,1175
1904,380,227,153,27,52,48,45,58,150,4,1100,384
1905,294,241,53,30,27,34,26,53,124,79,660,373
1906,170,102,68,22,34,24,19,27,44,0,533,170
1907,744,549,195,121,211,94,102,85,131,0,1943,744
1908,315,242,73,21,40,51,31,44,128,21,805,336
1909,534,423,111,49,47,64,62,87,225,12,1322,546
1910,160,89,71,13,24,22,18,22,61,0,571,160
1911,284,215,69,38,53,45,39,38,71,22,788,306
1912,318,219,99,29,36,39,24,52,138,0,982,318
1913,427,295,132,38,49,53,32,70,185,7,1318,434
1914,264,182,82,24,30,33,20,43,114,0,816,264
1915,196,148,48,17,24,27,19,31,78,17,566,213
1916,354,268,86,31,44,48,35,56,140,0,1023,354
1917,273,230,43,24,37,26,27,35,124,0,717,273
1918,535,408,127,37,47,61,50,89,251,0,1506,535
1919,713,584,129,73,66,82,63,128,301,92,1600,805
1920,508,427,81,59,55,72,58,77,187,147,1107,655
1921,827,695,132,96,89,117,95,125,305,41,1802,868
1922,391,300,91,25,49,63,39,54,161,22,997,413
1923,1088,751,337,70,139,144,126,169,440,0,3162,1088
1924,378,261,117,24,48,50,44,59,153,0,1099,378
1925,225,159,66,20,27,29,21,39,89,0,708,225
1926,23,17,6,2,3,3,2,4,9,0,65,23
1927,2494,1886,608,221,312,338,246,393,984,0,7199,2494
1928,89,64,25,6,12,12,8,15,36,0,269,89
1929,342,260,82,22,38,38,33,52,159,0,828,342
1930,162,140,22,13,19,20,17,25,68,0,342,162
1931,42,33,9,2,4,6,4,7,19,0,99,42
1932,89,69,20,5,9,12,9,16,38,0,211,89
1933,180,126,54,19,28,25,23,27,58,0,580,180
1934,0,0,0,0,0,0,0,0,0,0,0,0
1935,740,451,289,129,191,97,71,97,155,50,2547,790
1936,527,511,16,129,144,71,62,55,66,0,811,527
1937,2031,1788,243,104,160,208,199,354,1006,0,4581,2031
1938,663,571,92,49,61,71,68,104,310,1,1546,664
1939,261,220,41,28,30,31,29,48,95,0,570,261
1940,1244,1081,163,75,101,140,126,205,597,34,2879,1278
1941,177,165,12,10,17,22,22,25,81,0,416,177
1942,799,743,56,47,78,99,100,113,362,11,1881,810
1943,581,505,76,32,49,55,60,91,294,0,1370,581
1944,1958,1725,233,117,133,216,191,343,958,7,4480,1965
1945,1439,1242,197,68,100,149,143,275,704,0,3367,1439
1946,417,275,142,86,98,75,46,43,69,48,1192,465
1947,820,794,26,48,70,90,98,110,404,492,1848,1312
1948,1130,985,145,78,117,127,114,204,490,0,2575,1130
1949,205,163,42,35,31,26,28,32,53,14,485,219
1950,974,850,124,65,86,111,117,141,454,0,2325,974
1951,28,18,10,4,4,4,3,4,9,0,80,28
1952,1296,985,311,72,149,172,126,197,580,3,3508,1299
1953,221,186,35,22,28,27,27,30,87,0,500,221
1954,1479,911,568,130,222,211,160,207,549,0,3947,1479
1955,780,676,104,78,122,99,102,122,257,0,1627,780
1956,1521,1319,202,153,238,194,200,237,499,13,3172,1534
1957,526,438,88,39,56,48,65,75,243,0,1213,526
1958,1772,1429,343,124,169,212,189,249,829,0,4591,1772
1959,1998,1483,515,161,184,197,225,306,925,18,5130,2016
1960,68,49,19,11,17,10,8,10,12,0,184,68
1961,680,557,123,62,78,86,73,106,275,0,1531,680
1962,176,157,19,19,19,23,15,32,68,0,346,176
1963,208,171,37,18,27,25,23,38,77,0,502,208
1964,326,303,23,54,67,49,35,45,76,964,765,1290
1965,394,323,71,38,57,46,43,73,137,0,951,394
1966,325,191,134,64,66,54,31,44,66,46,1109,371
1967,176,103,73,35,36,29,17,24,35,9,600,185
1968,317,250,67,51,49,41,43,47,86,0,770,317
1969,427,350,77,39,49,54,46,67,172,0,962,427
1970,533,405,128,155,148,78,63,41,48,0,1240,533
1971,166,94,72,31,39,26,15,24,31,0,579,166
1972,412,338,74,37,47,52,44,65,167,0,928,412
1973,397,302,95,115,110,58,47,30,37,9,923,406
1974,448,341,107,130,124,65,53,34,42,0,1042,448
1975,1749,1674,75,771,632,156,93,58,39,0,2566,1749
1976,390,254,136,166,134,35,26,13,16,0,998,390
1977,264,173,91,109,95,21,18,13,8,7,661,271
1978,878,847,31,467,250,77,43,20,21,0,1526,878
1979,0,0,0,0,0,0,0,0,0,119,0,119
1980,997,693,304,267,463,99,76,46,46,21,2389,1018
1981,420,334,86,36,53,53,47,57,174,0,1019,420
1982,2513,2026,487,922,957,216,190,115,113,0,5513,2513
1983,1202,1024,178,96,124,126,165,175,516,0,2783,1202
1984,548,436,112,47,69,69,62,74,227,0,1331,548
1985,599,359,240,157,156,85,75,58,68,325,2011,924
1986,374,320,54,32,48,44,43,56,151,0,778,374
1987,411,342,69,31,44,38,51,59,188,0,949,411
1988,348,270,78,72,67,53,45,48,63,0,833,348
1989,408,201,207,68,76,68,47,56,93,0,1566,408
1990,304,179,125,60,61,51,29,41,62,49,1035,353
1991,540,356,184,57,60,89,52,88,194,13,1600,553
1992,244,120,124,41,45,40,28,33,57,0,934,244
1993,395,248,147,51,59,57,41,61,126,14,1136,409
1994,1230,1193,37,300,336,165,146,130,153,186,1893,1416
1995,584,531,53,207,162,73,51,43,48,0,1006,584
1996,573,401,172,189,171,64,63,43,43,0,1442,573
1997,1272,848,424,487,459,116,96,66,48,0,3609,1272
1998,814,740,74,289,226,102,72,60,65,0,1402,814
1999,763,693,70,271,212,96,67,57,60,0,1314,763
2000,548,384,164,180,163,61,60,41,43,0,1379,548
2001,490,343,147,161,146,55,54,37,37,0,1234,490
2002,340,238,102,112,101,38,38,26,25,177,857,517
2003,228,173,55,13,26,30,22,35,102,0,616,228
2004,1594,1587,7,621,474,191,124,95,89,83,2785,1677
2005,814,810,4,317,242,98,63,48,46,683,1423,1497
2006,490,337,153,179,145,56,39,37,34,581,1116,1071
2007,429,394,35,106,101,59,50,51,62,0,808,429
2008,567,431,136,165,157,83,67,43,52,23,1318,590
2009,703,469,234,273,211,66,64,50,39,69,1853,772
2010,860,705,155,63,97,101,103,138,358,0,2098,860
2011,327,266,61,76,69,43,50,32,57,0,757,327
2012,534,434,100,124,112,71,82,52,93,15,1236,549
2013,327,216,111,69,83,57,30,36,52,28,1007,355
2014,347,229,118,72,81,62,38,36,58,0,991,347
2015,211,139,72,22,24,35,20,34,76,0,626,211
2016,208,130,78,27,31,30,22,32,66,0,597,208
2017,357,200,157,106,99,39,49,26,38,11,1221,368
2018,479,268,211,142,133,52,66,35,51,8,1637,487
2019,255,128,127,47,67,44,25,29,43,20,956,275
2020,649,518,131,290,178,73,56,29,23,13,1518,662
2021,521,362,159,140,242,52,39,24,24,0,1249,521
2022,261,223,38,24,27,30,30,34,116,0,552,261
2023,347,310,37,38,37,46,30,62,134,92,682,439
2024,381,267,114,125,114,42,42,29,29,0,958,381
2025,379,212,167,112,105,41,52,28,41,17,1295,396
2026,231,129,102,68,64,25,32,17,25,13,791,244
2027,581,380,201,115,140,97,52,70,107,0,1775,581
2028,364,238,126,72,88,61,33,44,66,104,1111,468
2029,270,182,88,41,44,41,30,39,75,12,719,282
2030,458,309,149,69,75,69,50,67,128,0,1219,458
2031,490,331,159,74,81,74,54,72,135,0,1303,490
2032,273,184,89,41,45,41,30,40,76,0,725,273
2033,392,265,127,59,65,59,43,57,109,47,1045,439
2034,370,250,120,56,61,56,41,54,102,0,984,370
2035,337,272,65,40,66,56,32,45,98,0,867,337
2036,1125,1077,48,360,247,154,111,126,127,53,2173,1178
2037,422,387,35,104,99,58,49,50,62,0,795,422
2038,478,319,159,186,144,45,43,34,26,1,1262,479
2039,402,369,33,99,95,56,47,48,57,0,758,402
2040,1131,1084,47,310,327,148,103,125,118,0,1812,1131
2041,835,799,36,267,183,114,82,93,96,157,1612,992
2042,932,536,396,234,225,169,85,99,120,0,2958,932
2043,515,316,199,70,110,105,48,65,117,87,1818,602
2044,439,248,191,98,106,71,48,50,66,46,1532,485
2045,328,216,112,68,77,59,36,34,54,0,938,328
2046,282,186,96,60,72,49,26,31,44,0,867,282
2047,294,239,55,68,62,39,45,28,52,0,680,294
2048,336,205,131,84,77,53,32,37,53,0,1053,336
2049,347,200,147,87,84,63,32,37,44,0,1102,347
2050,118,74,44,25,27,22,11,15,18,115,362,233
2051,908,554,354,158,234,119,87,119,191,20,3127,928
2052,2161,1313,848,261,315,328,233,346,678,862,6478,3023
2053,599,369,230,121,164,96,55,70,93,0,1984,599
2054,427,263,164,86,117,69,40,50,65,0,1414,427
2055,516,318,198,104,142,83,48,60,79,0,1709,516
2056,231,142,89,47,63,37,21,27,36,0,767,231
2057,253,156,97,51,69,41,23,29,40,0,838,253
2058,264,163,101,53,72,42,24,31,42,0,875,264
2059,190,95,95,35,50,33,19,21,32,7,710,197
2060,134,83,51,12,20,19,15,19,49,0,357,134
2061,438,283,155,173,155,41,29,22,18,1,1133,439
2062,324,209,115,128,114,31,22,17,12,0,837,324
2063,573,382,191,222,172,54,52,41,32,643,1511,1216
2064,209,118,91,39,49,32,18,30,41,0,727,209
2065,767,474,293,164,232,118,77,81,95,119,2649,886
2066,324,200,124,69,98,50,33,34,40,13,1120,337
2067,688,686,2,374,167,67,31,29,20,393,998,1081
2068,659,458,201,176,306,66,50,30,31,9,1579,668
2069,555,431,124,114,107,85,72,76,101,0,1328,555
2070,244,161,83,52,62,42,22,27,39,0,752,244
2071,293,172,121,58,59,49,28,40,59,0,1000,293
2072,276,170,106,61,68,47,27,31,42,4,898,280
2073,353,217,136,86,78,57,32,35,65,0,1049,353
2074,252,155,97,62,56,40,23,25,46,0,750,252
2075,238,122,116,41,55,39,26,31,46,0,904,238
2076,658,641,17,193,162,93,55,76,79,9,1180,667
2077,656,551,105,66,82,79,81,89,259,39,1483,695
2078,741,585,156,333,231,66,55,33,23,31,1623,772
2079,663,413,250,258,220,67,56,31,31,7,1767,670
2080,1001,623,378,390,332,102,85,47,45,74,2665,1075
2081,230,183,47,39,34,29,32,36,60,0,544,230
2082,359,183,176,62,84,58,39,46,70,2,1364,361
2083,582,297,285,100,135,94,63,75,115,8,2211,590
2084,723,363,360,134,190,124,71,82,122,0,2707,723
2085,196,111,85,36,46,30,17,28,39,0,683,196
2086,283,158,125,52,60,50,27,35,59,55,886,338
2087,271,214,57,44,42,35,37,40,73,17,658,288
2088,501,420,81,46,55,63,54,79,204,448,1050,949
2089,584,525,59,263,207,46,37,18,13,4,1049,588
2090,502,481,21,221,181,45,27,17,11,10,737,512
2091,1,1,0,0,0,0,0,0,1,108,2,109
2092,447,250,197,82,94,78,43,55,95,0,1401,447
2093,237,231,6,70,58,33,20,28,28,0,425,237
2094,217,107,110,36,40,36,25,30,50,0,833,217
2095,445,323,122,70,113,63,55,65,79,0,1208,445
2096,216,133,83,48,53,37,21,25,32,0,704,216
2097,245,194,51,39,38,32,33,36,67,0,595,245
2098,676,437,239,178,181,93,86,64,74,42,1940,718
2099,212,171,41,25,42,35,20,28,62,0,544,212
2100,732,701,31,234,161,100,72,82,83,0,1414,732
2101,505,483,22,161,111,69,50,56,58,0,976,505
2102,1278,1234,44,680,364,112,63,30,29,129,2223,1407
2103,861,838,23,276,229,114,69,89,84,7,1416,868
2104,338,239,99,46,45,46,37,47,117,0,873,338
2105,246,150,96,62,56,39,23,27,39,0,769,246
2106,1139,1134,5,444,338,137,88,68,64,46,1991,1185
2107,367,306,61,27,39,34,45,52,170,0,846,367
2108,558,475,83,45,57,59,76,81,240,0,1292,558
2109,578,481,97,43,62,53,72,83,265,0,1334,578
2110,259,162,97,33,38,38,27,40,83,0,745,259
2111,411,266,145,130,176,36,38,18,13,0,1075,411
2112,428,276,152,135,184,37,40,19,13,17,1117,445
2113,288,257,31,39,53,36,33,44,83,0,598,288
2114,338,297,41,25,38,40,36,56,143,0,787,338
2115,418,279,139,160,151,38,32,22,15,0,1186,418
2116,815,390,425,174,129,105,89,119,199,0,2324,815
2117,653,520,133,56,83,82,73,89,270,0,1585,653
2118,449,368,81,33,50,53,54,72,187,0,1097,449
2119,840,739,101,306,384,67,38,25,20,1,1585,841
2120,739,737,2,364,236,58,42,25,14,152,1278,891
2121,379,261,118,139,112,43,30,29,26,0,865,379
2122,423,291,132,155,125,48,34,32,29,0,964,423
2123,387,340,47,28,44,46,42,64,163,0,900,387
2124,589,457,132,158,139,93,84,55,60,0,1321,589
2125,119,118,1,57,40,9,7,4,2,24,188,143
2126,131,129,2,57,51,9,6,5,3,53,217,184
2127,516,442,74,44,66,61,59,78,208,0,1072,516
2128,277,237,40,24,35,33,32,42,111,0,575,277
2129,879,724,155,69,98,126,113,120,353,0,1874,879
2130,552,463,89,50,61,70,60,87,224,0,1158,552
2131,409,343,66,37,45,52,44,65,166,0,857,409
2132,353,296,57,35,44,42,44,48,140,0,799,353
2133,566,439,127,157,152,93,62,43,59,0,1339,566
2134,410,326,84,35,52,52,46,56,169,38,995,448
2135,789,675,114,74,83,92,91,102,347,85,1664,874
2136,244,200,44,22,28,31,26,38,99,0,549,244
2137,439,392,47,60,81,55,50,68,125,0,912,439
2138,439,386,53,32,49,52,47,73,186,0,1022,439
2139,221,143,78,58,59,30,28,21,25,0,634,221
2140,968,927,41,265,279,126,88,107,103,0,1551,968
2141,942,917,25,302,250,125,75,97,93,17,1549,959
2142,378,368,10,111,93,53,31,44,46,13,677,391
2143,500,451,49,136,144,77,56,40,47,0,924,500
2144,362,281,81,101,97,59,40,28,37,21,855,383
2145,332,258,74,92,89,54,36,25,36,0,785,332
2146,257,153,104,63,64,35,42,21,32,0,801,257
2147,344,277,67,41,68,57,33,46,99,0,885,344
2148,233,167,66,47,50,40,23,27,46,0,581,233
2149,359,214,145,88,90,49,58,29,45,0,1118,359
2150,377,259,118,59,68,67,34,51,98,179,1043,556
2151,480,379,101,215,150,42,36,21,16,0,1053,480
2152,311,176,135,58,73,48,27,45,60,0,1085,311
2153,2161,2155,6,1176,526,210,97,92,60,44,3132,2205
2154,2569,2459,110,955,742,334,215,159,164,27,4219,2596
2155,491,425,66,53,55,70,55,85,173,3,1047,494
2156,468,394,74,49,54,55,51,86,173,56,1023,524
2157,292,246,46,31,34,34,32,54,107,0,638,292
2158,336,276,60,29,44,41,38,62,122,0,812,336
2159,230,194,36,24,26,27,25,42,86,0,501,230
2160,338,257,81,98,94,49,40,26,31,0,786,338
2161,371,282,89,108,103,54,44,28,34,0,863,371
2162,1067,1021,46,397,308,139,89,66,68,19,1752,1086
2163,252,241,11,94,73,33,21,16,15,0,413,252
2164,294,281,13,109,85,38,25,18,19,0,482,294
2165,394,377,17,147,114,51,33,24,25,25,647,419
2166,1960,1793,167,651,615,252,172,130,140,228,3222,2188
2167,392,380,12,145,116,50,30,25,26,74,581,466
2168,658,638,20,243,195,85,51,42,42,0,974,658
2169,414,402,12,153,123,53,32,26,27,0,613,414
2170,583,566,17,215,173,75,45,37,38,0,865,583
2171,1034,1003,31,253,283,138,123,109,128,0,1591,1034
2172,458,444,14,112,125,61,54,48,58,0,705,458
2173,471,299,172,101,123,74,58,56,59,3,1601,474
2174,141,89,52,29,32,26,13,18,23,0,435,141
2175,211,167,44,34,33,27,29,31,57,8,511,219
2176,557,456,101,54,81,65,60,103,194,11,1344,568
2177,318,251,67,51,49,41,43,47,87,0,772,318
2178,650,547,103,69,75,76,71,120,239,0,1420,650
2179,389,256,133,81,91,70,43,40,64,0,1113,389
2180,588,525,63,81,108,73,67,91,168,3,1222,591
2181,360,215,145,89,90,49,58,29,45,0,1121,360
2182,664,607,57,220,208,86,58,44,48,0,1091,664
2183,213,127,86,52,53,29,34,17,28,0,665,213
2184,467,424,43,166,130,59,41,35,36,0,805,467
2185,365,204,161,108,101,39,50,27,40,0,1248,365
2186,591,354,237,155,153,84,74,57,68,0,1982,591
2187,249,155,94,62,61,33,38,25,30,12,809,261
2188,434,283,151,86,104,73,39,52,80,0,1325,434
2189,2219,1353,866,386,571,291,212,292,467,0,7640,2219
2190,282,159,123,47,62,42,30,41,60,6,1029,288
2191,231,190,41,20,30,28,26,42,85,0,558,231
2192,305,251,54,31,39,37,37,57,104,39,713,344
2193,369,304,65,32,48,45,41,68,135,0,891,369
2194,222,182,40,21,32,26,24,41,78,0,536,222
2195,390,321,69,40,50,47,47,73,133,0,910,390
2196,227,187,40,23,29,27,27,43,78,6,530,233
2197,392,323,69,31,44,56,51,53,157,0,835,392
2198,239,222,17,40,49,36,25,33,56,0,563,239
2199,355,200,155,79,85,58,39,40,54,13,1239,368
2200,282,229,53,66,59,37,43,27,50,0,653,282
2201,1590,1010,580,341,414,251,197,189,198,3,5407,1593
2202,381,235,146,81,115,59,38,40,48,57,1315,438
2203,225,127,98,50,54,36,25,25,35,13,785,238
2204,361,238,123,77,92,63,33,40,56,0,1111,361
2205,452,260,192,113,109,82,41,48,59,0,1435,452
2206,455,277,178,114,104,72,43,50,72,0,1422,455
2207,513,398,115,106,99,78,67,70,93,0,1229,513
2208,1276,1113,163,88,132,144,129,231,552,0,2907,1276
2209,1048,661,387,218,240,195,95,136,164,0,3222,1048
2210,382,248,134,163,132,34,26,13,14,4,979,386
2211,279,156,123,51,59,49,27,34,59,0,875,279
2212,176,108,68,39,43,30,17,20,27,0,573,176
2213,355,346,9,104,87,50,29,41,44,0,638,355
2214,174,107,67,38,43,30,17,20,26,0,566,174
2215,273,152,121,50,57,48,26,33,59,0,857,273
2216,3195,2813,382,1166,1459,255,144,95,76,65,6030,3260
2217,221,139,82,46,51,41,20,29,34,0,681,221
2218,336,206,130,82,74,54,31,33,62,0,1000,336
2219,249,153,96,55,61,42,24,28,39,0,810,249
2220,243,160,83,26,27,40,23,40,87,0,720,243
2221,225,135,90,56,50,38,21,24,36,170,746,395
2222,282,186,96,60,72,49,26,31,44,0,867,282
2223,339,224,115,72,86,59,31,37,54,0,1045,339
2224,347,313,34,95,100,53,39,28,32,17,643,364
2225,397,358,39,108,114,61,45,32,37,0,734,397
2226,1187,1171,16,587,374,92,65,38,31,0,1689,1187
2227,485,344,141,66,64,65,54,68,168,13,1250,498
2228,540,487,53,147,156,83,61,43,50,0,999,540
2229,280,226,54,34,55,47,27,37,80,0,719,280
2230,371,316,55,30,38,39,51,54,159,0,859,371
2231,324,246,78,18,37,43,32,49,145,0,877,324
2232,480,288,192,120,108,82,46,51,73,8,1589,488
2233,443,431,12,142,118,59,35,46,43,25,729,468
2234,220,112,108,53,59,29,32,21,26,0,753,220
2235,660,433,227,273,237,54,44,32,20,0,1654,660
2236,461,409,52,62,74,58,58,72,137,0,976,461
2237,414,234,180,70,92,61,45,61,85,0,1507,414
2238,227,183,44,27,45,38,22,30,65,0,584,227
2239,337,299,38,45,54,43,43,53,99,0,714,337
2240,224,127,97,42,52,34,20,32,44,15,781,239
2241,271,242,29,30,29,36,23,49,104,92,533,363
2242,341,292,49,29,43,40,39,51,139,0,708,341
2243,389,333,56,33,49,46,45,58,158,111,807,500
2244,439,349,90,74,65,55,60,69,116,179,1041,618
2245,248,192,56,66,58,39,35,23,27,0,557,248
2246,414,300,114,98,99,64,52,43,58,0,1015,414
2247,258,200,58,72,69,42,28,20,27,0,609,258
2248,1888,1220,668,498,504,261,240,180,205,10,5419,1898
2249,396,307,89,106,93,62,56,37,42,0,887,396
2250,392,284,108,92,94,60,50,40,56,21,962,413
2251,322,234,88,76,77,50,41,33,45,0,788,322
2252,394,350,44,53,63,50,50,61,117,0,834,394
2253,444,394,50,60,71,56,56,69,132,0,940,444
2254,400,287,113,81,86,69,39,46,79,440,998,840
2255,339,173,166,82,91,45,50,32,39,0,1162,339
2256,343,249,94,54,87,49,43,50,60,0,932,343
2257,582,422,160,92,147,83,72,85,103,0,1581,582
2258,1089,704,385,287,291,150,139,104,118,6,3125,1095
2259,469,406,63,50,53,66,52,81,167,0,1001,469
2260,419,214,205,101,112,56,62,40,48,0,1434,419
2261,323,165,158,78,87,43,47,31,37,0,1107,323
2262,289,173,116,76,75,41,36,28,33,0,968,289
2263,299,186,113,74,73,39,45,30,38,52,970,351
2264,355,221,134,88,86,47,54,36,44,0,1153,355
2265,347,239,108,54,63,62,31,47,90,0,960,347
2266,283,176,107,70,69,37,43,29,35,0,920,283
2267,199,130,69,40,48,33,18,24,36,0,607,199
2268,389,268,121,60,71,70,35,53,100,0,1076,389
2269,392,258,134,81,92,70,43,40,66,25,1120,417
2270,391,269,122,61,71,70,35,53,101,0,1081,391
2271,264,182,82,41,48,47,24,36,68,33,731,297
2272,1364,785,579,343,329,248,124,145,175,0,4328,1364
2273,344,212,132,73,104,53,35,36,43,0,1187,344
2274,99,92,7,6,10,12,12,14,45,212,232,311
2275,83,77,6,5,8,10,10,12,38,0,195,83
2276,1020,1017,3,503,326,80,58,35,18,60,1764,1080
2277,1004,990,14,497,317,78,55,32,25,113,1427,1117
2278,233,223,10,103,84,21,12,8,5,33,342,266
2279,270,168,102,125,85,22,18,12,8,49,666,319
2280,428,266,162,199,134,36,28,19,12,7,1057,435
2281,45,37,8,5,6,5,5,8,16,10,104,55
2282,218,141,77,57,58,30,28,21,24,4,625,222
2283,746,685,61,60,56,90,82,104,354,0,1613,746
2284,741,714,27,62,38,79,90,129,343,0,1696,741
2285,912,882,30,92,49,97,109,166,399,0,2147,912
2286,560,542,18,74,33,63,63,95,232,0,1302,560
2287,1241,1205,36,133,86,98,131,211,582,31,2793,1272
2288,763,744,19,74,63,85,92,138,311,0,1648,763
2289,391,371,20,107,79,55,48,38,64,0,865,391
2290,633,614,19,94,71,91,79,95,203,50,1225,683
2291,5,4,1,1,1,1,0,1,1,1653,14,1658
2292,169,161,8,30,25,22,21,24,47,1560,305,1729
2293,478,449,29,130,98,67,64,46,73,1539,1042,2017
2294,226,212,14,61,46,31,30,22,36,895,493,1121
2295,2699,2679,20,771,487,369,392,246,434,184,5087,2883
2296,278,231,47,59,60,46,39,27,47,8,611,286
2297,741,719,22,90,65,79,98,118,291,28,1641,769
2298,468,442,26,105,74,62,57,53,117,0,986,468
2299,671,666,5,192,121,92,97,61,108,3,1265,674
2300,11,10,1,3,3,2,1,1,1,0,19,11
2301,319,293,26,97,92,47,31,24,28,0,542,319
2302,994,913,81,304,285,147,98,76,84,0,1690,994
2303,3942,3619,323,1205,1132,582,389,302,332,0,6703,3942
2304,511,488,23,64,36,51,74,74,212,0,1219,511
2305,291,276,15,80,59,41,36,28,47,0,643,291
2306,510,493,17,126,84,72,63,64,101,0,1013,510
2307,309,295,14,62,45,45,41,40,76,0,614,309
2308,347,330,17,95,70,49,43,33,57,10,768,357
2309,525,499,26,168,109,69,64,51,64,0,1212,525
2310,401,387,14,104,83,54,48,47,65,12,837,413
2311,557,529,28,152,112,78,69,54,92,132,1233,689
2312,301,288,13,68,49,54,36,34,60,0,627,301
2313,277,265,12,63,45,49,33,31,56,0,575,277
2314,1322,1214,108,404,380,195,130,101,112,0,2248,1322
2315,701,644,57,214,201,104,69,54,59,0,1192,701
2316,1019,936,83,311,293,151,100,78,86,3,1733,1022
2317,1273,1169,104,389,366,188,126,98,106,0,2164,1273
2318,793,779,14,256,145,110,106,69,107,1,1700,794
2319,477,452,25,94,72,63,49,82,117,0,921,477
2320,156,143,13,17,22,24,14,26,53,0,337,156
2321,817,774,43,162,123,107,84,141,200,14,1577,831
2322,893,854,39,202,145,159,106,100,181,177,1856,1070
2323,526,510,16,103,88,80,71,67,117,62,1021,588
2324,424,411,13,83,71,65,57,54,94,0,824,424
2325,373,361,12,60,33,40,51,63,126,0,847,373
2326,464,407,57,86,67,70,66,56,119,46,925,510
2327,581,473,108,173,141,86,72,41,68,3,1269,584
2328,2402,2205,197,734,690,355,237,184,202,99,4084,2501
2329,228,183,45,61,53,33,30,21,30,0,507,228
2330,395,317,78,106,91,57,51,37,53,215,880,610
2331,428,407,21,57,42,42,65,62,160,0,998,428
2332,494,397,97,147,125,77,58,39,48,190,1049,684
2333,302,243,59,81,70,43,39,28,41,19,673,321
2334,390,371,19,45,20,31,56,65,173,5,962,395
2335,507,407,100,136,117,73,66,47,68,0,1128,507
2336,431,359,72,91,93,72,61,41,73,0,945,431
2337,662,640,22,166,119,94,90,83,110,14,1394,676
2338,719,706,13,232,132,100,96,63,96,116,1543,835
2339,1143,919,224,340,289,177,135,90,112,0,2428,1143
2340,452,420,32,97,57,60,64,58,116,119,1100,571
2341,1057,998,59,238,168,141,129,119,262,0,2225,1057
2342,358,352,6,94,67,51,47,45,54,832,746,1190
2343,714,703,11,144,122,111,87,84,166,0,1316,714
2344,644,634,10,130,110,100,78,76,150,0,1188,644
2345,0,0,0,0,0,0,0,0,0,4,0,4
2346,507,444,63,94,73,76,72,61,131,0,1012,507
2347,655,643,12,212,120,91,87,57,88,5,1405,660
2348,280,273,7,27,23,31,34,51,114,11,606,291
2349,526,509,17,132,95,74,72,66,87,57,1108,583
2350,334,329,5,87,63,48,44,42,50,46,696,380
2351,704,617,87,131,101,106,100,85,181,0,1406,704
2352,333,304,29,36,46,51,29,56,115,98,716,431
2353,584,565,19,94,51,62,80,98,199,0,1325,584
2354,895,887,8,262,159,127,125,84,138,5184,1628,6079
2355,1041,999,42,290,181,163,107,128,172,0,2265,1041
2356,211,195,16,62,44,27,28,21,29,0,514,211
2357,430,415,15,51,32,51,46,72,178,0,955,430
2358,315,300,15,36,16,25,45,53,140,0,778,315
2359,312,288,24,92,65,40,41,31,43,60,759,372
2360,273,264,9,37,17,30,34,44,111,0,628,273
2361,298,285,13,39,14,32,37,46,130,0,764,298
2362,434,418,16,54,38,55,51,66,170,5,901,439
2363,460,443,17,57,40,59,55,70,179,0,956,460
2364,379,367,12,52,23,41,48,62,153,0,871,379
2365,382,365,17,47,27,38,55,55,160,0,910,382
2366,488,465,23,56,25,39,70,82,216,6,1205,494
2367,322,311,11,33,17,34,38,59,141,0,758,322
2368,532,514,18,72,32,58,67,87,216,7,1224,539
2369,514,495,19,61,38,61,56,86,212,0,1143,514
2370,528,512,16,79,60,76,66,79,168,1,1022,529
2371,239,227,12,32,25,28,28,37,89,0,523,239
2372,384,370,14,66,55,49,48,53,113,0,758,384
2373,411,392,19,73,62,54,52,58,112,30,743,441
2374,566,545,21,98,80,72,71,78,167,3,1116,569
2375,1198,1180,18,241,205,187,146,141,278,8,2210,1206
2376,205,197,8,25,18,26,24,31,81,0,425,205
2377,509,493,16,81,55,66,70,71,166,0,992,509
2378,853,815,38,172,125,123,112,109,212,35,1693,888
2379,238,227,11,48,35,34,31,31,59,207,472,445
2380,307,293,14,62,45,44,40,39,77,0,609,307
2381,230,216,14,62,47,32,31,22,36,295,502,525
2382,495,475,20,138,86,78,51,61,81,0,1078,495
2383,506,471,35,109,63,68,71,65,130,0,1231,506
2384,365,354,11,54,41,52,45,55,118,16,707,381
2385,702,678,24,173,115,99,87,89,139,21,1395,723
2386,314,303,11,39,27,40,37,48,123,0,652,314
2387,175,169,6,28,15,19,24,30,59,0,397,175
2388,481,465,16,76,52,62,66,67,158,83,939,564
2389,1693,1634,59,441,350,226,203,200,273,153,3529,1846
2390,315,253,62,94,80,49,37,25,30,26,670,341
2391,292,269,23,86,61,38,38,29,40,0,711,292
2392,218,213,5,63,44,31,22,25,33,37,413,255
2393,189,185,4,54,38,27,19,22,29,89,359,278
2394,539,438,101,160,130,80,66,38,65,0,1177,539
2395,744,719,25,183,122,105,92,94,148,174,1479,918
2396,250,238,12,34,26,29,29,39,93,0,548,250
2397,493,475,18,85,70,63,62,68,145,0,971,493
2398,475,468,7,124,89,68,62,60,72,0,991,475
2399,512,507,5,150,91,73,72,48,78,1816,930,2328
2400,240,230,10,31,11,26,30,37,105,0,617,240
2401,782,775,7,229,139,111,109,74,120,613,1422,1395
2402,653,623,30,115,98,86,83,92,179,820,1178,1473
2403,1438,1392,46,228,154,185,199,200,472,9,2804,1447
2404,528,516,12,152,108,74,54,61,79,2,1000,530
2405,641,610,31,205,134,84,78,63,77,0,1483,641
2406,355,327,28,105,74,46,47,36,47,127,864,482
2407,946,918,28,115,83,101,126,150,371,0,2095,946
2408,291,284,7,28,24,32,35,53,119,0,629,291
2409,361,348,13,43,27,43,39,60,149,0,802,361
2410,370,354,16,49,18,40,46,57,160,0,949,370
2411,507,492,15,62,45,54,67,80,199,1,1122,508
2412,761,724,37,101,75,75,115,110,285,0,1774,761
2413,10,9,1,2,2,1,1,1,3,0,20,10
2414,411,378,33,33,31,49,45,57,196,3,887,414
2415,0,0,0,0,0,0,0,0,0,0,0,0
2416,155,147,8,21,16,18,18,24,58,0,340,155
2417,167,159,8,23,17,20,20,26,61,0,367,167
2418,199,192,7,25,17,25,24,30,78,6,413,205
2419,771,728,43,173,122,103,94,87,192,0,1625,771
2420,519,490,29,117,82,69,63,58,130,0,1094,519
2421,0,0,0,0,0,0,0,0,0,10,0,10
2422,747,686,61,228,215,110,74,57,63,0,1271,747
2423,435,432,3,124,78,59,63,40,71,0,820,435
2424,347,344,3,99,63,47,50,32,56,3,654,350
2425,459,456,3,131,83,63,67,42,73,210,865,669
2426,301,298,3,88,53,43,42,28,47,0,548,301
2427,190,186,4,55,39,27,20,22,27,179,360,369
2428,216,211,5,62,44,30,22,25,33,0,410,216
2429,86,84,2,25,18,12,9,10,12,0,162,86
2430,89,87,2,26,18,12,9,10,14,0,170,89
2431,138,135,3,40,28,19,14,16,21,0,261,138
2432,382,363,19,104,77,54,47,37,63,29,844,411
2433,81,75,6,24,17,11,11,8,10,0,197,81
2434,357,345,12,93,74,48,43,42,57,0,744,357
2435,169,163,6,44,35,23,20,20,27,0,352,169
2436,83,77,6,24,17,11,11,8,12,18,201,101
2437,77,62,15,21,18,11,10,7,10,0,171,77
2438,90,72,18,24,21,13,12,8,12,0,201,90
2439,88,71,17,24,20,13,11,8,12,0,195,88
2440,98,79,19,26,23,14,13,9,13,0,219,98
2441,270,247,23,29,37,41,24,45,94,0,580,270
2442,244,231,13,48,37,32,25,42,60,0,471,244
2443,704,667,37,139,106,92,72,121,174,0,1359,704
2444,202,191,11,40,30,27,21,35,49,41,390,243
2445,770,468,302,93,112,117,83,123,242,0,2307,770
2446,0,0,0,0,0,0,0,0,0,0,0,0
2447,0,0,0,0,0,0,0,0,0,0,0,0
2448,210,101,109,45,33,27,23,31,51,0,600,210
2449,0,0,0,0,0,0,0,0,0,0,0,0
2450,374,314,60,38,47,45,46,51,147,0,845,374
2451,183,154,29,18,23,22,23,25,72,0,413,183
2452,745,626,119,75,93,89,92,101,295,0,1685,745
2453,173,171,2,83,58,13,10,6,3,0,274,173
2454,50,49,1,24,17,4,3,2,0,0,79,50
2455,1242,1225,17,539,483,86,60,44,30,6,2063,1248
2456,149,120,29,55,57,13,11,7,6,0,327,149
2457,924,745,179,339,352,79,70,42,42,6,2026,930
2458,47,46,1,20,18,3,2,2,2,3,79,50
2459,628,506,122,230,239,54,48,29,28,0,1378,628
2460,180,178,2,78,70,13,9,6,4,0,299,180
2461,111,110,1,48,43,8,5,4,3,4,185,115
2462,51,48,3,11,8,7,6,6,13,415,108,466
2463,255,241,14,57,40,34,31,29,64,0,538,255
2464,458,432,26,103,73,61,56,51,114,1,965,459
2465,0,0,0,0,0,0,0,0,0,49,0,49
2466,430,348,82,41,45,48,43,70,183,0,1052,430
2467,1117,756,361,168,255,197,134,150,213,0,3526,1117
2468,569,336,233,129,162,95,61,53,69,0,1744,569
2469,881,773,108,38,101,84,124,130,404,0,1923,881
2470,1191,842,349,109,109,88,178,218,489,0,3213,1191
2471,1494,1054,440,162,183,177,173,254,545,9,4012,1503
2472,1106,794,312,121,132,80,172,189,412,14,2983,1120
2473,1715,1240,475,152,225,192,267,287,592,25,4699,1740
2474,1513,1284,229,158,187,146,236,254,532,0,3085,1513
2475,2256,1668,588,172,237,169,277,362,1039,59,5942,2315
2476,1280,956,324,82,134,106,167,212,579,32,3256,1312
2477,861,624,237,66,80,64,116,146,389,9,2229,870
2478,3088,2367,721,231,291,266,316,540,1444,64,8362,3152
2479,1463,1083,380,77,149,129,166,260,682,85,3680,1548
2480,1021,854,167,93,112,96,140,154,426,0,2343,1021
2481,520,356,164,48,86,63,73,73,177,10,1659,530
2482,601,461,140,96,109,96,75,81,144,338,1492,939
2483,893,696,197,78,89,127,91,149,359,3,2221,896
2484,1189,878,311,125,187,169,152,179,377,6,3250,1195
2485,3153,2945,208,884,951,223,203,303,589,4,5842,3157
2486,1501,1213,288,350,276,249,165,187,274,0,3177,1501
2487,311,277,34,19,33,25,39,46,149,0,725,311
2488,321,283,38,17,38,22,44,54,146,0,732,321
2489,477,310,167,36,66,49,64,90,172,0,1473,477
2490,483,285,198,110,138,80,52,45,58,244,1480,727
2491,528,323,205,109,152,83,53,58,73,90,1739,618
2492,1300,934,366,142,155,94,202,222,485,0,3504,1300
2493,315,226,89,34,38,23,49,54,117,0,849,315
2494,515,335,180,39,72,53,69,97,185,0,1590,515
2495,541,388,153,46,70,57,70,95,203,0,1515,541
2496,347,249,98,29,45,36,45,61,131,0,971,347
2497,245,144,101,37,36,31,33,39,69,0,839,245
2498,307,181,126,46,45,39,42,49,86,8,1052,315
2499,220,129,91,33,32,28,30,35,62,0,751,220
2500,679,373,306,79,121,116,88,95,180,0,2332,679
2501,223,160,63,27,27,31,24,33,81,6,591,229
2502,639,459,180,77,76,90,68,95,233,0,1692,639
2503,672,583,89,67,72,73,73,121,266,0,1462,672
2504,823,713,110,82,88,89,90,148,326,10,1790,833
2505,381,328,53,25,49,30,54,57,166,0,887,381
2506,389,335,54,26,50,31,56,58,168,0,906,389
2507,288,197,91,26,47,35,40,41,99,10,918,298
2508,724,520,204,79,86,52,112,124,271,0,1953,724
2509,378,184,194,71,95,61,44,46,61,158,1333,536
2510,304,274,30,24,36,16,44,48,136,0,707,304
2511,1832,1316,516,200,219,133,284,313,683,0,4940,1832
2512,306,276,30,29,31,25,43,44,134,0,656,306
2513,270,233,37,18,35,21,39,40,117,6,630,276
2514,409,353,56,27,53,32,58,61,178,0,953,409
2515,708,631,77,44,74,58,88,105,339,0,1653,708
2516,387,335,52,35,45,29,58,59,161,0,869,387
2517,232,208,24,17,24,20,31,29,111,0,525,232
2518,467,416,51,37,49,25,87,65,204,0,1015,467
2519,517,418,99,121,95,86,57,64,94,3,1094,520
2520,637,462,175,49,59,47,86,108,288,13,1649,650
2521,1156,886,270,185,210,185,145,156,275,146,2870,1302
2522,1583,1478,105,444,478,112,102,152,295,2,2933,1585
2523,428,247,181,96,118,67,44,41,62,0,1381,428
2524,299,267,32,21,31,25,40,37,145,0,673,299
2525,1489,1287,202,135,171,111,223,226,623,0,3339,1489
2526,427,369,58,39,49,32,64,65,178,6,958,433
2527,157,136,21,14,18,12,24,24,65,0,352,157
2528,313,278,35,21,43,25,44,47,133,7,673,320
2529,237,211,26,16,32,19,34,36,100,11,510,248
2530,528,469,59,36,72,42,75,80,223,0,1136,528
2531,369,329,40,30,39,20,69,52,159,15,802,384
2532,449,344,105,72,82,72,56,61,106,0,1113,449
2533,881,623,258,80,81,65,131,161,363,0,2378,881
2534,555,456,99,59,65,80,67,89,195,0,1389,555
2535,471,364,107,55,75,84,48,64,145,0,1217,471
2536,104,85,19,11,12,15,12,17,37,0,259,104
2537,613,503,110,65,72,89,73,98,216,0,1536,613
2538,199,143,56,17,26,21,26,35,74,0,557,199
2539,588,422,166,50,76,62,76,103,221,0,1648,588
2540,331,215,116,25,46,34,44,62,120,17,1022,348
2541,624,551,73,33,75,44,86,106,280,0,1424,624
2542,1447,1041,406,156,183,178,178,250,502,18,4285,1465
2543,439,360,79,46,51,63,53,70,156,0,1099,439
2544,216,167,49,25,34,38,22,29,68,9,557,225
2545,258,200,58,30,41,46,27,35,79,29,666,287
2546,490,237,253,85,108,80,56,64,97,0,1881,490
2547,165,80,85,29,36,27,19,22,32,0,634,165
2548,345,167,178,60,76,57,39,45,68,56,1323,401
2549,390,189,201,68,86,64,44,51,77,0,1498,390
2550,277,204,73,29,44,39,35,42,88,0,758,277
2551,219,148,71,33,50,39,26,29,42,4,693,223
2552,319,216,103,48,73,56,38,43,61,0,1006,319
2553,247,167,80,37,56,43,30,33,48,28,780,275
2554,304,176,128,56,91,40,37,35,45,0,1159,304
2555,221,128,93,41,66,29,27,26,32,0,842,221
2556,367,212,155,68,110,48,45,42,54,0,1396,367
2557,377,296,81,78,93,61,37,48,60,0,955,377
2558,244,192,52,50,60,39,24,31,40,0,619,244
2559,373,293,80,77,92,60,37,48,59,7,946,380
2560,307,241,66,63,76,50,30,39,49,21,778,328
2561,597,286,311,118,195,93,60,61,70,0,2287,597
2562,1252,600,652,247,409,195,125,127,149,15,4794,1267
2563,2983,1429,1554,589,975,464,298,302,355,0,11427,2983
2564,250,144,106,56,69,39,26,24,36,0,807,250
2565,408,235,173,92,113,64,42,39,58,0,1318,408
2566,696,401,295,156,192,109,72,67,100,10,2246,706
2567,836,493,343,190,239,139,90,78,100,0,2562,836
2568,417,246,171,95,119,69,45,39,50,0,1277,417
2569,320,189,131,73,91,53,34,30,39,8,982,328
2570,360,220,140,74,103,57,36,39,51,0,1186,360
2571,374,228,146,77,107,59,37,41,53,39,1232,413
2572,495,302,193,102,142,78,50,54,69,0,1628,495
2573,1118,903,215,261,205,185,123,139,205,1,2366,1119
2574,1657,1108,549,286,362,235,196,214,364,239,4893,1896
2575,905,605,300,156,198,128,107,117,199,30,2672,935
2576,556,372,184,96,121,79,66,72,122,11,1642,567
2577,1096,733,363,189,239,156,130,141,241,4,3238,1100
2578,511,367,144,61,61,72,55,76,186,14,1351,525
2579,345,248,97,41,41,48,37,51,127,28,912,373
2580,459,398,61,46,49,50,50,82,182,0,999,459
2581,140,88,52,12,19,14,16,23,56,41,438,181
2582,209,147,62,23,26,25,24,36,75,0,562,209
2583,253,178,75,27,31,30,29,43,93,9,679,262
2584,733,403,330,86,130,126,94,103,194,0,2518,733
2585,719,638,81,71,78,52,130,104,284,0,1598,719
2586,1373,1217,156,136,148,98,249,199,543,1,3052,1374
2587,273,245,28,25,30,38,35,53,92,0,563,273
2588,305,273,32,28,34,43,39,60,101,63,627,368
2589,239,116,123,42,53,39,27,31,47,0,918,239
2590,246,119,127,43,54,40,28,32,49,0,942,246
2591,340,261,79,54,62,54,43,46,81,68,845,408
2592,999,630,369,87,134,103,117,163,395,0,3133,999
2593,216,155,61,18,28,23,28,38,81,0,606,216
2594,398,194,204,74,100,64,46,48,66,0,1403,398
2595,395,192,203,74,99,64,46,48,64,0,1393,395
2596,425,329,96,50,67,76,44,58,130,0,1098,425
2597,268,242,26,21,32,14,39,43,119,3,624,271
2598,270,244,26,21,32,14,39,43,121,0,630,270
2599,381,343,38,36,39,31,54,55,166,15,814,396
2600,312,182,130,38,63,58,34,48,71,0,1036,312
2601,526,308,218,64,106,98,58,80,120,10,1745,536
2602,159,93,66,19,32,30,18,24,36,0,528,159
2603,496,359,137,38,46,37,67,84,224,8,1283,504
2604,238,193,45,23,25,27,24,39,100,0,583,238
2605,316,256,60,30,33,36,31,52,134,13,774,329
2606,274,195,79,19,40,38,36,50,91,0,798,274
2607,726,569,157,42,73,72,96,106,337,22,1697,748
2608,1730,1301,429,89,187,176,200,312,766,22,4310,1752
2609,1352,1078,274,59,140,126,139,244,644,53,3266,1405
2610,2969,2179,790,217,276,347,262,475,1392,22,7792,2991
2611,1217,789,428,91,79,150,86,241,570,0,3406,1217
2612,422,312,110,37,29,60,24,78,194,0,1069,422
2613,1564,1286,278,179,117,193,185,259,631,43,3531,1607
2614,1684,1271,413,98,217,184,166,298,721,6,4477,1690
2615,234,175,59,18,34,28,31,41,82,82,555,316
2616,1252,983,269,74,104,125,128,223,598,8,2999,1260
2617,923,707,216,41,81,88,103,166,444,0,2241,923
2618,2374,1900,474,110,239,230,268,435,1092,14,5639,2388
2619,1566,1383,183,112,163,172,173,271,675,26,2958,1592
2620,1384,1110,274,75,141,153,131,279,605,311,3260,1695
2621,1320,1059,261,101,223,169,165,223,439,23,3163,1343
2622,466,359,107,44,47,53,50,77,195,0,1180,466
2623,173,133,40,16,18,20,19,29,71,9,437,182
2624,2692,2028,664,226,219,272,270,479,1226,0,7101,2692
2625,2136,1658,478,161,195,208,210,373,989,90,5616,2226
2626,1479,1179,300,123,138,165,121,259,673,7,3575,1486
2627,3249,2509,740,275,235,449,247,586,1457,17,7448,3266
2628,2417,1416,1001,222,361,312,265,441,816,10,8495,2427
2629,594,449,145,53,70,65,59,102,245,19,1573,613
2630,869,573,296,66,135,115,92,160,301,0,2407,869
2631,351,249,102,25,25,43,30,62,166,0,912,351
2632,3155,2365,790,213,255,419,214,588,1466,14,7880,3169
2633,1386,1087,299,77,105,129,155,249,671,14,3602,1400
2634,2671,1918,753,206,242,291,205,475,1252,11,7363,2682
2635,1345,1029,316,86,98,181,82,242,656,0,3594,1345
2636,381,282,99,25,52,42,46,70,146,0,941,381
2637,653,524,129,50,110,83,82,110,218,96,1566,749
2638,910,648,262,62,134,125,121,166,302,0,2650,910
2639,610,610,0,101,71,84,94,90,170,0,1081,610
2640,474,454,20,41,73,54,66,86,154,183,928,657
2641,1232,1088,144,88,128,135,136,213,532,100,2327,1332
2642,661,481,180,63,71,96,70,105,256,5,1812,666
2643,688,519,169,40,89,75,68,122,294,0,1829,688
2644,364,307,57,28,59,41,46,76,114,0,772,364
2645,592,568,24,52,92,67,83,108,190,1,1158,593
2646,599,505,94,46,97,67,76,126,187,0,1271,599
2647,731,557,174,50,68,81,65,138,329,0,1744,731
2648,541,413,128,37,50,60,48,102,244,31,1291,572
2649,539,411,128,37,50,60,48,101,243,0,1286,539
2650,303,224,79,20,41,33,37,56,116,0,747,303
2651,628,428,200,83,126,89,78,99,153,0,1862,628
2652,588,519,69,42,61,65,65,102,253,0,1112,588
2653,1635,1444,191,117,170,180,181,283,704,0,3089,1635
2654,2305,2035,270,165,240,253,255,399,993,100,4354,2405
2655,2069,1276,793,252,412,308,260,310,527,0,6720,2069
2656,11561,7135,4426,2742,5753,580,607,736,1143,0,37575,11561
2657,5180,3197,1983,1229,2578,260,272,330,511,0,16835,5180
2658,753,563,190,58,108,89,100,133,265,0,1788,753
2659,1003,786,217,58,101,99,132,146,467,37,2345,1040
2660,396,270,126,52,79,56,49,63,97,0,1174,396
2661,216,160,56,14,29,24,26,40,83,0,532,216
2662,792,621,171,44,60,74,89,143,382,7,2059,799
2663,739,563,176,51,69,82,66,139,332,553,1764,1292
2664,836,657,179,50,69,83,85,149,400,0,2003,836
2665,257,197,60,11,23,24,29,46,124,0,625,257
2666,552,433,119,32,55,54,73,80,258,0,1290,552
2667,978,785,193,75,165,125,123,165,325,0,2344,978
2668,2677,2540,137,450,423,460,215,411,718,4,4280,2681
2669,1681,1595,86,282,265,289,135,258,452,146,2687,1827
2670,542,396,146,62,63,71,55,100,191,40,1475,582
2671,445,325,120,51,52,58,45,82,157,7,1210,452
2672,422,325,97,40,43,48,46,70,175,37,1069,459
2673,432,333,99,41,44,49,47,72,179,81,1092,513
2674,391,301,90,37,40,44,42,65,163,24,989,415
2675,518,415,103,28,53,57,49,104,227,0,1218,518
2676,583,397,186,77,117,83,72,92,142,0,1726,583
2677,1855,1144,711,226,369,276,233,278,473,0,6027,1855
2678,682,465,217,90,136,97,84,108,167,0,2020,682
2679,1045,816,229,120,145,148,107,173,352,24,2766,1069
2680,363,283,80,42,50,52,37,60,122,0,960,363
2681,534,450,84,41,86,60,68,112,167,57,1135,591
2682,274,181,93,21,43,36,29,51,94,106,758,380
2683,735,550,185,56,106,87,98,130,258,3,1745,738
2684,702,525,177,54,101,83,93,124,247,0,1666,702
2685,297,232,65,34,41,42,30,49,101,14,785,311
2686,558,422,136,49,65,61,56,96,231,24,1478,582
2687,105,86,19,12,8,13,12,17,43,0,238,105
2688,66,54,12,8,5,8,8,11,26,75,148,141
2689,1032,849,183,118,77,127,122,171,417,267,2332,1299
2690,361,270,91,28,52,43,48,64,126,0,858,361
2691,273,204,69,21,39,32,36,48,97,6,648,279
2692,2600,1924,676,170,354,286,315,479,996,92,6418,2692
2693,619,486,133,37,51,62,63,110,296,8,1483,627
2694,697,534,163,31,61,66,78,125,336,13,1691,710
2695,395,298,97,23,51,43,39,70,169,37,1050,432
2696,568,415,153,65,66,74,58,104,201,13,1546,581
2697,608,444,164,69,71,80,62,112,214,3,1656,611
2698,362,264,98,35,39,53,38,58,139,8,992,370
2699,546,397,149,52,58,80,58,87,211,31,1497,577
2700,351,256,95,34,37,51,37,56,136,5,961,356
2701,697,537,160,66,71,79,75,116,290,0,1763,697
2702,618,571,47,52,98,79,62,107,220,0,1071,618
2703,1841,1596,245,139,215,243,197,310,737,409,4237,2250
2704,2214,1761,453,102,195,239,227,391,1060,38,5801,2252
2705,1053,868,185,54,74,116,85,210,514,36,2704,1089
2706,2058,1651,407,128,178,212,232,379,929,63,5361,2121
2707,1559,1321,238,117,160,173,171,263,675,28,3602,1587
2708,1079,897,182,87,141,125,116,194,416,25,2499,1104
2709,566,483,83,52,82,76,63,100,193,7,1278,573
2710,1363,1090,273,103,153,138,168,272,529,8,3451,1371
2711,5961,5960,1,1092,1359,1055,647,753,1055,0,7734,5961
2712,720,583,137,87,57,68,97,129,282,1363,1844,2083
2713,282,240,42,22,35,39,33,43,110,0,618,282
2714,86,73,13,7,11,12,10,13,33,0,188,86
2715,707,534,173,58,64,74,90,140,281,0,1941,707
2716,1690,1374,316,150,145,172,204,303,716,801,4522,2491
2717,2097,1728,369,165,212,258,253,347,862,0,5111,2097
2718,974,870,104,67,82,135,114,151,425,0,2216,974
2719,388,304,84,30,40,42,43,72,161,0,1019,388
2720,666,555,111,52,63,72,81,122,276,0,1669,666
2721,1142,833,309,68,90,84,118,216,566,8,3189,1150
2722,245,196,49,17,22,25,28,47,106,0,654,245
2723,630,514,116,45,51,61,78,123,272,0,1614,630
2724,672,618,54,41,83,79,74,101,294,0,1264,672
2725,1835,1637,198,175,207,269,190,338,656,196,3776,2031
2726,1005,787,218,78,104,110,112,185,416,0,2634,1005
2727,2050,1894,156,171,326,261,205,355,732,31,3554,2081
2728,986,913,73,83,142,136,125,137,363,10,1709,996
2729,3384,3134,250,285,486,467,428,469,1249,0,5867,3384
2730,760,699,61,46,87,89,71,130,337,0,1430,760
2731,479,441,38,29,55,56,45,82,212,0,902,479
2732,1010,929,81,60,115,118,95,172,450,2,1900,1012
2733,1995,1848,147,168,287,275,252,277,736,43,3458,2038
2734,1072,986,86,65,132,126,118,162,469,0,2018,1072
2735,1426,1193,233,92,150,185,183,204,612,57,3375,1483
2736,460,390,70,35,47,51,50,78,199,0,1064,460
2737,441,406,35,26,50,52,41,75,197,2,830,443
2738,413,383,30,35,59,57,52,57,153,0,715,413
2739,1200,948,252,86,119,128,146,239,482,2,3225,1202
2740,255,204,51,18,23,26,29,49,110,0,680,255
2741,410,328,82,29,37,43,47,78,176,0,1094,410
2742,278,233,45,18,29,36,36,40,119,0,658,278
2743,511,428,83,33,54,66,66,73,219,0,1209,511
2744,674,564,110,43,71,87,87,96,290,236,1595,910
2745,1099,939,160,100,158,147,122,193,379,7,2485,1106
2746,365,305,60,23,27,38,40,61,176,97,930,462
2747,1343,1123,220,83,98,138,147,223,654,28,3418,1371
2748,907,834,73,55,112,106,100,137,397,0,1708,907
2749,216,183,33,16,22,24,24,36,94,14,498,230
2750,671,569,102,51,69,75,73,113,290,0,1551,671
2751,676,562,114,55,88,79,73,121,260,17,1565,693
2752,261,226,35,20,31,35,28,44,103,84,601,345
2753,625,534,91,57,90,84,70,110,214,0,1413,625
2754,373,304,69,27,52,48,41,69,136,0,878,373
2755,910,774,136,71,113,125,108,139,354,0,1993,910
2756,370,292,78,27,37,40,45,74,147,20,993,390
2757,707,576,131,51,99,91,78,130,258,70,1664,777
2758,736,599,137,53,103,95,81,136,268,0,1731,736
2759,1534,1305,229,119,190,210,182,235,598,0,3359,1534
2760,412,311,101,34,37,43,53,82,163,0,1132,412
2761,822,621,201,67,74,86,105,163,327,0,2256,822
2762,498,399,99,35,45,52,57,95,214,11,1327,509
2763,1533,1278,255,120,145,167,187,281,633,59,3846,1592
2764,312,260,52,24,30,34,38,57,129,0,783,312
2765,503,413,90,33,48,80,54,83,205,0,1234,503
2766,1687,1186,501,98,189,181,241,280,698,41,4598,1728
2767,2368,1707,661,134,253,302,252,389,1038,46,6305,2414
2768,338,213,125,19,41,42,49,60,127,0,991,338
2769,1574,1173,401,110,165,197,180,288,634,24,4080,1598
2770,1225,961,264,81,132,128,178,250,456,0,3151,1225
2771,13049,8547,4502,514,1475,1250,1983,2217,5610,489,39930,13538
2772,3660,2744,916,203,357,416,459,645,1580,8,9480,3668
2773,3465,2939,526,238,305,296,571,514,1541,0,7609,3465
2774,1780,1332,448,115,136,173,283,276,797,0,4621,1780
2775,4229,3373,856,273,418,545,473,728,1792,53,10422,4282
2776,1510,1226,284,87,137,136,217,240,693,0,3556,1510
2777,1859,1362,497,87,224,273,149,324,802,39,5122,1898
2778,2206,1662,544,117,239,283,255,385,927,6,5898,2212
2779,3621,2496,1125,191,397,450,482,643,1458,7,9957,3628
2780,1190,700,490,63,118,139,119,226,525,0,3581,1190
2781,888,721,167,51,80,80,128,141,408,0,2091,888
2782,132,99,33,9,10,13,21,20,59,0,342,132
2783,474,279,195,25,47,56,47,90,209,0,1428,474
2784,422,248,174,22,42,49,42,80,187,19,1271,441
2785,1078,875,203,62,98,97,155,172,494,0,2539,1078
2786,499,294,205,26,50,58,50,95,220,8,1501,507
2787,318,201,117,18,38,39,46,57,120,1,932,319
2788,484,305,179,27,58,59,70,86,184,3,1419,487
2789,6108,5181,927,420,538,522,1007,905,2716,0,13413,6108
2790,747,559,188,48,57,73,119,116,334,0,1938,747
2791,1947,1457,490,126,148,189,310,302,872,0,5053,1947
2792,1462,1102,360,113,185,183,167,288,526,63,4103,1525
2793,1264,971,293,97,138,114,209,188,518,10,3455,1274
2794,1265,810,455,178,202,163,175,165,382,83,3771,1348
2795,1301,817,484,224,190,174,187,174,352,0,3671,1301
2796,355,249,106,23,43,38,37,63,151,0,1029,355
2797,1496,1061,435,160,233,245,172,210,476,129,4163,1625
2798,335,206,129,38,52,49,35,51,110,3,1150,338
2799,426,375,51,53,65,72,56,75,105,21,947,447
2800,977,525,452,47,97,110,92,183,448,16,3227,993
2801,1226,743,483,81,132,133,136,221,523,0,3942,1226
2802,2499,1673,826,154,245,255,265,448,1132,0,7369,2499
2803,1472,1054,418,164,196,237,207,209,459,0,4249,1472
2804,451,306,145,46,61,65,51,67,161,5,1444,456
2805,3442,2335,1107,354,469,499,387,510,1223,31,9521,3473
2806,475,371,104,60,66,63,87,61,138,10,1281,485
2807,2491,1820,671,244,271,314,359,357,946,39,7376,2530
2808,1296,841,455,117,179,183,157,198,462,21,4061,1317
2809,201,130,71,18,28,28,24,31,72,0,630,201
2810,1570,849,721,161,281,235,169,232,492,7,5916,1577
2811,6319,3517,2802,371,495,627,598,1079,3149,119,21415,6438
2812,1963,1137,826,100,188,195,197,346,937,0,6355,1963
2813,1371,794,577,70,131,136,138,241,655,44,4436,1415
2814,4896,3691,1205,379,619,612,558,964,1764,209,13743,5105
2815,188,142,46,15,24,23,21,37,68,0,527,188
2816,332,178,154,35,55,44,39,56,103,4,1193,336
2817,505,300,205,30,52,44,52,97,230,16,1687,521
2818,225,146,79,20,31,32,27,34,81,0,704,225
2819,972,597,375,111,150,141,101,148,321,0,3340,972
2820,388,233,155,35,44,49,44,73,143,66,1134,454
2821,127,82,45,11,18,18,15,19,46,0,397,127
2822,510,309,201,34,55,55,57,92,217,0,1640,510
2823,1082,642,440,65,111,95,111,209,491,0,3614,1082
2824,613,368,245,55,69,78,69,115,227,11,1791,624
2825,769,462,307,70,87,98,87,144,283,1,2245,770
2826,521,313,208,47,59,66,59,98,192,4,1521,525
2827,832,447,385,40,83,94,78,156,381,1,2748,833
2828,659,354,305,32,66,74,62,124,301,0,2177,659
2829,696,418,278,63,79,89,79,131,255,20,2032,716
2830,1175,918,257,149,164,156,215,150,341,0,3171,1175
2831,688,398,290,35,66,68,69,121,329,96,2227,784
2832,707,496,211,46,86,75,74,125,301,13,2050,720
2833,492,347,145,63,75,73,72,70,139,50,1370,542
2834,1021,817,204,123,146,110,194,143,305,46,2661,1067
2835,1559,925,634,94,160,137,160,301,707,0,5209,1559
2836,399,240,159,36,45,51,45,75,147,0,1165,399
2837,1021,550,471,52,90,108,96,177,498,0,3262,1021
2838,262,141,121,13,23,28,25,45,128,13,836,275
2839,974,564,410,50,93,97,98,172,464,0,3153,974
2840,602,391,211,54,83,85,73,92,215,42,1888,644
2841,179,118,61,20,29,31,21,27,51,0,553,179
2842,461,305,156,53,73,79,55,69,132,38,1429,499
2843,376,213,163,43,61,61,38,56,117,0,1274,376
2844,1140,804,336,147,175,168,166,162,322,11,3176,1151
2845,426,301,125,55,65,63,62,61,120,124,1186,550
2846,336,237,99,43,51,50,49,48,95,35,935,371
2847,523,396,127,56,87,71,77,92,140,57,1446,580
2848,458,347,111,49,76,62,68,81,122,15,1266,473
2849,762,577,185,82,127,103,112,134,204,147,2108,909
2850,655,496,159,71,109,89,97,115,174,0,1811,655
2851,776,577,199,74,89,122,91,160,240,0,2142,776
2852,230,165,65,26,31,37,32,33,71,0,662,230
2853,417,293,124,27,50,44,44,74,178,0,1210,417
2854,923,647,276,60,112,98,97,163,393,0,2678,923
2855,388,222,166,43,60,62,48,59,116,0,1311,388
2856,310,177,133,35,48,50,38,47,92,0,1049,310
2857,1198,727,471,137,197,185,133,167,379,36,4073,1234
2858,733,445,288,84,120,113,81,102,233,0,2493,733
2859,437,265,172,50,72,67,49,61,138,0,1487,437
2860,1008,692,316,118,173,143,134,141,299,0,2940,1008
2861,380,297,83,48,53,50,70,48,111,1,1025,381
2862,1513,1182,331,192,211,200,277,193,440,0,4082,1513
2863,394,211,183,41,66,52,46,66,123,6,1414,400
2864,771,402,369,71,119,118,93,124,246,0,2766,771
2865,696,452,244,63,96,98,85,106,248,0,2182,696
2866,386,237,149,44,60,56,40,59,127,0,1326,386
2867,604,426,178,78,92,89,88,86,171,0,1683,604
2868,921,547,374,55,95,81,95,178,417,5,3076,926
2869,251,142,109,28,41,41,25,38,78,14,849,265
2870,1027,582,445,116,167,168,104,154,318,0,3476,1027
2871,350,231,119,40,56,60,42,52,100,0,1085,350
2872,1430,945,485,163,228,245,171,213,410,87,4429,1517
2873,407,308,99,44,68,55,60,72,108,0,1126,407
2874,245,182,63,23,28,38,29,51,76,3,677,248
2875,527,422,105,63,75,57,100,74,158,0,1372,527
2876,874,500,374,97,135,141,108,132,261,0,2958,874
2877,680,441,239,61,94,96,83,104,242,0,2131,680
2878,440,235,205,46,73,58,51,74,138,0,1578,440
2879,8,5,3,1,1,1,1,1,3,41,26,49
2880,758,459,299,50,82,82,84,136,324,0,2436,758
2881,1465,888,577,97,158,159,163,264,624,4,4711,1469
2882,844,511,333,56,91,92,94,152,359,110,2714,954
2883,870,527,343,58,94,95,97,157,369,2,2798,872
2884,628,420,208,39,62,64,67,113,283,12,1853,640
2885,351,235,116,22,34,36,37,63,159,0,1034,351
2886,491,329,162,30,48,50,52,88,223,0,1447,491
2887,417,279,138,26,41,43,44,75,188,0,1229,417
2888,466,312,154,29,46,48,49,84,210,3,1375,469
2889,600,402,198,37,59,61,64,108,271,5,1770,605
2890,1125,753,372,70,110,115,119,202,509,19,3315,1144
2891,1534,1027,507,95,150,157,163,275,694,0,4522,1534
2892,661,443,218,41,65,68,70,119,298,3,1949,664
2893,2682,1796,886,166,263,274,285,481,1213,22,7907,2704
2894,3422,2291,1131,211,335,350,363,614,1549,48,10090,3470
2895,593,397,196,37,58,61,63,106,268,9,1750,602
2896,2201,1183,1018,107,219,248,207,413,1007,12,7268,2213
2897,51,38,13,4,6,6,6,10,19,0,144,51
2898,1461,1288,173,183,223,246,194,257,358,0,3248,1461
2899,4045,2691,1354,317,654,626,520,687,1241,53,12245,4098
2900,1176,915,261,128,168,192,152,188,348,99,3207,1275
2901,1221,953,268,165,190,207,157,208,294,13,3108,1234
2902,1157,898,259,120,163,164,157,218,335,35,3071,1192
2903,1523,985,538,160,242,232,196,263,430,29,4745,1552
2904,2950,2072,878,266,438,447,406,516,877,27,7904,2977
2905,978,697,281,146,164,160,116,173,219,643,2140,1621
2906,8199,5904,2295,1118,1380,1099,1583,1381,1638,0,23542,8199
2907,792,642,150,102,130,116,112,126,206,0,1951,792
2908,2398,1880,518,255,373,349,312,393,716,73,6486,2471
2909,1491,1176,315,131,236,232,202,259,431,78,4023,1569
2910,792,595,197,81,109,116,119,133,234,45,2164,837
2911,253,183,70,30,49,39,35,37,63,21,712,274
2912,986,629,357,124,179,156,155,153,219,0,2664,986
2913,319,204,115,32,52,47,38,56,94,22,1138,341
2914,1961,1265,696,189,303,283,257,317,612,24,6534,1985
2915,1297,961,336,147,172,185,180,216,397,0,3202,1297
2916,1412,1110,302,140,196,209,184,275,408,0,3497,1412
2917,285,212,73,36,39,47,39,45,79,243,753,528
2918,2398,2203,195,324,312,425,266,414,657,7,4715,2405
2919,1708,1337,371,222,269,264,230,279,444,20,4082,1728
2920,1906,1405,501,190,287,278,236,306,609,29,5000,1935
2921,2889,1708,1181,200,397,411,400,508,973,0,8857,2889
2922,1601,1272,329,168,227,216,206,307,477,0,3881,1601
2923,1379,1075,304,150,212,209,192,233,383,8,3396,1387
2924,766,515,251,102,123,132,94,124,191,17,2254,783
2925,751,541,210,106,134,115,116,121,159,0,1758,751
2926,343,220,123,34,56,51,41,60,101,14,1223,357
2927,463,308,155,48,69,66,56,84,140,0,1613,463
2928,801,580,221,95,157,125,111,116,197,3,2258,804
2929,472,375,97,82,76,79,67,66,102,9,933,481
2930,797,633,164,139,128,133,113,111,173,302,1577,1099
2931,284,224,60,38,48,46,40,53,59,0,630,284
2932,403,333,70,52,62,66,57,72,94,0,969,403
2933,311,246,65,41,53,50,44,58,65,0,691,311
2934,304,240,64,40,51,49,43,57,64,0,675,304
2935,333,224,109,44,54,57,41,54,83,0,978,333
2936,293,217,76,40,50,47,38,49,69,7,799,300
2937,289,214,75,39,50,47,37,49,67,14,786,303
2938,461,341,120,62,79,74,59,78,109,0,1256,461
2939,438,362,76,57,67,71,61,78,104,0,1053,438
2940,306,253,53,40,47,50,43,54,72,0,734,306
2941,591,479,112,76,97,86,83,94,155,0,1455,591
2942,302,217,85,44,54,48,39,44,73,0,791,302
2943,400,288,112,58,71,64,51,58,98,4,1047,404
2944,689,497,192,99,121,109,98,121,141,0,1573,689
2945,256,185,71,37,45,40,37,45,52,10,586,266
2946,513,370,143,72,91,78,79,82,111,64,1202,577
2947,357,237,120,37,53,51,43,65,108,34,1244,391
2948,402,267,135,42,60,57,49,73,121,34,1401,436
2949,865,645,220,110,119,144,119,138,235,202,2287,1067
2950,679,506,173,86,94,113,94,108,184,78,1793,757
2951,298,182,116,30,45,40,39,54,90,12,1058,310
2952,527,323,204,53,79,71,70,96,158,0,1870,527
2953,244,149,95,24,37,33,32,45,73,12,867,256
2954,572,350,222,57,86,77,76,105,171,28,2028,600
2955,480,345,135,69,86,76,62,70,117,0,1258,480
2956,969,865,104,129,122,143,120,157,298,55,1916,1024
2957,329,211,118,33,53,49,39,57,98,26,1174,355
2958,265,176,89,28,40,38,32,48,79,7,923,272
2959,847,687,160,109,139,124,119,135,221,15,2086,862
2960,25,17,8,3,5,3,4,4,6,0,71,25
2961,229,130,99,21,43,34,34,39,58,0,712,229
2962,1754,1010,744,165,342,227,275,320,425,3,5583,1757
2963,804,367,437,110,208,114,104,150,118,1272,2735,2076
2964,4601,2785,1816,422,948,551,716,815,1149,0,13539,4601
2965,1233,823,410,119,253,154,174,255,278,0,3366,1233
2966,0,0,0,0,0,0,0,0,0,0,0,0
2967,1167,841,326,127,282,153,179,196,230,0,2828,1167
2968,1237,860,377,132,251,170,204,216,264,0,3091,1237
2969,2078,1626,452,218,369,260,346,357,528,0,5207,2078
2970,5920,4786,1134,857,1316,1004,800,945,998,163,12576,6083
2971,1231,931,300,122,230,153,181,227,318,0,3142,1231
2972,3586,2919,667,480,596,493,543,632,842,164,8736,3750
2973,460,283,177,62,93,68,76,76,85,0,1452,460
2974,1195,769,426,151,199,201,191,190,263,254,3502,1449
2975,824,619,205,66,122,113,119,148,256,0,2314,824
2976,477,253,224,35,82,58,66,90,146,0,1495,477
2977,1631,1226,405,147,268,215,267,261,473,7,4539,1638
2978,4109,3073,1036,378,666,492,603,751,1219,43,10559,4152
2979,4370,2848,1522,421,932,600,721,708,988,181,13620,4551
2980,1894,1237,657,213,353,268,299,314,447,116,5459,2010
2981,1704,1180,524,209,300,282,261,280,372,46,5092,1750
2982,1267,798,469,158,275,175,196,209,254,8,3895,1275
2983,2186,1449,737,311,432,325,350,330,438,27,6375,2213
2984,1679,1042,637,195,299,256,232,276,421,11,5010,1690
2985,1165,637,528,106,216,146,160,232,305,0,3659,1165
2986,1751,1279,472,206,322,246,300,259,418,0,4798,1751
2987,2897,2389,508,360,506,378,477,510,666,0,6265,2897
2988,1503,1174,329,141,302,176,227,273,384,11,4030,1514
2989,2544,1991,553,290,641,307,382,419,505,29,6439,2573
2990,1150,726,424,99,228,159,160,216,288,0,3342,1150
2991,1843,1153,690,189,344,239,295,329,447,15,5200,1858
2992,486,391,95,56,92,61,79,85,113,4,1176,490
2993,2255,1580,675,254,500,327,331,348,495,0,5820,2255
2994,1480,1290,190,185,298,228,250,239,280,6,3855,1486
2995,4170,2472,1698,401,841,532,623,792,981,6,12501,4176
2996,1513,1104,409,147,278,182,247,254,405,0,3910,1513
2997,777,544,233,78,169,93,107,143,187,21,2224,798
2998,1012,623,389,136,205,151,166,168,186,147,3191,1159
2999,671,380,291,61,126,99,100,114,171,0,2083,671
3000,508,320,188,44,113,61,76,97,117,0,1553,508
3001,1018,642,376,89,226,123,152,195,233,1,3110,1019
3002,412,260,152,36,91,50,61,79,95,0,1259,412
3003,618,410,208,57,149,78,98,110,126,0,1839,618
3004,685,432,253,60,152,83,102,131,157,0,2094,685
3005,0,0,0,0,0,0,0,0,0,0,0,0
3006,7162,4668,2494,690,1528,984,1181,1160,1619,0,22323,7162
3007,554,349,205,48,123,67,83,106,127,0,1694,554
3008,595,395,200,55,144,75,94,106,121,0,1773,595
3009,644,427,217,60,156,81,102,115,130,0,1916,644
3010,476,300,176,41,106,58,71,91,109,0,1454,476
3011,402,267,135,37,97,51,64,72,81,0,1198,402
3012,478,322,156,49,88,66,73,81,121,16,1371,494
3013,58,39,19,6,11,8,9,10,14,0,167,58
3014,704,475,229,72,129,97,108,120,178,0,2019,704
3015,975,597,378,127,190,158,149,141,210,6,2925,981
3016,306,173,133,28,57,45,45,52,79,0,951,306
3017,1398,943,455,143,256,192,215,238,354,0,4007,1398
3018,564,325,239,70,98,77,83,95,141,9,1844,573
3019,152,106,46,15,33,18,21,28,37,0,436,152
3020,444,272,172,58,86,72,68,64,96,2,1332,446
3021,596,477,119,87,104,93,83,99,130,0,1546,596
3022,700,513,187,84,129,105,121,117,144,111,1920,811
3023,241,176,65,29,45,36,42,40,49,53,662,294
3024,318,254,64,46,55,49,44,53,71,0,824,318
3025,661,381,280,83,115,91,98,112,162,11,2164,672
3026,468,287,181,61,91,76,71,67,102,0,1403,468
3027,1440,1081,359,115,214,198,207,259,447,4,4045,1444
3028,1418,1064,354,114,210,195,204,255,440,0,3981,1418
3029,1998,1062,936,145,345,242,278,375,613,0,6259,1998
3030,578,307,271,42,100,70,80,108,178,1,1809,579
3031,208,168,40,24,40,26,34,36,48,14,503,222
3032,291,234,57,34,55,37,47,51,67,0,704,291
3033,1012,815,197,117,192,127,165,176,235,10,2447,1022
3034,660,476,184,72,160,87,101,111,129,0,1601,660
3035,465,335,130,51,112,61,71,78,92,0,1127,465
3036,399,288,111,44,97,52,61,67,78,0,966,399
3037,1022,737,285,112,247,134,157,171,201,0,2478,1022
3038,743,613,130,92,130,97,122,131,171,0,1606,743
3039,808,666,142,100,141,105,133,142,187,0,1746,808
3040,559,461,98,69,98,73,92,98,129,0,1209,559
3041,14,10,4,1,3,2,2,3,3,0,40,14
3042,0,0,0,0,0,0,0,0,0,0,0,0
3043,0,0,0,0,0,0,0,0,0,0,0,0
3044,0,0,0,0,0,0,0,0,0,0,0,0
3045,4,3,1,0,1,0,1,1,1,0,13,4
3046,1983,1338,645,202,364,272,305,338,502,25,5687,2008
3047,322,224,98,26,38,41,39,61,117,0,940,322
3048,3390,2531,859,280,339,362,367,598,1444,78,8992,3468
3049,2369,1483,886,167,273,232,241,404,1052,28,7392,2397
3050,1473,1160,313,89,164,158,156,266,640,83,3547,1556
3051,2622,1997,625,193,281,236,261,442,1209,11,7115,2633
3052,2426,1776,650,181,209,258,230,432,1116,50,6080,2476
3053,1102,843,259,72,95,124,143,184,484,1,2811,1103
3054,2287,1846,441,181,212,280,236,420,958,140,5478,2427
3055,40,40,0,3,7,4,3,4,19,0,55,40
3056,1447,894,553,91,170,158,160,250,618,71,4929,1518
3057,3056,2322,734,222,347,311,303,567,1306,0,9696,3056
3058,349,254,95,27,38,43,34,59,148,0,884,349
3059,917,646,271,63,113,102,105,150,384,0,2604,917
3060,840,526,314,70,89,106,83,165,327,1,2400,841
3061,457,371,86,30,45,50,47,82,203,8,1023,465
3062,591,480,111,39,59,65,61,106,261,0,1325,591
3063,362,278,84,33,40,41,38,65,145,0,761,362
3064,218,168,50,20,24,25,23,39,87,176,459,394
3065,464,337,127,36,51,57,46,79,195,0,1175,464
3066,503,365,138,39,55,62,50,86,211,115,1274,618
3067,1085,802,283,87,135,129,115,184,435,57,2813,1142
3068,581,423,158,50,79,70,57,109,216,17,1416,598
3069,598,460,138,55,67,68,63,108,237,164,1259,762
3070,478,333,145,39,57,60,57,90,175,0,1394,478
3071,997,694,303,80,118,125,119,188,367,0,2908,997
3072,1009,746,263,81,126,120,107,171,404,0,2618,1009
3073,260,189,71,23,36,31,26,49,95,0,633,260
3074,664,468,196,46,82,74,76,109,277,0,1885,664
3075,1212,854,358,83,149,135,138,198,509,62,3440,1274
3076,513,416,97,33,51,56,53,92,228,0,1149,513
3077,445,329,116,36,56,53,47,75,178,0,1153,445
3078,416,308,108,33,52,49,44,70,168,382,1079,798
3079,418,309,109,34,52,50,44,71,167,0,1084,418
3080,428,265,163,27,50,47,47,74,183,0,1457,428
3081,530,328,202,33,62,58,59,92,226,0,1806,530
3082,535,407,128,39,61,55,53,99,228,8,1696,543
3083,991,753,238,72,112,101,98,184,424,0,3144,991
3084,1176,1065,111,100,96,118,120,219,523,1383,2107,2559
3085,2667,2130,537,230,280,289,280,451,1137,137,6142,2804
3086,857,637,220,84,145,118,87,152,271,14,2054,871
3087,2198,1732,466,195,219,232,253,433,866,76,5371,2274
3088,2271,1931,340,176,204,221,235,417,1018,15,5257,2286
3089,2749,2228,521,205,229,283,265,471,1296,63,6273,2812
3090,1016,820,196,80,111,130,95,182,418,20,2318,1036
3091,1858,1717,141,175,207,182,313,301,680,1493,4278,3351
3092,736,616,120,58,55,88,84,149,302,88,1568,824
3093,4,2,2,0,0,0,0,1,3,0,14,4
3094,444,274,170,28,52,48,49,77,190,0,1513,444
3095,1,1,0,0,0,0,0,0,1,0,3,1
3096,1,1,0,0,0,0,0,0,1,0,3,1
3097,0,0,0,0,0,0,0,0,0,0,0,0
3098,0,0,0,0,0,0,0,0,0,0,0,0
3099,1,1,0,0,0,0,0,0,1,0,3,1
3100,0,0,0,0,0,0,0,0,0,0,0,0
3101,306,248,58,23,26,32,29,52,144,27,698,333
3102,317,257,60,24,26,33,31,54,149,0,723,317
3103,192,156,36,14,16,20,18,33,91,14,439,206
3104,1109,910,199,115,258,185,109,183,259,6,2539,1115
3105,2224,2095,129,285,433,349,264,363,530,17,4194,2241
3106,2082,1522,560,210,501,357,220,333,461,39,5539,2121
3107,2323,1925,398,281,420,376,323,379,544,986,4914,3309
3108,3088,2238,850,273,618,491,387,480,839,0,8201,3088
3109,1484,1126,358,155,326,250,167,223,363,0,4071,1484
3110,2885,2188,697,314,644,500,340,452,635,170,7732,3055
3111,5536,4019,1517,511,1200,870,698,891,1366,66,14623,5602
3112,405,320,85,65,88,82,33,61,76,0,1016,405
3113,551,489,62,92,126,107,52,88,86,0,1240,551
3114,554,392,162,73,153,86,63,86,93,8,1496,562
3115,1604,1363,241,205,381,254,178,237,349,0,3619,1604
3116,607,536,71,66,143,83,96,101,118,3223,1550,3830
3117,1700,1305,395,268,424,336,147,249,276,0,4485,1700
3118,5340,4801,539,822,1312,1053,479,755,919,355,11272,5695
3119,1601,1294,307,154,387,249,171,269,371,0,4011,1601
3120,773,646,127,81,187,127,100,117,161,0,1796,773
3121,365,326,39,56,72,82,26,58,71,0,848,365
3122,789,704,85,121,155,178,57,126,152,0,1831,789
3123,1388,1109,279,147,291,211,167,230,342,42,3348,1430
3124,1842,1517,325,155,325,330,182,335,515,593,4655,2435
3125,983,872,111,163,224,191,93,157,155,3,2213,986
3126,2411,1912,499,354,545,403,304,365,440,0,5551,2411
3127,455,335,120,41,116,71,58,77,92,0,1218,455
3128,2523,2150,373,301,603,392,318,386,523,17,5662,2540
3129,1915,1504,411,249,379,348,171,335,433,0,4843,1915
3130,4191,3714,477,532,901,754,492,639,873,0,8617,4191
3131,2716,2419,297,281,640,513,263,429,590,59,5551,2775
3132,3438,2280,1158,323,911,604,407,532,661,21,9665,3459
3133,1336,997,339,108,318,222,149,226,313,15,3984,1351
3134,1301,1073,228,159,292,196,126,261,267,205,3162,1506
3135,3722,3638,84,471,688,590,472,618,883,0,6055,3722
3136,2160,1737,423,254,480,344,251,379,452,256,4926,2416
3137,4235,3509,726,403,881,688,444,781,1038,118,9851,4353
3138,1451,1166,285,172,326,260,174,251,268,60,3374,1511
3139,3155,2532,623,313,674,563,278,582,745,46,7861,3201
3140,3454,2805,649,449,960,590,389,478,588,97,8084,3551
3141,1770,1379,391,191,441,324,158,289,367,0,4420,1770
3142,1432,1181,251,186,328,256,159,251,252,419,2985,1851
3143,1703,1340,363,216,379,268,204,291,345,60,3625,1763
3144,1664,1178,486,202,382,263,191,296,330,38,4002,1702
3145,2034,1383,651,210,424,340,289,337,434,43,5508,2077
3146,1740,1369,371,260,433,296,204,273,274,20,4116,1760
3147,1499,871,628,212,290,227,262,223,285,27,4862,1526
3148,508,312,196,75,102,77,79,73,102,8,1619,516
3149,1592,891,701,203,325,243,275,223,323,33,5379,1625
3150,630,353,277,80,129,96,109,88,128,13,2127,643
3151,2789,2234,555,265,668,461,306,476,613,0,6263,2789
3152,3565,2696,869,353,835,586,432,650,709,21,9234,3586
3153,1830,1335,495,225,399,308,223,326,349,11,4765,1841
3154,1447,1121,326,215,352,244,161,216,259,20,3796,1467
3155,978,681,297,141,214,155,123,165,180,18,2664,996
3156,2364,1721,643,200,492,380,263,444,585,67,6287,2431
3157,2635,2063,572,283,568,476,240,459,609,43,6606,2678
3158,1423,655,768,187,335,216,220,208,257,279,5547,1702
3159,2750,1616,1134,350,521,400,435,447,597,60,9336,2810
3160,813,552,261,99,170,141,104,124,175,45,2413,858
3161,1706,1402,304,164,406,300,173,297,366,206,3765,1912
3162,1710,1367,343,197,372,298,159,302,382,17,3846,1727
3163,1801,1438,363,180,345,277,181,330,488,22,4190,1823
3164,1580,1273,307,142,318,259,201,272,388,0,3575,1580
3165,2249,1770,479,250,461,384,238,433,483,151,5117,2400
3166,3022,1832,1190,435,678,449,468,439,553,70,9726,3092
3167,3372,2328,1044,496,830,566,404,468,608,39,9147,3411
3168,2925,2407,518,353,587,480,319,539,647,20,6356,2945
3169,3144,2620,524,392,676,551,309,558,658,385,6993,3529
3170,1339,1061,278,106,317,237,146,224,309,28,3255,1367
3171,1869,1646,223,306,415,291,222,267,368,342,3355,2211
3172,3625,3137,488,493,850,617,459,563,643,0,7825,3625
3173,2907,2427,480,364,676,486,310,521,550,98,6558,3005
3174,1880,1705,175,237,438,325,238,281,361,0,3498,1880
3175,1734,1536,198,198,363,298,152,348,375,240,3699,1974
3176,2503,2266,237,412,530,426,268,430,437,104,4647,2607
3177,2346,2024,322,318,515,429,273,368,443,60,4510,2406
3178,1648,1358,290,209,382,280,161,314,302,46,3561,1694
3179,655,473,182,66,147,118,67,115,142,19,1785,674
3180,1558,1243,315,163,345,272,153,308,317,0,3598,1558
3181,1261,1058,203,140,267,222,111,232,289,115,2838,1376
3182,1567,1233,334,150,383,272,153,262,347,144,3922,1711
3183,4988,3750,1238,496,1163,992,530,855,952,157,12788,5145
3184,3625,3244,381,567,1125,731,405,418,379,156,7124,3781
3185,2273,1972,301,252,570,399,262,352,438,0,4596,2273
3186,2132,1774,358,244,453,333,221,363,518,3,4691,2135
3187,286,169,117,21,66,45,32,54,68,68,898,354
3188,791,539,252,78,179,142,67,145,180,25,2170,816
3189,2009,1662,347,204,414,361,214,360,456,230,4757,2239
3190,2244,1608,636,255,502,329,297,380,481,76,6036,2320
3191,224,175,49,22,44,40,24,38,56,0,548,224
3192,106,83,23,11,26,19,9,17,24,0,265,106
3193,1102,812,290,99,281,172,140,187,223,0,2951,1102
3194,253,209,44,26,52,46,27,45,57,0,599,253
3195,642,380,262,48,147,100,72,121,154,0,2017,642
3196,313,185,128,23,72,49,35,59,75,8,983,321
3197,1119,763,356,110,253,200,95,205,256,0,3071,1119
3198,843,609,234,85,189,152,86,147,184,0,2298,843
3199,1837,1088,749,137,421,287,205,345,442,8,5774,1845
3200,847,611,236,86,190,152,87,148,184,0,2308,847
3201,255,184,71,26,57,46,26,45,55,6,694,261
3202,496,358,138,50,111,89,51,87,108,0,1352,496
3203,152,110,42,15,34,27,16,27,33,6,416,158
3204,315,215,100,31,71,56,27,58,72,0,865,315
3205,475,324,151,47,107,85,40,87,109,0,1302,475
3206,284,194,90,28,64,51,24,52,65,0,780,284
3207,353,241,112,35,80,63,30,65,80,0,967,353
3208,356,279,77,35,70,64,39,61,87,31,869,387
3209,727,569,158,71,143,131,79,125,178,0,1775,727
3210,725,568,157,71,142,131,79,125,177,0,1770,725
3211,231,180,51,25,58,42,21,38,47,0,577,231
3212,502,391,111,54,125,92,45,82,104,0,1254,502
3213,694,541,153,75,173,127,62,113,144,0,1734,694
3214,712,560,152,107,177,121,83,112,112,114,1683,826
3215,1332,1048,284,199,332,226,156,209,210,0,3150,1332
3216,1933,1497,436,288,471,326,215,289,344,0,5072,1933
3217,397,308,89,59,97,67,44,59,71,0,1042,397
3218,483,296,187,71,97,73,75,69,98,41,1540,524
3219,369,226,143,54,74,56,58,53,74,2,1176,371
3220,301,185,116,44,60,46,47,43,61,0,958,301
3221,645,396,249,95,130,98,101,92,129,301,2055,946
3222,856,754,102,140,190,133,102,122,169,22,1538,878
3223,415,289,126,60,91,66,52,70,76,7,1132,422
3224,766,533,233,110,167,121,96,129,143,10,2087,776
3225,1864,1613,251,254,437,317,236,290,330,0,4022,1864
3226,453,254,199,58,92,69,78,64,92,21,1531,474
3227,309,173,136,39,63,47,53,43,64,65,1042,374
3228,646,457,189,86,178,100,73,100,109,0,1747,646
3229,410,302,108,37,105,64,52,69,83,0,1096,410
3230,355,314,41,39,84,48,56,59,69,0,907,355
3231,313,276,37,34,74,43,49,52,61,0,798,313
3232,170,150,20,18,40,23,27,28,34,8,434,178
3233,104,82,22,17,23,21,9,16,18,0,262,104
3234,534,422,112,86,116,108,44,81,99,13,1338,547
3235,379,300,79,61,82,77,31,57,71,0,951,379
3236,593,469,124,95,128,120,49,89,112,0,1486,593
3237,625,480,145,98,156,124,54,92,101,0,1649,625
3238,859,659,200,135,214,170,74,126,140,0,2266,859
3239,1398,1073,325,220,349,276,121,205,227,0,3689,1398
3240,1046,815,231,146,277,168,128,144,183,11,2480,1057
3241,568,443,125,79,151,91,70,78,99,0,1345,568
3242,661,515,146,92,175,106,81,91,116,2,1566,663
3243,380,342,38,58,93,75,34,54,66,0,803,380
3244,369,332,37,57,91,73,33,52,63,1,779,370
3245,227,203,24,35,45,51,16,36,44,0,527,227
3246,460,385,75,48,111,75,59,69,98,0,1068,460
3247,403,337,66,42,98,66,52,61,84,0,936,403
3248,359,300,59,37,87,59,46,54,76,0,834,359
3249,395,319,76,38,96,61,42,66,92,6,991,401
3250,431,305,126,57,119,67,49,67,72,236,1166,667
3251,3149,2138,1011,384,658,547,404,480,676,287,9351,3436
3252,140,95,45,14,32,25,12,26,31,0,383,140
3253,1675,1521,154,94,131,191,142,278,839,273,3207,1948
3254,2536,2082,454,144,244,300,202,406,1240,122,6350,2658
3255,2691,2369,322,149,242,341,223,448,1288,493,6307,3184
3256,47,43,4,3,5,3,5,4,27,6,104,53
3257,710,560,150,31,66,72,62,118,361,0,1695,710
3258,2734,2188,546,147,289,262,235,438,1363,38,6984,2772
3259,3079,2543,536,171,326,359,250,478,1495,42,7615,3121
3260,2154,1730,424,112,236,251,175,325,1055,18,5170,2172
3261,1467,1270,197,80,136,158,117,249,727,10,3411,1477
3262,885,721,164,65,89,130,72,124,405,0,2172,885
3263,872,730,142,39,71,82,70,149,461,0,2056,872
3264,830,669,161,41,83,91,67,132,416,0,2108,830
3265,2351,1893,458,124,226,274,199,378,1150,116,5829,2467
3266,1230,1126,104,95,132,160,103,190,550,481,2234,1711
3267,1409,1271,138,88,164,179,109,243,626,234,3306,1643
3268,2595,2239,356,147,258,317,202,413,1258,53,6144,2648
3269,255,233,22,16,21,35,19,42,122,83,542,338
3270,1442,1222,220,89,113,167,114,234,725,22,3111,1464
3271,2782,2211,571,211,214,326,203,486,1342,116,6984,2898
3272,185,160,25,10,16,17,14,27,101,0,426,185
3273,1224,1080,144,133,247,210,128,186,320,8,2347,1232
3274,1778,1540,238,126,202,238,159,291,762,38,3875,1816
3275,1683,1381,302,84,190,174,152,288,795,24,3645,1707
3276,2653,2274,379,148,258,242,244,412,1349,10,5709,2663
3277,1370,1127,243,110,80,194,83,195,708,0,3098,1370
3278,2256,1922,334,165,140,318,176,367,1090,35,4789,2291
3279,898,641,257,48,69,117,70,141,453,73,2564,971
3280,2323,2061,262,166,185,301,138,380,1153,0,4917,2323
3281,506,452,54,30,36,69,32,83,256,362,1072,868
3282,2190,1878,312,130,164,309,99,374,1114,0,5084,2190
3283,1429,1251,178,100,127,170,121,210,701,86,2852,1515
3284,526,456,70,40,44,72,37,83,250,10,1193,536
3285,2502,1416,1086,555,821,493,55,262,316,89,9729,2591
3286,2279,2080,199,171,160,268,144,405,1131,171,4591,2450
3287,2008,1710,298,150,130,257,135,328,1008,0,4577,2008
3288,1783,1578,205,127,134,238,130,291,863,343,3623,2126
3289,1203,955,248,118,88,158,103,186,550,0,2726,1203
3290,304,291,13,16,34,30,34,51,139,161,643,465
3291,2001,1627,374,128,122,243,132,307,1069,20,4748,2021
3292,2591,2276,315,172,194,327,158,427,1313,13,5335,2604
3293,1381,1131,250,114,94,195,93,223,662,0,3096,1381
3294,1069,955,114,61,61,127,82,177,561,0,2309,1069
3295,2289,1874,415,158,142,296,147,408,1138,0,5334,2289
3296,0,0,0,0,0,0,0,0,0,0,0,0
3297,2799,2486,313,195,178,375,175,459,1417,53,6156,2852
3298,2608,2139,469,205,177,353,183,424,1266,0,6230,2608
3299,2105,1855,250,157,168,273,134,333,1040,0,4146,2105
3300,2211,1886,325,159,153,287,116,387,1109,8,4919,2219
3301,2736,2290,446,217,179,359,162,446,1373,20,6244,2756
3302,2022,1691,331,136,126,265,126,346,1023,0,4654,2022
3303,5135,4944,191,400,516,679,400,755,2385,18,8505,5153
3304,202,159,43,9,19,21,18,34,101,0,482,202
3305,515,423,92,29,50,61,41,83,251,0,1289,515
3306,337,277,60,19,32,40,27,54,165,0,843,337
3307,835,685,150,47,80,99,67,134,408,15,2090,850
3308,592,477,115,30,59,65,47,94,297,1,1501,593
3309,1354,1103,251,99,135,199,111,190,620,137,3321,1491
3310,802,694,108,44,74,87,64,136,397,0,1867,802
3311,1664,1524,140,128,178,216,139,257,746,0,3022,1664
3312,2203,2015,188,142,178,301,161,359,1062,0,4682,2203
3313,381,349,32,25,31,52,28,62,183,139,811,520
3314,502,459,43,32,41,69,37,82,241,25,1067,527
3315,70,64,6,5,6,10,5,11,33,0,149,70
3316,81,74,7,5,7,11,6,13,39,122,173,203
3317,281,254,27,18,33,36,22,48,124,27,659,308
3318,665,590,75,48,53,86,39,109,330,0,1407,665
3319,846,750,96,60,68,109,50,138,421,28,1791,874
3320,1979,1767,212,118,142,272,127,325,995,675,4188,2654
3321,468,265,203,104,154,92,10,49,59,55,1821,523
3322,1310,1135,175,99,110,179,91,206,625,3,2972,1313
3323,709,647,62,53,50,83,45,126,352,0,1429,709
3324,576,526,50,43,40,68,36,102,287,0,1161,576
3325,177,155,22,12,13,22,11,29,90,0,365,177
3326,264,232,32,18,20,33,16,44,133,0,544,264
3327,254,216,38,19,16,33,17,41,128,0,578,254
3328,1353,1108,245,112,92,191,91,218,649,0,3033,1353
3329,66,54,12,5,5,9,4,11,32,0,148,66
3330,1423,1245,178,99,127,169,121,209,698,464,2839,1887
3331,309,270,39,22,28,37,26,45,151,5,617,314
3332,301,261,40,23,25,41,21,47,144,0,684,301
